year,vcnaics3,firms,estabs,emp,denom,estabs_entry,estabs_entry_rate,estabs_exit,estabs_exit_rate,job_creation,job_creation_births,job_creation_continuers,job_creation_rate_births,job_creation_rate,job_destruction,job_destruction_deaths,job_destruction_continuers,job_destruction_rate_deaths,job_destruction_rate,net_job_creation,net_job_creation_rate,reallocation_rate,firmdeath_firms,firmdeath_estabs,firmdeath_emp
1978,113,12352,12496,103194,98546,2436,19.766,2093,16.982,28686,10186,18500,10.336,29.109,19341,7836,11505,7.952,19.626,9345,9.483,39.253,1553,1556,5409
1978,114,1651,1687,11180,10209,417,24.866,397,23.673,4738,1933,2805,18.935,46.412,2810,1324,1486,12.970,27.526,1928,18.886,55.052,297,297,863
1978,115,6360,6836,71421,70043,1158,16.878,1208,17.607,23945,8451,15494,12.065,34.186,21540,8508,13032,12.147,30.753,2405,3.434,61.505,840,862,5775
1978,211,5258,7004,120136,117269,905,12.990,831,11.928,29725,9942,19783,8.478,25.348,23873,11834,12039,10.091,20.357,5852,4.990,40.715,391,402,1637
1978,212,7357,9888,372695,391561,1472,15.018,1299,13.253,65604,22899,42705,5.848,16.754,102838,29574,73264,7.553,26.264,-37234,-9.509,33.509,736,748,10065
1978,213,6708,7817,215802,201418,1571,20.764,1069,14.129,69769,24668,45101,12.247,34.639,41628,18588,23040,9.229,20.667,28141,13.971,41.335,621,633,5010
1978,221,5681,11859,658516,643489,928,7.946,567,4.855,80920,19715,61205,3.064,12.575,51198,12451,38747,1.935,7.956,29722,4.619,15.913,215,217,1820
1978,236,134674,135684,1175922,1082995,34808,27.122,20119,15.676,425158,153098,272060,14.137,39.258,240005,89525,150480,8.266,22.161,185153,17.096,44.322,15543,15554,64380
1978,237,34981,35952,702634,671469,5997,17.015,4585,13.009,208311,48849,159462,7.275,31.023,144906,40242,104664,5.993,21.580,63405,9.443,43.161,3374,3384,21800
1978,238,257393,260350,2217371,2068170,51033,20.344,32026,12.767,702891,219775,483116,10.627,33.986,403531,143703,259828,6.948,19.512,299360,14.475,39.023,24925,24934,103855
1978,311,22201,28378,1387517,1369711,2452,8.593,2768,9.700,177846,40349,137497,2.946,12.984,142624,54000,88624,3.942,10.413,35222,2.571,20.825,1813,1850,23679
1978,312,2508,3213,232112,230315,178,5.480,248,7.635,25605,4086,21519,1.774,11.117,21616,8342,13274,3.622,9.385,3989,1.732,18.771,145,146,2403
1978,313,5286,6654,653209,658887,534,8.090,427,6.469,50597,8707,41890,1.321,7.679,61390,23382,38008,3.549,9.317,-10793,-1.638,15.358,271,272,7469
1978,314,7905,8339,271703,261491,1086,13.237,816,9.946,50858,13854,37004,5.298,19.449,30284,11189,19095,4.279,11.581,20574,7.868,23.163,635,635,5959
1978,315,16654,18980,1237842,1224287,2465,13.029,2343,12.384,193767,63244,130523,5.166,15.827,167151,73209,93942,5.980,13.653,26616,2.174,27.306,1772,1787,41343
1978,316,2374,2791,250705,250343,256,9.149,270,9.650,31728,8050,23678,3.216,12.674,31528,10415,21113,4.160,12.594,200,0.080,25.188,192,195,3502
1978,321,14733,16626,575296,552408,2042,12.398,1731,10.510,103285,25399,77886,4.598,18.697,57582,23303,34279,4.218,10.424,45703,8.273,20.848,1240,1250,12303
1978,322,3712,5788,620510,614154,491,8.657,259,4.566,51454,12498,38956,2.035,8.378,38258,12879,25379,2.097,6.229,13196,2.149,12.459,139,140,3056
1978,323,29487,30810,602461,584991,3604,11.891,2600,8.579,87846,19544,68302,3.341,15.017,53062,23247,29815,3.974,9.071,34784,5.946,18.141,1947,1954,11640
1978,324,1261,2057,148540,147206,176,8.598,156,7.621,12876,2693,10183,1.829,8.747,10147,2608,7539,1.772,6.893,2729,1.854,13.786,62,63,880
1978,325,8014,11666,941810,930666,927,7.957,894,7.674,85980,14392,71588,1.546,9.239,63375,20703,42672,2.225,6.810,22605,2.429,13.619,506,509,5814
1978,326,9818,11635,721669,696952,1344,11.755,941,8.230,106124,21271,84853,3.052,15.227,57118,18846,38272,2.704,8.195,49006,7.031,16.391,652,655,8610
1978,327,12585,15650,591251,574633,1465,9.417,1280,8.228,81568,14809,66759,2.577,14.195,48505,14132,34373,2.459,8.441,33063,5.754,16.882,867,879,6364
1978,331,4668,5848,1063952,1051896,419,7.196,369,6.337,89678,13995,75683,1.330,8.525,66530,14429,52101,1.372,6.325,23148,2.201,12.650,248,249,4184
1978,332,44554,48298,1745451,1681613,5016,10.675,2393,5.093,271576,53630,217946,3.189,16.150,144438,47723,96715,2.838,8.589,127138,7.560,17.179,1600,1610,23314
1978,333,24759,27430,1754290,1701793,2469,9.115,1781,6.575,233174,43446,189728,2.553,13.702,128114,36669,91445,2.155,7.528,105060,6.173,15.056,1218,1220,11142
1978,334,9568,11070,1438534,1385524,1441,13.217,1107,10.153,214998,34882,180116,2.518,15.517,109955,30955,79000,2.234,7.936,105043,7.581,15.872,749,751,10975
1978,335,4925,6155,753769,730468,592,9.751,424,6.984,95130,16214,78916,2.220,13.023,48006,13475,34531,1.845,6.572,47124,6.451,13.144,264,265,3286
1978,336,8386,9923,2093525,2051357,1136,10.971,2000,19.314,231143,45379,185764,2.212,11.268,146241,43993,102248,2.145,7.129,84902,4.139,14.258,1557,1559,14157
1978,337,15049,15959,550623,524670,2245,14.337,1645,10.505,97068,23307,73761,4.442,18.501,45145,19310,25835,3.680,8.604,51923,9.896,17.209,1257,1259,10764
1978,339,23367,24641,689845,669594,3278,13.523,2477,10.218,115954,26441,89513,3.949,17.317,75620,26116,49504,3.900,11.293,40334,6.024,22.587,1883,1887,13294
1978,423,129128,167235,2070163,1987509,21955,13.414,14838,9.065,437519,147680,289839,7.430,22.013,272684,119517,153167,6.013,13.720,164835,8.294,27.440,9285,9470,46576
1978,424,88004,113396,1498158,1467341,13081,11.617,11492,10.206,301843,93051,208792,6.341,20.571,239863,112754,127109,7.684,16.347,61980,4.224,32.694,7377,7499,52001
1978,425,23310,25747,258129,248984,3458,13.772,2181,8.686,54404,18378,36026,7.381,21.850,36210,15014,21196,6.030,14.543,18194,7.307,29.086,1421,1425,6941
1978,441,94124,110684,1341448,1291380,12821,11.742,9831,9.004,237305,79785,157520,6.178,18.376,136974,55990,80984,4.336,10.607,100331,7.769,21.214,7127,7279,38658
1978,442,41138,47035,328956,313696,7426,16.138,5387,11.707,80657,33429,47228,10.657,25.712,50255,23896,26359,7.618,16.020,30402,9.692,32.041,3755,3850,13669
1978,443,28411,38066,210506,198389,6007,16.119,4408,11.828,56991,25447,31544,12.827,28.727,32947,16275,16672,8.204,16.607,24044,12.120,33.215,2858,2931,9753
1978,444,69789,87231,767973,733866,9773,11.401,6747,7.871,163015,58191,104824,7.929,22.213,94868,36730,58138,5.005,12.927,68147,9.286,25.854,4617,4670,19533
1978,445,114030,155821,1830947,1772342,20248,13.022,19583,12.595,384480,158121,226359,8.922,21.693,267335,119648,147687,6.751,15.084,117145,6.610,30.167,13386,13597,58138
1978,446,44180,59791,525797,515428,6924,11.795,4751,8.093,99241,38908,60333,7.549,19.254,79016,35228,43788,6.835,15.330,20225,3.924,30.660,2865,2938,13988
1978,447,124389,162658,938140,905936,22548,13.682,26839,16.285,264149,105682,158467,11.666,29.158,199924,104699,95225,11.557,22.068,64225,7.089,44.136,18371,18668,63752
1978,448,86768,142156,1040329,1008192,20453,14.610,16123,11.517,255410,108199,147211,10.732,25.333,191053,89976,101077,8.924,18.950,64357,6.383,37.900,8891,9349,40218
1978,451,37471,47379,279749,266503,8897,19.247,6588,14.252,80421,36691,43730,13.768,30.176,53837,25996,27841,9.755,20.201,26584,9.975,40.403,4480,4552,16096
1978,452,17014,38876,1937934,1899620,3610,9.244,3963,10.148,286276,101863,184413,5.362,15.070,211826,67361,144465,3.546,11.151,74450,3.919,22.302,2084,2152,11566
1978,453,65946,75478,374613,353494,13637,18.522,9934,13.492,111787,45991,65796,13.010,31.623,69505,35189,34316,9.955,19.662,42282,11.961,39.325,7099,7230,21188
1978,454,27069,35609,364294,363044,4103,11.580,3749,10.581,72521,23971,48550,6.603,19.976,69699,29919,39780,8.241,19.199,2822,0.777,38.397,2473,2495,12395
1978,481,1217,2628,277535,266007,354,13.499,343,13.079,43921,4898,39023,1.841,16.511,20620,4033,16587,1.516,7.752,23301,8.760,15.503,139,140,1183
1978,483,887,1239,54072,53401,155,12.490,159,12.812,12332,4682,7650,8.768,23.093,10862,5677,5185,10.631,20.340,1470,2.753,40.681,84,98,2364
1978,484,58586,67512,1045547,1002115,12256,18.444,10135,15.252,254554,81625,172929,8.145,25.402,167301,68205,99096,6.806,16.695,87253,8.707,33.390,7551,7563,29913
1978,485,11938,12676,241682,239460,1876,14.890,1722,13.668,48477,15033,33444,6.278,20.244,43846,19688,24158,8.222,18.310,4631,1.934,36.621,1401,1408,12966
1978,486,306,1457,67366,63428,196,13.911,100,7.097,14040,7082,6958,11.165,22.135,6237,3185,3052,5.021,9.833,7803,12.302,19.666,13,13,137
1978,487,935,953,12004,11075,177,18.780,156,16.552,3889,844,3045,7.621,35.115,1986,822,1164,7.422,17.932,1903,17.183,35.865,122,122,492
1978,488,9775,13095,304260,287191,2067,16.176,1433,11.215,88438,33256,55182,11.580,30.794,54601,20773,33828,7.233,19.012,33837,11.782,38.024,888,900,6638
1978,492,1984,2418,56529,54706,551,22.712,567,23.372,11712,3121,8591,5.705,21.409,8247,2383,5864,4.356,15.075,3465,6.334,30.151,459,459,1560
1978,493,5473,8580,373385,364013,830,9.787,632,7.452,68820,16837,51983,4.625,18.906,50209,11821,38388,3.247,13.793,18611,5.113,27.586,249,250,1568
1978,511,15406,17425,617775,600865,2638,15.527,1767,10.401,84774,21946,62828,3.652,14.109,51436,21634,29802,3.600,8.560,33338,5.548,17.121,1216,1222,8971
1978,512,8861,14236,187472,187451,2384,16.776,2334,16.424,53830,20395,33435,10.880,28.717,53268,28225,25043,15.057,28.417,562,0.300,56.834,1198,1284,10267
1978,515,5172,6061,170986,163650,567,9.503,378,6.335,29188,9169,20019,5.603,17.836,14580,5406,9174,3.303,8.909,14608,8.926,17.819,275,280,3351
1978,517,3049,17004,996749,971372,926,5.475,745,4.405,158515,13699,144816,1.410,16.319,107033,6986,100047,0.719,11.019,51482,5.300,22.037,185,189,1626
1978,518,4500,5962,165957,158145,1141,19.783,752,13.039,42875,16555,26320,10.468,27.111,27289,13615,13674,8.609,17.256,15586,9.856,34.511,400,410,4365
1978,519,1916,2296,25397,26154,262,11.736,135,6.047,4757,1277,3480,4.883,18.188,6125,4582,1543,17.519,23.419,-1368,-5.231,36.377,93,93,3667
1978,521,20,50,23489,23807,0,0.000,0,0.000,1081,0,1081,0.000,4.541,1697,0,1697,0.000,7.128,-616,-2.588,9.082,0,0,0
1978,522,46653,103969,1903773,1843611,8214,8.036,4705,4.603,296805,74347,222458,4.033,16.099,176124,42678,133446,2.315,9.553,120681,6.546,19.106,1789,1811,11616
1978,523,12071,15916,222970,224899,2846,18.256,2192,14.061,48098,14661,33437,6.519,21.386,51422,19916,31506,8.856,22.864,-3324,-1.478,42.773,1425,1489,8126
1978,524,87934,113098,1948762,1883269,14048,12.696,9151,8.270,332926,78297,254629,4.158,17.678,200655,71918,128737,3.819,10.655,132271,7.023,21.309,5419,5434,17419
1978,525,564,770,6770,6755,53,6.739,86,10.935,1250,243,1007,3.598,18.506,1191,428,763,6.337,17.633,59,0.873,35.265,49,49,253
1978,531,151103,154938,805583,768847,25683,16.862,20438,13.418,226677,93589,133088,12.173,29.483,152179,74460,77719,9.685,19.793,74498,9.690,39.586,16359,16379,49114
1978,532,17417,22189,206840,198786,4742,22.343,2812,13.249,62876,27074,35802,13.620,31.630,46375,19436,26939,9.777,23.329,16501,8.301,46.658,1805,1838,9169
1978,533,836,962,12025,12245,188,20.215,124,13.333,3956,1470,2486,12.005,32.308,4465,1829,2636,14.937,36.465,-509,-4.157,64.617,84,84,310
1978,541,234677,250085,2217643,2115461,42345,17.546,24854,10.298,534296,197486,336810,9.335,25.257,330533,149600,180933,7.072,15.625,203763,9.632,31.249,17483,17751,95606
1978,551,18993,36128,2428735,2362628,3944,11.034,3177,8.888,524500,138903,385597,5.879,22.200,391529,97797,293732,4.139,16.572,132971,5.628,33.144,400,431,4528
1978,561,98988,110981,1805418,1686283,24703,23.301,14774,13.936,583507,196104,387403,11.629,34.603,346221,123966,222255,7.351,20.532,237286,14.072,41.063,10962,11043,67100
1978,562,10223,10890,156506,148130,1729,16.192,1305,12.221,36541,10798,25743,7.290,24.668,19922,9205,10717,6.214,13.449,16619,11.219,26.898,976,976,5350
1978,611,30432,32424,1282237,1211637,4458,14.044,3098,9.759,272273,33454,238819,2.761,22.472,134005,64316,69689,5.308,11.060,138268,11.412,22.120,2260,2292,48802
1978,621,256825,266316,1393978,1322209,29336,11.319,15040,5.803,317897,113316,204581,8.570,24.043,173668,63123,110545,4.774,13.135,144229,10.908,26.269,11173,11262,43380
1978,622,4609,5584,2683227,2600746,232,4.185,151,2.724,246671,28924,217747,1.112,9.485,81034,28891,52143,1.111,3.116,165637,6.369,6.232,85,88,13869
1978,623,18170,23304,1111974,1062798,3228,14.272,1857,8.210,224926,81778,143148,7.695,21.164,126307,68168,58139,6.414,11.884,98619,9.279,23.769,1145,1191,38748
1978,624,35643,45464,656385,593951,8063,18.516,4228,9.709,218411,67668,150743,11.393,36.773,93618,32688,60930,5.503,15.762,124793,21.011,31.524,2305,2342,12267
1978,711,12165,12457,165548,157965,3129,26.218,2084,17.462,53381,21251,32130,13.453,33.793,38278,15814,22464,10.011,24.232,15103,9.561,48.464,1492,1501,8409
1978,712,1715,1839,29406,27792,221,12.402,107,6.004,5998,1558,4440,5.606,21.582,2681,479,2202,1.724,9.647,3317,11.935,19.294,60,61,285
1978,713,28826,30410,455989,429031,4319,14.510,3029,10.176,108853,37317,71536,8.698,25.372,55186,19529,35657,4.552,12.863,53667,12.509,25.726,2304,2312,13726
1978,721,38047,42094,991762,947555,6002,14.307,5717,13.628,250055,103935,146120,10.969,26.390,161545,86746,74799,9.155,17.049,88510,9.341,34.097,4152,4191,52943
1978,722,248380,299947,4226396,3988844,55696,18.826,47508,16.058,1269337,673296,596041,16.879,31.822,791780,397852,393928,9.974,19.850,477557,11.972,39.700,34032,34566,247776
1978,811,128074,135298,724338,686697,24052,18.186,17966,13.584,192676,80709,111967,11.753,28.058,116661,56884,59777,8.284,16.989,76015,11.070,33.977,13790,13849,39907
1978,812,143843,164336,1000558,981851,23230,14.233,20985,12.857,228570,91907,136663,9.361,23.280,190027,84039,105988,8.559,19.354,38543,3.926,38.708,15155,15408,54368
1978,813,158632,164195,1439838,1352068,14997,9.329,8121,5.052,342477,68541,273936,5.069,25.330,167023,38597,128426,2.855,12.353,175454,12.977,24.706,4829,4861,20017
1979,113,11996,12146,106164,105580,2180,17.965,2157,17.776,25283,9549,15734,9.044,23.947,24143,9733,14410,9.219,22.867,1140,1.080,45.734,1577,1578,6849
1979,114,1613,1655,11510,11079,324,19.454,345,20.715,4634,1530,3104,13.810,41.827,3745,1369,2376,12.357,33.803,889,8.024,67.605,250,250,947
1979,115,6423,6832,68220,69889,1108,16.170,1148,16.754,20159,8358,11801,11.959,28.845,23682,9505,14177,13.600,33.885,-3523,-5.041,57.689,791,834,6115
1979,211,5634,7418,128743,124008,1047,14.505,647,8.964,24636,6824,17812,5.503,19.866,15384,5642,9742,4.550,12.406,9252,7.461,24.811,349,353,2112
1979,212,7135,9688,443190,407608,1414,14.617,1385,14.317,122385,23523,98862,5.771,30.025,51711,21748,29963,5.336,12.686,70674,17.339,25.373,855,862,8215
1979,213,7314,8485,247775,233658,1729,21.189,1079,13.223,71336,23313,48023,9.977,30.530,42526,18216,24310,7.796,18.200,28810,12.330,36.400,665,670,8774
1979,221,5947,12131,683736,672011,789,6.570,545,4.538,62484,21587,40897,3.212,9.298,39494,8065,31429,1.200,5.877,22990,3.421,11.754,213,213,897
1979,236,143710,144721,1326206,1255438,33049,23.548,24297,17.312,450646,149746,300900,11.928,35.896,309902,109634,200268,8.733,24.685,140744,11.211,49.370,18916,18917,84249
1979,237,35875,36869,759368,732869,5730,15.817,4447,12.275,201916,43738,158178,5.968,27.551,148092,36633,111459,4.999,20.207,53824,7.344,40.414,3297,3303,21455
1979,238,269395,272388,2497096,2366952,46022,17.243,35036,13.127,730877,197136,533741,8.329,30.878,470427,159407,311020,6.735,19.875,260450,11.004,39.750,27397,27416,118583
1979,311,20993,27150,1399212,1393089,2236,8.168,2689,9.822,167506,38337,129169,2.752,12.024,155105,49429,105676,3.548,11.134,12401,0.890,22.268,1741,1770,20045
1979,312,2358,3037,237451,235411,184,5.965,279,9.045,25789,5080,20709,2.158,10.955,21446,7454,13992,3.166,9.110,4343,1.845,18.220,165,166,2186
1979,313,5367,6737,651547,655124,489,7.288,435,6.483,51101,11125,39976,1.698,7.800,57664,17652,40012,2.694,8.802,-6563,-1.002,15.600,240,245,6028
1979,314,7918,8385,272413,271497,1096,13.207,923,11.122,40586,13507,27079,4.975,14.949,38823,12232,26591,4.505,14.300,1763,0.649,28.599,691,692,7163
1979,315,16361,18670,1221160,1229504,2242,11.973,2354,12.571,168312,55022,113290,4.475,13.689,185404,68525,116879,5.573,15.080,-17092,-1.390,27.379,1708,1721,35944
1979,316,2241,2645,245862,248799,211,7.864,287,10.697,26347,4669,21678,1.877,10.590,32370,8821,23549,3.545,13.011,-6023,-2.421,21.179,189,189,3534
1979,321,14792,16700,588626,582814,2084,12.586,1801,10.877,88166,25517,62649,4.378,15.128,76149,24261,51888,4.163,13.066,12017,2.062,26.131,1237,1250,12777
1979,322,3721,5826,630345,628392,327,5.596,361,6.178,51495,11175,40320,1.778,8.195,46985,12812,34173,2.039,7.477,4510,0.718,14.954,203,204,3884
1979,323,29722,31053,632900,618240,3328,10.766,3047,9.857,90940,22256,68684,3.600,14.710,61459,25784,35675,4.171,9.941,29481,4.769,19.882,2153,2169,13193
1979,324,1274,2096,155333,152312,201,9.703,152,7.338,13785,3437,10348,2.257,9.051,7768,1425,6343,0.936,5.100,6017,3.950,10.200,68,68,582
1979,325,7703,11329,983385,973246,882,7.768,932,8.209,88113,19006,69107,1.953,9.054,67748,17725,50023,1.821,6.961,20365,2.092,13.922,463,467,4030
1979,326,10788,12704,792595,773253,1400,11.218,952,7.628,114459,23446,91013,3.032,14.802,75619,22446,53173,2.903,9.779,38840,5.023,19.559,591,599,9456
1979,327,12121,15177,604247,595545,1325,8.694,1453,9.533,80504,16837,63667,2.827,13.518,62917,20020,42897,3.362,10.565,17587,2.953,21.129,929,981,8080
1979,331,4535,5747,1100844,1080553,382,6.637,399,6.932,107633,21545,86088,1.994,9.961,68141,22367,45774,2.070,6.306,39492,3.655,12.612,215,215,3371
1979,332,44158,48034,1862173,1803494,4871,10.251,3833,8.067,273713,50584,223129,2.805,15.177,156371,53533,102838,2.968,8.670,117342,6.506,17.341,2464,2472,22524
1979,333,24983,27790,1874994,1809218,2406,8.715,2042,7.396,259676,47304,212372,2.615,14.353,127838,46836,81002,2.589,7.066,131838,7.287,14.132,1248,1249,12021
1979,334,9643,11272,1611533,1543867,1443,12.989,1118,10.063,247268,51721,195547,3.350,16.016,111563,39786,71777,2.577,7.226,135705,8.790,14.452,677,680,13953
1979,335,4832,6066,773648,762506,525,8.644,540,8.891,92150,20544,71606,2.694,12.085,69606,20266,49340,2.658,9.129,22544,2.957,18.257,298,298,4975
1979,336,7896,9481,2226386,2142392,1023,10.765,1067,11.228,275243,29984,245259,1.400,12.847,106437,25028,81409,1.168,4.968,168806,7.879,9.936,708,710,8657
1979,337,15157,16090,562626,555084,1955,12.230,1745,10.916,79345,17767,61578,3.201,14.294,64172,23645,40527,4.260,11.561,15173,2.733,23.122,1274,1280,14223
1979,339,22521,23756,685971,678989,2843,11.967,2844,11.971,103435,23937,79498,3.525,15.234,89393,30519,58874,4.495,13.166,14042,2.068,26.331,2047,2053,14343
1979,423,136779,176197,2256163,2177901,20590,11.881,14804,8.542,428081,134950,293131,6.196,19.656,272243,104437,167806,4.795,12.500,155838,7.155,25.000,9297,9452,47127
1979,424,90635,115794,1552845,1534527,11768,10.188,11205,9.700,275232,83539,191693,5.444,17.936,237823,92654,145169,6.038,15.498,37409,2.438,30.996,7142,7266,41725
1979,425,24765,27369,278877,270708,3261,12.170,2115,7.893,52916,17221,35695,6.361,19.547,36575,12430,24145,4.592,13.511,16341,6.036,27.022,1366,1368,6293
1979,441,95336,112042,1429216,1393455,11201,10.060,9809,8.809,226304,67672,158632,4.856,16.240,154710,59413,95297,4.264,11.103,71594,5.138,22.205,7268,7386,43096
1979,442,43206,49594,352619,342950,6781,13.943,4858,9.989,72785,28378,44407,8.275,21.223,53442,20749,32693,6.050,15.583,19343,5.640,31.166,3658,3718,14509
1979,443,28273,38200,223241,216956,4638,12.233,4064,10.719,48319,19077,29242,8.793,22.271,35641,14989,20652,6.909,16.428,12678,5.844,32.856,2748,2825,9535
1979,444,71120,88930,822463,797204,8489,9.651,6551,7.448,147612,46611,101001,5.847,18.516,97122,32673,64449,4.098,12.183,50490,6.333,24.366,4555,4617,20025
1979,445,114542,156307,1937452,1886262,18747,12.013,18248,11.693,362051,150570,211481,7.982,19.194,257790,110186,147604,5.842,13.667,104261,5.527,27.333,12466,12702,54391
1979,446,45857,62808,562150,544919,6987,11.381,4152,6.763,100251,37875,62376,6.951,18.397,64696,21548,43148,3.954,11.873,35555,6.525,23.745,2823,2858,12991
1979,447,120320,158387,929816,935863,18884,11.746,23645,14.708,211565,87039,124526,9.300,22.606,223420,98742,124678,10.551,23.873,-11855,-1.267,45.213,16162,16401,61966
1979,448,89564,148882,1095874,1070698,19247,13.200,13114,8.994,230596,100058,130538,9.345,21.537,180716,59037,121679,5.514,16.878,49880,4.659,33.757,8213,8492,32683
1979,451,39149,49599,302835,292347,7982,16.417,6025,12.392,73920,31734,42186,10.855,25.285,53043,21320,31723,7.293,18.144,20877,7.141,36.288,4314,4530,14037
1979,452,17313,39152,1971111,1956236,3569,9.117,3555,9.082,231297,104223,127074,5.328,11.824,198543,44745,153798,2.287,10.149,32754,1.674,20.298,1782,1855,8391
1979,453,69801,79763,404386,390421,13445,17.311,9254,11.915,101691,44034,57657,11.279,26.046,73760,29422,44338,7.536,18.892,27931,7.154,37.785,6911,7002,20841
1979,454,27983,36686,390947,379005,3913,10.732,3463,9.498,75763,24821,50942,6.549,19.990,51737,19346,32391,5.104,13.651,24026,6.339,27.302,2507,2538,10552
1979,481,1324,2813,306654,292183,412,15.136,230,8.450,37826,5872,31954,2.010,12.946,9186,3103,6083,1.062,3.144,28640,9.802,6.288,136,136,727
1979,483,852,1194,53255,52533,148,12.437,140,11.765,13085,4960,8125,9.442,24.908,11587,3931,7656,7.483,22.057,1498,2.852,44.113,65,65,420
1979,484,60324,69484,1128987,1085475,12651,18.602,9699,14.262,234514,71290,163224,6.568,21.605,147925,53603,94322,4.938,13.628,86589,7.977,27.255,7459,7474,32746
1979,485,12156,12915,247919,244442,1738,13.512,1634,12.703,43580,12500,31080,5.114,17.828,36729,12655,24074,5.177,15.026,6851,2.803,30.051,1378,1383,10352
1979,486,347,1567,70401,69311,137,9.004,46,3.023,7093,2775,4318,4.004,10.234,5015,1086,3929,1.567,7.236,2078,2.998,14.471,13,13,176
1979,487,939,959,10542,10752,185,19.629,152,16.127,2582,969,1613,9.012,24.014,3010,1037,1973,9.645,27.995,-428,-3.981,48.028,123,123,774
1979,488,10941,14294,323705,316533,2278,16.438,1407,10.153,75252,22831,52421,7.213,23.774,60023,14463,45560,4.569,18.963,15229,4.811,37.925,888,906,6030
1979,492,1745,2226,61916,58490,622,28.611,518,23.827,11696,3594,8102,6.145,19.997,4938,2350,2588,4.018,8.443,6758,11.554,16.885,444,444,1978
1979,493,6017,9235,395380,385736,878,9.659,587,6.458,70925,23787,47138,6.167,18.387,51435,11195,40240,2.902,13.334,19490,5.053,26.668,230,230,1685
1979,511,16140,18503,660887,642466,3087,17.241,1891,10.561,92683,29637,63046,4.613,14.426,55640,19228,36412,2.993,8.660,37043,5.766,17.321,1337,1341,10381
1979,512,9499,14811,203885,197411,2264,15.476,1900,12.988,59111,18479,40632,9.361,29.943,45730,15400,30330,7.801,23.165,13381,6.778,46.330,997,1017,6710
1979,515,5369,6297,178884,175164,636,10.270,428,6.911,26783,9835,16948,5.615,15.290,19318,6271,13047,3.580,11.029,7465,4.262,22.057,307,308,3907
1979,517,3331,16590,1029497,1014263,729,4.334,1192,7.086,187617,6128,181489,0.604,18.498,157391,27362,130029,2.698,15.518,30226,2.980,31.036,271,271,1514
1979,518,4836,6296,180443,172880,1059,17.229,760,12.365,41695,16250,25445,9.400,24.118,26863,13889,12974,8.034,15.539,14832,8.579,31.077,376,378,2820
1979,519,2010,2395,26767,26128,266,11.372,154,6.584,3994,1337,2657,5.117,15.286,2753,820,1933,3.138,10.537,1241,4.750,21.073,110,110,644
1979,521,19,48,23505,23472,0,0.000,0,0.000,647,0,647,0.000,2.756,629,0,629,0.000,2.680,18,0.077,5.360,0,0,0
1979,522,47421,108272,2029651,1971644,7991,7.519,3994,3.758,249050,72807,176243,3.693,12.632,133061,29268,103793,1.484,6.749,115989,5.883,13.497,1998,2015,11027
1979,523,13242,17388,252593,240891,3120,18.559,1966,11.695,58222,19487,38735,8.090,24.169,35056,15724,19332,6.527,14.553,23166,9.617,29.105,1365,1365,5169
1979,524,92059,119936,2140405,2042726,15381,13.185,8822,7.562,416103,102582,313521,5.022,20.370,221123,56243,164880,2.753,10.825,194980,9.545,21.650,5582,5614,20810
1979,525,593,798,6936,6917,70,8.766,71,8.892,1520,279,1241,4.034,21.975,1413,429,984,6.202,20.428,107,1.547,40.856,28,28,75
1979,531,159783,163709,870067,841215,26983,16.816,20489,12.769,228310,96350,131960,11.454,27.141,170323,75310,95013,8.953,20.247,57987,6.893,40.495,16493,16524,53634
1979,532,18518,24461,245493,226690,4995,21.419,2713,11.634,76573,27288,49285,12.038,33.779,39700,16669,23031,7.353,17.513,36873,16.266,35.026,1847,1864,9335
1979,533,875,934,10303,11029,154,16.117,197,20.617,2994,1255,1739,11.379,27.147,4588,3212,1376,29.123,41.599,-1594,-14.453,54.293,101,103,406
1979,541,252616,268576,2447778,2338143,44477,17.120,26928,10.365,536671,194067,342604,8.300,22.953,316215,126175,190040,5.396,13.524,220456,9.429,27.048,19670,19867,79234
1979,551,20026,37773,2573911,2501924,4305,11.619,2862,7.724,463418,144587,318831,5.779,18.522,317598,78274,239324,3.129,12.694,145820,5.828,25.388,424,429,4563
1979,561,108075,121028,2035788,1923601,26050,22.506,15485,13.378,590650,200224,390426,10.409,30.705,366441,120318,246123,6.255,19.050,224209,11.656,38.099,11720,11793,71347
1979,562,10874,11587,174533,165990,1747,15.404,1255,11.066,37787,10102,27685,6.086,22.765,20746,8414,12332,5.069,12.498,17041,10.266,24.997,955,956,5355
1979,611,31267,33268,1322093,1270503,4198,12.804,3233,9.861,205024,29451,175573,2.318,16.137,100969,22803,78166,1.795,7.947,104055,8.190,15.894,2437,2472,14789
1979,621,269656,279695,1521797,1458247,28754,10.527,15649,5.729,307838,114666,193172,7.863,21.110,181459,59851,121608,4.104,12.444,126379,8.667,24.887,11613,11680,41847
1979,622,4804,5816,2789297,2733629,213,3.657,230,3.949,219946,29006,190940,1.061,8.046,109616,38909,70707,1.423,4.010,110330,4.036,8.020,142,145,22898
1979,623,18748,24330,1176226,1148051,2605,10.911,1694,7.095,179161,61893,117268,5.391,15.606,122505,52683,69822,4.589,10.671,56656,4.935,21.341,1175,1246,37233
1979,624,38352,49183,713860,682605,7169,15.125,3597,7.589,165745,60643,105102,8.884,24.281,103881,24955,78926,3.656,15.218,61864,9.063,30.437,2439,2473,13869
1979,711,13437,13718,189936,177915,3480,26.622,2188,16.738,70827,19334,51493,10.867,39.810,45975,15453,30522,8.686,25.841,24852,13.969,51.682,1570,1573,10132
1979,712,1830,1937,31126,30328,172,9.012,115,6.026,4862,747,4115,2.463,16.031,3377,434,2943,1.431,11.135,1485,4.896,22.270,58,58,224
1979,713,29623,31238,481611,469366,4093,13.274,3286,10.657,95166,31590,63576,6.730,20.275,70907,22705,48202,4.837,15.107,24259,5.168,30.214,2485,2505,16895
1979,721,38798,42846,1051250,1028607,5689,13.315,5448,12.751,223555,89218,134337,8.674,21.734,178972,77185,101787,7.504,17.399,44583,4.334,34.799,3971,4014,48728
1979,722,253937,308957,4494048,4368361,53149,17.436,44888,14.726,1171199,624258,546941,14.290,26.811,923820,381175,542645,8.726,21.148,247379,5.663,42.296,32340,32817,246016
1979,811,133975,141394,786618,755946,24114,17.432,17995,13.008,196901,81476,115425,10.778,26.047,135231,59670,75561,7.893,17.889,61670,8.158,35.778,13879,13951,44660
1979,812,146608,168063,1048076,1029438,22528,13.532,19368,11.634,212484,90323,122161,8.774,20.641,176371,71324,105047,6.928,17.133,36113,3.508,34.266,14477,14713,49849
1979,813,163591,169340,1504548,1470250,13298,7.967,8430,5.051,271550,55605,215945,3.782,18.470,202456,37855,164601,2.575,13.770,69094,4.699,27.540,5320,5337,21882
1980,113,11776,11929,103005,104590,1937,16.113,2121,17.644,21864,7948,13916,7.599,20.905,25189,8631,16558,8.252,24.084,-3325,-3.179,41.809,1625,1625,6421
1980,114,1649,1681,11798,11755,343,20.564,317,19.005,3933,1563,2370,13.296,33.458,3854,1294,2560,11.008,32.786,79,0.672,65.572,226,226,820
1980,115,6562,6976,72441,71180,1002,14.413,954,13.723,19807,6802,13005,9.556,27.827,17345,5307,12038,7.456,24.368,2462,3.459,48.736,730,730,3558
1980,211,6049,7842,137411,132908,1106,14.524,652,8.562,27162,8437,18725,6.348,20.437,18062,4991,13071,3.755,13.590,9100,6.847,27.180,369,374,1538
1980,212,7055,9548,432746,439323,1238,12.872,1377,14.318,62417,21811,40606,4.965,14.208,75605,21981,53624,5.003,17.209,-13188,-3.002,28.415,923,948,10640
1980,213,8260,9506,285890,267590,2013,22.308,1048,11.614,83056,26234,56822,9.804,31.039,46441,18615,27826,6.957,17.355,36615,13.683,34.711,697,708,9476
1980,221,5956,12215,698989,691119,576,4.731,495,4.066,43076,11276,31800,1.632,6.233,27477,7856,19621,1.137,3.976,15599,2.257,7.951,279,281,1162
1980,236,137811,138744,1226033,1255628,26663,18.873,31733,22.461,339662,116482,223180,9.277,27.051,398633,133492,265141,10.631,31.748,-58971,-4.697,54.102,24548,24555,100060
1980,237,36662,37590,746328,751954,5586,14.944,5165,13.818,164074,38540,125534,5.125,21.820,175566,37681,137885,5.011,23.348,-11492,-1.528,43.639,3779,3786,23330
1980,238,266061,269008,2453387,2477406,39106,14.440,42725,15.776,590611,168665,421946,6.808,23.840,639079,181116,457963,7.311,25.796,-48468,-1.956,47.680,32934,32941,135979
1980,311,20800,26840,1367871,1381251,2284,8.471,2532,9.390,142268,36959,105309,2.676,10.300,168259,55693,112566,4.032,12.182,-25991,-1.882,20.600,1686,1705,20862
1980,312,2312,2971,232664,235001,172,5.730,233,7.763,18401,4705,13696,2.002,7.830,22859,5806,17053,2.471,9.727,-4458,-1.897,15.660,143,143,2237
1980,313,5485,6853,640939,646380,532,7.825,424,6.236,48357,11731,36626,1.815,7.481,58999,17243,41756,2.668,9.128,-10642,-1.646,14.962,253,255,4411
1980,314,7753,8207,260827,266649,897,10.816,1069,12.890,31775,8509,23266,3.191,11.916,43663,14691,28972,5.509,16.375,-11888,-4.458,23.833,855,859,8549
1980,315,16188,18420,1187007,1202014,2160,11.658,2375,12.819,155018,49950,105068,4.156,12.897,185151,65278,119873,5.431,15.403,-30133,-2.507,25.793,1875,1888,39733
1980,316,2211,2583,230213,236682,209,8.018,256,9.822,23351,5235,18116,2.212,9.866,36050,13026,23024,5.504,15.231,-12699,-5.365,19.732,183,186,5501
1980,321,14893,16763,546370,566511,1951,11.678,1839,11.007,62502,19926,42576,3.517,11.033,102620,29332,73288,5.178,18.114,-40118,-7.082,22.066,1358,1359,14375
1980,322,3692,5786,634217,632506,325,5.595,370,6.370,49239,9193,40046,1.453,7.785,46176,10732,35444,1.697,7.300,3063,0.484,14.601,227,228,3663
1980,323,30698,32064,641824,637347,3686,11.686,2644,8.382,78123,21578,56545,3.386,12.258,69527,21715,47812,3.407,10.909,8596,1.349,21.818,2067,2073,14174
1980,324,1307,2088,145593,150600,200,9.563,207,9.897,9376,2710,6666,1.799,6.226,19706,4956,14750,3.291,13.085,-10330,-6.859,12.452,59,78,920
1980,325,7823,11454,956057,953178,933,8.204,771,6.779,79827,20915,58912,2.194,8.375,73675,16812,56863,1.764,7.729,6152,0.645,15.459,444,448,4617
1980,326,11016,12951,749658,771004,1298,10.114,1064,8.290,83774,25020,58754,3.245,10.866,127567,35754,91813,4.637,16.546,-43793,-5.680,21.731,716,722,10447
1980,327,12159,15149,580737,593381,1298,8.563,1317,8.688,55199,15361,39838,2.589,9.302,80700,19456,61244,3.279,13.600,-25501,-4.298,18.605,877,888,7250
1980,331,4636,5869,1062240,1079780,441,7.597,313,5.392,67625,13672,53953,1.266,6.263,102613,17654,84959,1.635,9.503,-34988,-3.240,12.526,195,195,4167
1980,332,45884,49806,1852194,1858432,5401,11.039,3641,7.442,213741,52328,161413,2.816,11.501,226581,54857,171724,2.952,12.192,-12840,-0.691,23.002,2668,2679,27288
1980,333,25626,28520,1871239,1872361,2586,9.189,1829,6.499,196700,44430,152270,2.373,10.505,199773,57850,141923,3.090,10.670,-3073,-0.164,21.011,1248,1250,15260
1980,334,10010,11753,1746213,1680253,1604,13.938,1115,9.688,262780,65863,196917,3.920,15.639,129941,46671,83270,2.778,7.733,132839,7.906,15.467,737,740,15743
1980,335,4887,6140,775783,774549,542,8.898,444,7.289,79771,19455,60316,2.512,10.299,77006,20098,56908,2.595,9.942,2765,0.357,19.884,276,278,4610
1980,336,7876,9446,2023232,2121670,1002,10.614,990,10.487,164644,28063,136581,1.323,7.760,363503,39833,323670,1.877,17.133,-198859,-9.373,15.520,710,711,10016
1980,337,15303,16258,545622,553359,1967,12.148,1835,11.333,60337,18550,41787,3.352,10.904,75884,21331,54553,3.855,13.713,-15547,-2.810,21.808,1427,1433,12964
1980,339,22809,24039,672668,678414,2885,12.091,2530,10.603,88919,27268,61651,4.019,13.107,100453,27859,72594,4.106,14.807,-11534,-1.700,26.214,1930,1934,12269
1980,423,140978,180996,2288241,2275271,20275,11.336,15991,8.941,358131,121178,236953,5.326,15.740,332260,121186,211074,5.326,14.603,25871,1.137,29.206,10159,10312,51371
1980,424,90931,115847,1561736,1562349,11270,9.714,11606,10.004,234192,72288,161904,4.627,14.990,235195,85970,149225,5.503,15.054,-1003,-0.064,29.979,7777,7910,42441
1980,425,25704,28358,283241,281579,3251,11.656,2317,8.307,47813,15844,31969,5.627,16.980,44591,14127,30464,5.017,15.836,3222,1.144,31.672,1481,1487,6701
1980,441,93929,110492,1307149,1369173,9857,8.858,11438,10.278,142710,56830,85880,4.151,10.423,266419,73509,192910,5.369,19.458,-123709,-9.035,20.846,8334,8452,51953
1980,442,43708,50604,354103,353826,6459,12.883,5521,11.012,63661,26055,37606,7.364,17.992,62938,21445,41493,6.061,17.788,723,0.204,35.576,4194,4258,15611
1980,443,28043,37887,220583,222234,4375,11.493,4731,12.429,41450,17075,24375,7.683,18.652,44847,18117,26730,8.152,20.180,-3397,-1.529,37.303,3095,3189,10559
1980,444,72510,90693,819930,822973,8355,9.283,6972,7.747,120009,46855,73154,5.693,14.582,126228,36305,89923,4.411,15.338,-6219,-0.756,29.165,4909,5035,22945
1980,445,114235,156192,1992025,1965958,17733,11.348,17890,11.448,335254,152259,182995,7.745,17.053,282632,107942,174690,5.491,14.376,52622,2.677,28.753,12441,12643,54955
1980,446,46949,64706,568957,564819,6445,10.108,4556,7.145,89896,37115,52781,6.571,15.916,80554,24864,55690,4.402,14.262,9342,1.654,28.524,3030,3129,14957
1980,447,115363,153495,862187,895819,15964,10.243,20675,13.266,167558,78497,89061,8.763,18.704,234745,84672,150073,9.452,26.205,-67187,-7.500,37.409,14061,14480,56209
1980,448,90015,152576,1100391,1098681,18771,12.451,15132,10.037,212358,94890,117468,8.637,19.328,206367,66734,139633,6.074,18.783,5991,0.545,37.566,9561,10036,34913
1980,451,39599,50640,313110,308408,7600,15.159,6588,13.141,71932,31566,40366,10.235,23.324,61459,22776,38683,7.385,19.928,10473,3.396,39.856,4779,4931,15597
1980,452,16897,38786,1952634,1962351,3171,8.137,3537,9.076,183254,99143,84111,5.052,9.338,204485,41681,162804,2.124,10.420,-21231,-1.082,18.677,1822,1879,8170
1980,453,72139,82677,413416,409476,13095,16.113,10284,12.654,93164,42729,50435,10.435,22.752,85267,32185,53082,7.860,20.823,7897,1.929,41.647,7877,7998,23742
1980,454,27539,36148,383296,387190,3411,9.374,3893,10.698,59427,19619,39808,5.067,15.348,67196,23159,44037,5.981,17.355,-7769,-2.007,30.697,2749,2781,12368
1980,481,1384,2927,324012,315517,420,14.609,316,10.991,35230,4878,30352,1.546,11.166,17870,2070,15800,0.656,5.664,17360,5.502,11.327,175,176,1141
1980,483,841,1176,55160,53817,143,12.160,143,12.160,12755,5584,7171,10.376,23.701,10404,3349,7055,6.223,19.332,2351,4.369,38.664,68,69,728
1980,484,60555,69862,1069910,1099500,11330,16.255,11005,15.789,156308,57527,98781,5.232,14.216,216321,59177,157144,5.382,19.674,-60013,-5.458,28.433,8707,8764,37406
1980,485,11820,12623,242414,245342,1617,12.660,1917,15.008,37130,11705,25425,4.771,15.134,43144,15024,28120,6.124,17.585,-6014,-2.451,30.268,1600,1600,10079
1980,486,362,1605,72516,71431,119,7.501,82,5.169,7573,2128,5445,2.979,10.602,5470,1905,3565,2.667,7.658,2103,2.944,15.315,28,28,206
1980,487,974,997,12385,11432,186,19.106,139,14.278,3796,1684,2112,14.731,33.206,1914,712,1202,6.228,16.743,1882,16.463,33.486,104,104,425
1980,488,11358,14739,328948,327902,2239,15.432,1779,12.261,70716,27048,43668,8.249,21.566,68832,14804,54028,4.515,20.992,1884,0.575,41.983,1245,1251,8507
1980,492,1736,2257,63166,61606,644,29.664,472,21.741,9983,3424,6559,5.558,16.205,6833,3134,3699,5.087,11.091,3150,5.113,22.183,374,374,1474
1980,493,6202,9544,393105,394808,851,9.020,632,6.699,51331,15391,35940,3.898,13.002,54192,11875,42317,3.008,13.726,-2861,-0.725,26.003,326,328,1896
1980,511,17181,19735,665839,659806,3187,16.683,1923,10.066,78483,25628,52855,3.884,11.895,66296,24716,41580,3.746,10.048,12187,1.847,20.096,1369,1374,10680
1980,512,9858,15074,200112,202694,2277,15.216,2058,13.753,47020,17483,29537,8.625,23.198,52784,16224,36560,8.004,26.041,-5764,-2.844,46.395,1139,1215,8375
1980,515,5536,6487,193094,186566,639,9.992,455,7.115,31199,10795,20404,5.786,16.723,17810,6893,10917,3.695,9.546,13389,7.177,19.092,346,349,4510
1980,517,3452,16934,1067425,1048753,890,5.309,547,3.263,278015,7609,270406,0.726,26.509,241227,4031,237196,0.384,23.001,36788,3.508,46.003,365,367,2271
1980,518,5091,6664,194882,186744,1232,19.045,842,13.016,47571,21859,25712,11.705,25.474,31094,14793,16301,7.922,16.651,16477,8.823,33.301,486,489,5112
1980,519,2079,2463,27175,26889,230,9.477,158,6.510,3466,1079,2387,4.013,12.890,2920,1206,1714,4.485,10.860,546,2.031,21.719,111,111,896
1980,521,21,52,23790,23648,5,10.000,D,D,1036,555,481,2.347,4.381,765,D,344,D,3.235,271,1.146,6.470,0,0,0
1980,522,47522,110324,2128010,2080877,7389,6.761,5312,4.861,237185,70426,166759,3.384,11.398,143097,40638,102459,1.953,6.877,94088,4.522,13.754,2282,2327,11868
1980,523,14019,18540,275136,264450,3243,18.012,2172,12.064,63636,20711,42925,7.832,24.064,42019,16030,25989,6.062,15.889,21617,8.174,31.778,1587,1590,6714
1980,524,93567,121987,2220356,2183582,12543,10.370,10482,8.666,327823,90402,237421,4.140,15.013,254809,73454,181355,3.364,11.669,73014,3.344,23.339,6542,6577,28038
1980,525,591,790,9331,8110,67,8.422,78,9.805,3161,516,2645,6.363,38.979,712,273,439,3.366,8.780,2449,30.199,17.560,48,48,120
1980,531,159067,162981,857146,863286,24182,14.804,24918,15.254,198342,86815,111527,10.056,22.975,209950,88948,121002,10.303,24.320,-11608,-1.345,45.950,20344,20379,65867
1980,532,19261,25372,250524,247346,4373,17.545,3479,13.958,64480,22298,42182,9.015,26.069,58033,24839,33194,10.042,23.462,6447,2.606,46.925,2148,2177,11496
1980,533,855,911,9624,10025,158,17.146,179,19.425,3038,1178,1860,11.751,30.306,3920,2461,1459,24.550,39.104,-882,-8.798,60.612,142,142,933
1980,541,265503,281999,2581489,2520106,44585,16.193,31266,11.355,497917,184938,312979,7.339,19.758,374749,138891,235858,5.511,14.870,123168,4.887,29.741,22986,23124,88879
1980,551,20555,38896,2649333,2607973,3974,10.366,2855,7.447,417351,122159,295192,4.684,16.003,332589,96856,235733,3.714,12.753,84762,3.250,25.506,568,592,6517
1980,561,115911,129658,2143424,2092147,26152,20.861,17560,14.007,530182,191079,339103,9.133,25.342,428372,122062,306310,5.834,20.475,101810,4.866,40.950,13366,13426,73265
1980,562,11163,11908,173358,173733,1710,14.540,1415,12.032,26913,9014,17899,5.188,15.491,27564,8852,18712,5.095,15.866,-651,-0.375,30.982,1087,1088,5863
1980,611,31547,33581,1382196,1358667,3715,11.116,3395,10.158,158308,22081,136227,1.625,11.652,111969,22442,89527,1.652,8.241,46339,3.411,16.482,2657,2676,15679
1980,621,282076,292780,1588569,1554910,30200,10.552,17020,5.947,287506,110267,177239,7.092,18.490,220249,63809,156440,4.104,14.165,67257,4.325,28.329,12655,12729,45223
1980,622,4572,5609,2875333,2820680,235,4.200,207,3.700,205107,39837,165270,1.412,7.272,94241,38681,55560,1.371,3.341,110866,3.930,6.682,114,114,21802
1980,623,18998,24925,1200264,1188140,2379,9.662,1771,7.193,152391,55252,97139,4.650,12.826,128314,48325,79989,4.067,10.800,24077,2.026,21.599,1218,1256,32861
1980,624,40078,51381,739366,723946,6783,13.510,4436,8.835,147050,46743,100307,6.457,20.312,116532,29901,86631,4.130,16.097,30518,4.216,32.194,2978,3042,15973
1980,711,14252,14515,197060,193939,3352,23.738,2564,18.157,52107,18640,33467,9.611,26.868,45945,15289,30656,7.883,23.690,6162,3.177,47.381,1924,1931,10327
1980,712,1851,1963,31513,31293,156,8.025,118,6.070,4182,613,3569,1.959,13.364,3679,594,3085,1.898,11.757,503,1.607,23.513,80,80,303
1980,713,30284,32141,488851,485602,4275,13.489,3380,10.665,88007,31611,56396,6.510,18.123,81559,25087,56472,5.166,16.795,6448,1.328,33.591,2515,2528,16528
1980,721,38193,42332,1075517,1064822,4908,11.518,5466,12.828,202040,80971,121069,7.604,18.974,180849,69230,111619,6.502,16.984,21191,1.990,33.968,3952,3972,43526
1980,722,254116,312043,4571609,4532994,50623,16.303,47580,15.323,1103581,613139,490442,13.526,24.346,1028857,415206,613651,9.160,22.697,74724,1.648,45.394,34643,35204,265990
1980,811,135472,143161,767889,778138,22270,15.649,20570,14.454,154217,71217,83000,9.152,19.819,175204,66788,108416,8.583,22.516,-20987,-2.697,39.637,15924,15976,50547
1980,812,146443,168713,1041253,1045913,21625,12.840,21044,12.495,188033,84901,103132,8.117,17.978,197178,72961,124217,6.976,18.852,-9145,-0.874,35.956,15970,16186,52583
1980,813,166024,171998,1544478,1525763,11501,6.738,8883,5.204,243801,49569,194232,3.249,15.979,206289,34761,171528,2.278,13.520,37512,2.459,27.041,5680,5692,20070
1981,113,11133,11275,95070,98942,1521,13.126,2146,18.520,18105,6041,12064,6.106,18.299,25997,9382,16615,9.482,26.275,-7892,-7.976,36.597,1545,1545,6190
1981,114,1569,1603,10760,11118,297,18.154,363,22.188,3346,1322,2024,11.891,30.097,4079,1632,2447,14.680,36.690,-733,-6.593,60.193,255,256,1064
1981,115,6525,6934,73197,72539,992,14.319,980,14.145,20127,7414,12713,10.221,27.746,18729,8362,10367,11.528,25.819,1398,1.927,51.638,686,688,4260
1981,211,6841,8765,164000,150796,1601,19.251,704,8.465,40841,12908,27933,8.560,27.084,14839,7264,7575,4.817,9.840,26002,17.243,19.681,424,430,2430
1981,212,7174,9690,432544,433222,1406,14.612,1270,13.199,66097,21346,44751,4.927,15.257,67207,20255,46952,4.675,15.513,-1110,-0.256,30.514,850,856,10156
1981,213,10132,11542,360636,323340,3169,30.092,1147,10.892,124914,45602,79312,14.103,38.632,49853,20335,29518,6.289,15.418,75061,23.214,30.836,800,806,11800
1981,221,5957,12293,722431,712097,628,5.142,467,3.824,44030,9482,34548,1.332,6.183,23486,6418,17068,0.901,3.298,20544,2.885,6.596,258,259,1364
1981,236,128564,129526,1148722,1187521,22406,16.694,31784,23.681,310844,103856,206988,8.746,26.176,387768,124273,263495,10.465,32.654,-76924,-6.478,52.352,24152,24157,95710
1981,237,36373,37342,744357,746247,5287,14.137,5400,14.439,175379,44888,130491,6.015,23.501,177977,38257,139720,5.127,23.850,-2598,-0.348,47.003,4059,4062,24165
1981,238,256617,259604,2382510,2415626,34570,13.086,43721,16.550,560627,162192,398435,6.714,23.208,625553,180307,445246,7.464,25.896,-64926,-2.688,46.417,32725,32746,137556
1981,311,21005,26982,1339980,1348946,2557,9.507,2386,8.871,139494,46895,92599,3.476,10.341,156865,46574,110291,3.453,11.629,-17371,-1.288,20.682,1592,1620,20334
1981,312,2288,2943,230116,230540,202,6.856,209,7.093,20488,6357,14131,2.757,8.887,21199,8303,12896,3.602,9.195,-711,-0.308,17.774,152,154,3488
1981,313,5662,7025,608957,624628,570,8.204,415,5.973,40836,13358,27478,2.139,6.538,71653,18547,53106,2.969,11.471,-30817,-4.934,13.075,254,256,5471
1981,314,7710,8156,244765,252748,953,11.652,999,12.214,31150,13376,17774,5.292,12.325,47068,16124,30944,6.379,18.623,-15918,-6.298,24.649,792,795,8806
1981,315,16687,18883,1175828,1182822,2629,14.102,2148,11.522,163881,66172,97709,5.594,13.855,177500,59276,118224,5.011,15.006,-13619,-1.151,27.710,1737,1750,36339
1981,316,2246,2607,229027,230189,267,10.305,235,9.070,30253,7393,22860,3.212,13.143,32199,10067,22132,4.373,13.988,-1946,-0.845,26.285,171,174,3920
1981,321,14909,16760,508820,526657,1902,11.340,1926,11.483,64003,24790,39213,4.707,12.153,99562,26789,72773,5.087,18.905,-35559,-6.752,24.305,1433,1444,13234
1981,322,3731,5785,614884,623632,373,6.459,352,6.096,37534,11122,26412,1.783,6.019,55245,13052,42193,2.093,8.859,-17711,-2.840,12.037,174,178,3417
1981,323,32189,33607,655602,648535,4140,12.614,2566,7.818,87036,33397,53639,5.150,13.420,73012,22379,50633,3.451,11.258,14024,2.162,22.516,1953,1959,12065
1981,324,1368,2150,156445,151190,235,11.088,174,8.209,21682,5791,15891,3.830,14.341,10916,2344,8572,1.550,7.220,10766,7.121,14.440,81,81,638
1981,325,8102,11742,944556,950847,1038,8.945,762,6.567,72896,19657,53239,2.067,7.666,85268,15290,69978,1.608,8.968,-12372,-1.301,15.333,435,443,4628
1981,326,11467,13414,709831,728263,1456,11.042,1000,7.584,78187,25290,52897,3.473,10.736,116138,33328,82810,4.576,15.947,-37951,-5.211,21.472,681,683,9964
1981,327,12262,15341,554925,567021,1400,9.181,1217,7.981,55211,19612,35599,3.459,9.737,79152,16727,62425,2.950,13.959,-23941,-4.222,19.474,862,866,7671
1981,331,4815,6034,993245,1028982,522,8.760,372,6.243,54038,18888,35150,1.836,5.252,126395,28501,97894,2.770,12.283,-72357,-7.032,10.503,241,245,6195
1981,332,47524,51557,1793750,1824624,5607,11.065,3838,7.574,194838,67284,127554,3.688,10.678,257087,48103,208984,2.636,14.090,-62249,-3.412,21.357,2899,2913,25586
1981,333,26559,29600,1809869,1839387,2906,10.001,1823,6.274,208933,75829,133104,4.123,11.359,266972,57128,209844,3.106,14.514,-58039,-3.155,22.718,1304,1308,14365
1981,334,10797,12620,1740829,1740834,1888,15.501,1008,8.276,200687,66912,133775,3.844,11.528,200993,55493,145500,3.188,11.546,-306,-0.018,23.056,681,682,13143
1981,335,5114,6384,746349,763370,655,10.440,435,6.933,67932,24901,43031,3.262,8.899,101342,25061,76281,3.283,13.276,-33410,-4.377,17.798,276,277,4786
1981,336,7991,9532,1932721,1977637,1061,11.196,950,10.025,176960,43109,133851,2.180,8.948,266671,53516,213155,2.706,13.484,-89711,-4.536,17.896,672,673,11467
1981,337,15531,16501,525325,537239,2020,12.317,1817,11.080,61130,25688,35442,4.781,11.379,84806,23477,61329,4.370,15.786,-23676,-4.407,22.757,1424,1427,13201
1981,339,23363,24585,660821,665364,3122,12.847,2554,10.510,87959,29861,58098,4.488,13.220,97224,29037,68187,4.364,14.612,-9265,-1.392,26.439,1918,1923,12949
1981,423,145362,186912,2319346,2300951,22448,12.206,16448,8.943,384801,157434,227367,6.842,16.724,347415,114621,232794,4.981,15.099,37386,1.625,30.198,11030,11241,54731
1981,424,91713,116902,1605363,1582451,12371,10.639,11124,9.567,273262,101976,171286,6.444,17.268,228105,80889,147216,5.112,14.415,45157,2.854,28.829,7798,7960,45511
1981,425,26798,29586,291252,287205,3576,12.344,2341,8.081,52389,19644,32745,6.840,18.241,44156,12952,31204,4.510,15.374,8233,2.867,30.749,1597,1602,7636
1981,441,91470,108002,1226824,1265100,9417,8.629,11675,10.698,153527,63087,90440,4.987,12.136,229988,80547,149441,6.367,18.179,-76461,-6.044,24.271,8742,8918,60975
1981,442,43063,50496,342039,347761,5691,11.265,5741,11.364,56478,23397,33081,6.728,16.240,67896,23684,44212,6.810,19.524,-11418,-3.283,32.481,4445,4532,17209
1981,443,27739,37779,215079,217944,4417,11.685,4462,11.804,39001,18546,20455,8.510,17.895,44834,16939,27895,7.772,20.571,-5833,-2.676,35.790,3070,3271,11379
1981,444,72763,91640,813823,816513,7874,8.637,6922,7.593,115971,45811,70160,5.611,14.203,121439,32536,88903,3.985,14.873,-5468,-0.670,28.406,5166,5266,21428
1981,445,113645,157411,2034865,2017932,19333,12.327,18176,11.589,338476,157617,180859,7.811,16.773,303565,113532,190033,5.626,15.043,34911,1.730,30.087,12359,12616,55327
1981,446,47507,66657,567858,568342,6875,10.488,4667,7.119,86237,38274,47963,6.734,15.173,87132,26153,60979,4.602,15.331,-895,-0.157,30.347,3211,3292,15944
1981,447,110556,150871,878419,869434,17266,11.355,19641,12.917,196489,83922,112567,9.652,22.600,178067,75890,102177,8.729,20.481,18422,2.119,40.962,13501,13796,50481
1981,448,89146,156072,1100008,1098983,19381,12.569,15620,10.130,212894,104508,108386,9.510,19.372,211374,66937,144437,6.091,19.234,1520,0.138,38.467,10020,10956,39864
1981,451,39708,51372,317774,315148,7355,14.428,6564,12.877,66525,28433,38092,9.022,21.109,61123,22813,38310,7.239,19.395,5402,1.714,38.790,4883,5044,15247
1981,452,16282,38589,1935866,1944028,3081,7.969,3223,8.337,198756,113339,85417,5.830,10.224,214880,38091,176789,1.959,11.053,-16124,-0.829,20.448,1820,1859,6849
1981,453,73475,84373,419727,416394,12422,14.866,10791,12.914,92126,40722,51404,9.780,22.125,85535,33496,52039,8.044,20.542,6591,1.583,41.084,8196,8349,24201
1981,454,27051,35727,375556,378722,3592,10.012,3895,10.856,57511,19396,38115,5.121,15.186,63534,21116,42418,5.576,16.776,-6023,-1.590,30.371,2747,2774,11570
1981,481,1443,3090,311723,317826,465,15.464,299,9.943,17581,5171,12410,1.627,5.532,29399,4184,25215,1.316,9.250,-11818,-3.718,11.063,209,210,2171
1981,483,826,1158,53340,54338,125,10.841,115,9.974,9223,3003,6220,5.527,16.974,10941,2768,8173,5.094,20.135,-1718,-3.162,33.947,69,70,1152
1981,484,59787,69420,1030054,1049865,10564,15.168,11019,15.821,157745,60667,97078,5.779,15.025,197315,62353,134962,5.939,18.794,-39570,-3.769,30.051,8547,8574,37087
1981,485,11447,12248,243744,246796,1488,11.962,1870,15.033,36389,13201,23188,5.349,14.745,42975,16946,26029,6.866,17.413,-6586,-2.669,29.489,1536,1539,9496
1981,486,356,1747,75192,73514,220,13.123,79,4.712,7802,2721,5081,3.701,10.613,4395,971,3424,1.321,5.978,3407,4.634,11.957,28,28,278
1981,487,978,1004,12385,12419,154,15.446,140,14.042,2843,875,1968,7.046,22.893,2896,1164,1732,9.373,23.320,-53,-0.427,45.787,115,115,691
1981,488,11675,15094,320764,324078,2199,14.774,1779,11.952,57417,19339,38078,5.967,17.717,64167,16895,47272,5.213,19.800,-6750,-2.083,35.434,1224,1234,10113
1981,492,1860,2459,64048,63687,651,27.602,450,19.080,9492,3410,6082,5.354,14.904,8734,2874,5860,4.513,13.714,758,1.190,27.428,373,373,1689
1981,493,6297,9771,392058,393445,811,8.404,570,5.906,51546,20023,31523,5.089,13.101,54307,8464,45843,2.151,13.803,-2761,-0.702,26.202,281,283,1906
1981,511,18693,21395,690130,677289,3769,18.329,2105,10.237,88165,32358,55807,4.778,13.017,62695,22235,40460,3.283,9.257,25470,3.761,18.514,1557,1576,10872
1981,512,10305,15562,201337,201251,2428,15.852,1937,12.646,52447,22688,29759,11.273,26.060,52022,15621,36401,7.762,25.849,425,0.211,51.699,1152,1194,7637
1981,515,5667,6678,201383,197320,680,10.322,500,7.590,29878,12036,17842,6.100,15.142,21896,7608,14288,3.856,11.097,7982,4.045,22.193,388,395,4997
1981,517,3596,16924,1126641,1096327,880,5.202,862,5.096,277943,11183,266760,1.020,25.352,223698,9654,214044,0.881,20.404,54245,4.948,40.809,397,398,5048
1981,518,5495,7192,198149,197534,1394,20.110,874,12.608,39394,16775,22619,8.492,19.943,38457,14289,24168,7.234,19.469,937,0.474,38.937,515,520,4497
1981,519,2168,2551,28080,27625,257,10.259,165,6.587,3739,1089,2650,3.942,13.535,2783,703,2080,2.545,10.074,956,3.461,20.148,121,121,460
1981,521,22,58,25204,24609,8,14.815,0,0.000,1342,234,1108,0.951,5.453,125,0,125,0.000,0.508,1217,4.945,1.016,0,0,0
1981,522,46981,112150,2206575,2167560,7914,7.115,6069,5.456,252819,81116,171703,3.742,11.664,174753,49675,125078,2.292,8.062,78066,3.602,16.124,2671,2723,16405
1981,523,15342,20227,322766,300165,3904,20.140,2218,11.442,78669,23743,54926,7.910,26.209,33265,12399,20866,4.131,11.082,45404,15.126,22.164,1652,1655,6258
1981,524,94477,123524,2342455,2271863,12881,10.495,11303,9.209,422931,122357,300574,5.386,18.616,283458,111691,171767,4.916,12.477,139473,6.139,24.954,6986,7025,43530
1981,525,614,803,11946,11789,71,8.864,67,8.365,1817,378,1439,3.206,15.413,1549,289,1260,2.451,13.139,268,2.273,26.279,37,38,87
1981,531,155673,159751,868748,860137,22327,13.852,25198,15.633,203889,92575,111314,10.763,23.704,186726,81609,105117,9.488,21.709,17163,1.995,43.418,20198,20294,59713
1981,532,19789,26392,263095,256357,4365,16.882,3293,12.736,61436,26270,35166,10.247,23.965,48280,18218,30062,7.107,18.833,13156,5.132,37.666,2295,2320,9925
1981,533,885,936,9345,9539,167,18.044,146,15.775,2196,821,1375,8.607,23.021,2552,1144,1408,11.993,26.753,-356,-3.732,46.043,112,113,513
1981,541,277791,295631,2754113,2667522,47579,16.483,33644,11.655,559725,217256,342469,8.144,20.983,385366,138524,246842,5.193,14.447,174359,6.536,28.893,25244,25420,90298
1981,551,21463,41359,2768294,2713183,4934,12.260,2707,6.726,457415,157298,300117,5.798,16.859,346346,66479,279867,2.450,12.765,111069,4.094,25.531,565,576,5837
1981,561,123459,138251,2179099,2158567,27488,20.517,18942,14.138,520587,204075,316512,9.454,24.117,479345,136474,342871,6.322,22.207,41242,1.911,44.413,14505,14614,85101
1981,562,11217,12006,174491,173866,1596,13.341,1510,12.622,28522,9743,18779,5.604,16.405,27329,9053,18276,5.207,15.718,1193,0.686,31.437,1183,1186,6109
1981,611,31927,34035,1449874,1418870,3758,11.098,3413,10.079,166693,25598,141095,1.804,11.748,104225,21933,82292,1.546,7.346,62468,4.403,14.691,2638,2662,14299
1981,621,296522,308058,1711445,1653485,33050,11.002,17752,5.909,331762,133522,198240,8.075,20.064,215360,66153,149207,4.001,13.025,116402,7.040,26.049,13352,13442,46302
1981,622,4587,5729,3041013,2966007,300,5.286,192,3.383,245531,54518,191013,1.838,8.278,93729,34934,58795,1.178,3.160,151802,5.118,6.320,123,127,24864
1981,623,19604,26170,1276714,1238273,2996,11.732,1728,6.767,196138,91255,104883,7.370,15.840,118387,49124,69263,3.967,9.561,77751,6.279,19.121,1243,1283,34927
1981,624,41409,53464,762479,749456,6909,13.198,4678,8.936,148492,50968,97524,6.801,19.813,121636,30296,91340,4.042,16.230,26856,3.583,32.460,3312,3353,16666
1981,711,15060,15327,207482,202553,3502,23.474,2685,17.998,55653,23503,32150,11.603,27.476,45869,15420,30449,7.613,22.645,9784,4.830,45.291,1974,1979,10115
1981,712,1846,1961,33486,32521,150,7.665,142,7.256,5297,616,4681,1.894,16.288,3510,780,2730,2.398,10.793,1787,5.495,21.586,94,94,474
1981,713,31018,32975,504348,496905,4237,13.022,3359,10.324,90522,35711,54811,7.187,18.217,74968,21055,53913,4.237,15.087,15554,3.130,30.174,2513,2529,14628
1981,721,37583,41864,1097121,1086396,4711,11.198,5125,12.182,203261,97374,105887,8.963,18.710,181987,63705,118282,5.864,16.751,21274,1.958,33.503,3825,3858,43457
1981,722,255206,315948,4661671,4615550,50857,16.200,46833,14.918,1052277,599276,453001,12.984,22.799,959801,395918,563883,8.578,20.795,92476,2.004,41.590,34573,35273,270313
1981,811,135709,143691,768778,767560,21507,15.001,20860,14.550,161542,73827,87715,9.618,21.046,159476,64762,94714,8.437,20.777,2066,0.269,41.554,15952,16005,47680
1981,812,144865,167491,1073096,1056838,20567,12.243,21575,12.843,215746,91892,123854,8.695,20.414,183556,76613,106943,7.249,17.368,32190,3.046,34.737,16298,16658,56924
1981,813,167862,174216,1562976,1555205,12299,7.102,10234,5.909,238285,58750,179535,3.778,15.322,222780,47533,175247,3.056,14.325,15505,0.997,28.650,6411,6434,29917
1982,113,10152,10292,83479,88094,1307,12.180,2185,20.362,16420,5418,11002,6.150,18.639,25551,8539,17012,9.693,29.004,-9131,-10.365,37.279,1493,1493,5837
1982,114,1484,1524,10377,10324,268,17.414,298,19.363,3517,1169,2348,11.324,34.068,3394,1322,2072,12.806,32.876,123,1.191,65.753,232,232,1056
1982,115,6325,6798,75871,74013,1025,15.121,986,14.546,22847,9491,13356,12.824,30.869,19157,6762,12395,9.136,25.883,3690,4.986,51.767,690,695,4484
1982,211,7509,9559,184204,174010,1738,18.902,1010,10.984,52123,18439,33684,10.597,29.954,31713,12011,19702,6.902,18.225,20410,11.729,36.450,621,635,3995
1982,212,7261,9721,414371,424194,1381,14.235,1342,13.833,62695,22317,40378,5.261,14.780,82501,23423,59078,5.522,19.449,-19806,-4.669,29.560,874,876,9604
1982,213,11914,13531,416774,388744,3667,29.209,1714,13.652,143837,49789,94048,12.808,37.000,88565,37522,51043,9.652,22.782,55272,14.218,45.565,1259,1263,18605
1982,221,5859,12240,747598,735518,449,3.670,439,3.588,47955,7461,40494,1.014,6.520,24210,4792,19418,0.652,3.292,23745,3.228,6.583,282,282,1590
1982,236,111103,112201,969496,1041353,17082,14.293,31707,26.530,247696,80948,166748,7.773,23.786,391932,134025,257907,12.870,37.637,-144236,-13.851,47.572,22142,22146,99790
1982,237,33542,34430,649909,673777,4743,13.506,6117,17.419,137987,38042,99945,5.646,20.480,185553,43967,141586,6.525,27.539,-47566,-7.060,40.959,4420,4426,28331
1982,238,245161,248477,2271358,2341954,32468,12.734,45475,17.835,538201,146423,391778,6.252,22.981,679610,191885,487725,8.193,29.019,-141409,-6.038,45.962,31732,31749,139223
1982,311,20852,26624,1320647,1323724,2437,9.126,2595,9.718,152765,35890,116875,2.711,11.541,158118,47626,110492,3.598,11.945,-5353,-0.404,23.081,1740,1770,17778
1982,312,2142,2783,225570,227945,168,5.937,261,9.224,18608,4174,14434,1.831,8.163,23176,6984,16192,3.064,10.167,-4568,-2.004,16.327,180,182,2974
1982,313,5723,7046,551933,573790,489,6.981,407,5.810,33667,10149,23518,1.769,5.867,77523,16586,60937,2.891,13.511,-43856,-7.643,11.735,251,253,5715
1982,314,7292,7712,221508,226121,798,10.173,1063,13.551,29609,9043,20566,3.999,13.094,39045,11668,27377,5.160,17.267,-9436,-4.173,26.189,835,840,7591
1982,315,18250,20472,1274045,1295671,2213,10.739,2482,12.045,161430,50602,110828,3.905,12.459,204372,65311,139061,5.041,15.773,-42942,-3.314,24.918,1986,2006,41824
1982,316,2124,2470,211343,217566,229,9.195,270,10.841,22198,5320,16878,2.445,10.203,34810,8226,26584,3.781,16.000,-12612,-5.797,20.406,202,203,3999
1982,321,14146,15926,436651,471403,1418,8.695,2182,13.380,46637,16091,30546,3.413,9.893,116244,29132,87112,6.180,24.659,-69607,-14.766,19.786,1549,1554,14571
1982,322,3766,5818,603639,613575,273,4.671,327,5.595,37906,6116,31790,0.997,6.178,57530,11056,46474,1.802,9.376,-19624,-3.198,12.356,195,201,2818
1982,323,33321,34852,682292,680813,3905,11.353,2995,8.707,84496,23030,61466,3.383,12.411,81595,24581,57014,3.611,11.985,2901,0.426,23.970,2333,2338,15091
1982,324,1366,2212,150259,156474,203,9.236,175,7.962,10530,3299,7231,2.108,6.730,22690,6068,16622,3.878,14.501,-12160,-7.771,13.459,91,95,1441
1982,325,7980,11573,886389,894641,909,7.830,980,8.442,71969,19282,52687,2.155,8.044,88507,22548,65959,2.520,9.893,-16538,-1.849,16.089,557,561,5689
1982,326,11708,13636,675003,691588,1195,8.795,1096,8.067,69153,21344,47809,3.086,9.999,102367,25846,76521,3.737,14.802,-33214,-4.803,19.998,772,779,11219
1982,327,11872,14910,493608,522307,1104,7.320,1448,9.601,43011,13002,30009,2.489,8.235,100748,19071,81677,3.651,19.289,-57737,-11.054,16.470,983,997,8977
1982,331,4639,5813,855558,916277,381,6.523,436,7.465,38565,8182,30383,0.893,4.209,160451,19008,141443,2.074,17.511,-121886,-13.302,8.418,296,297,5085
1982,332,48700,52806,1678221,1732865,4867,9.262,4354,8.286,173271,49798,123473,2.874,9.999,283459,65876,217583,3.802,16.358,-110188,-6.359,19.998,3263,3270,34313
1982,333,25681,28757,1693164,1750255,2313,8.056,2223,7.742,148293,39481,108812,2.256,8.473,260862,48530,212332,2.773,14.904,-112569,-6.432,16.945,1615,1621,17936
1982,334,11292,13241,1781837,1769582,1715,13.221,1176,9.066,214030,51508,162522,2.911,12.095,189325,45597,143728,2.577,10.699,24705,1.396,21.398,812,814,13398
1982,335,5168,6445,689280,714233,544,8.496,460,7.184,55010,13137,41873,1.839,7.702,105115,15305,89810,2.143,14.717,-50105,-7.015,15.404,303,305,4192
1982,336,8032,9517,1789403,1866861,801,8.358,935,9.756,131207,29220,101987,1.565,7.028,285460,62187,223273,3.331,15.291,-154253,-8.263,14.056,657,659,8272
1982,337,15104,16046,490204,512297,1666,10.203,2230,13.658,49493,15151,34342,2.957,9.661,93245,26563,66682,5.185,18.201,-43752,-8.540,19.322,1691,1701,15897
1982,339,23495,24699,622601,630373,3107,12.652,2825,11.503,85061,28520,56541,4.524,13.494,100612,28807,71805,4.570,15.961,-15551,-2.467,26.988,2171,2178,15697
1982,423,147792,189966,2276674,2297331,22028,11.662,19867,10.518,386747,139014,247733,6.051,16.835,428884,141328,287556,6.152,18.669,-42137,-1.834,33.669,12919,13117,68376
1982,424,92843,118317,1645960,1635796,12303,10.384,12626,10.657,290799,90858,199941,5.554,17.777,271036,95704,175332,5.851,16.569,19763,1.208,33.138,8321,8458,49830
1982,425,27170,29885,287479,287514,3552,12.026,2853,9.660,51749,16770,34979,5.833,17.999,51674,16970,34704,5.902,17.973,75,0.026,35.945,1860,1867,9658
1982,441,90216,108738,1224043,1224832,11846,10.906,11607,10.686,190000,78246,111754,6.388,15.512,192762,71368,121394,5.827,15.738,-2762,-0.226,31.025,8288,8455,53351
1982,442,41903,49853,328717,335374,5728,11.396,6551,13.033,59652,23057,36595,6.875,17.787,72767,25201,47566,7.514,21.697,-13115,-3.911,35.573,4795,4944,17290
1982,443,27317,38785,212337,213035,6272,16.435,5027,13.173,51754,26318,25436,12.354,24.294,52923,19762,33161,9.276,24.842,-1169,-0.549,48.587,3130,3326,11874
1982,444,71721,90630,781673,796026,7438,8.157,8559,9.386,112888,41402,71486,5.201,14.181,142102,40509,101593,5.089,17.851,-29214,-3.670,28.363,5967,6098,25048
1982,445,113252,157701,2059055,2048813,18722,11.860,19044,12.064,351080,147878,203202,7.218,17.136,327576,128155,199421,6.255,15.989,23504,1.147,31.977,13632,13818,64721
1982,446,49287,71115,583845,579788,7097,10.090,5534,7.868,97415,39475,57940,6.809,16.802,88396,27260,61136,4.702,15.246,9019,1.556,30.493,3733,3817,17229
1982,447,102323,143666,857372,865495,16217,11.061,22111,15.081,190773,79782,110991,9.218,22.042,206218,90703,115515,10.480,23.827,-15445,-1.785,44.084,15614,16037,59561
1982,448,88075,157723,1118450,1118463,18349,11.651,17880,11.353,222730,99171,123559,8.867,19.914,220385,76718,143667,6.859,19.704,2345,0.210,39.409,10834,11606,42015
1982,451,39690,53705,322109,320154,9167,17.426,6968,13.246,73271,36994,36277,11.555,22.886,70517,24262,46255,7.578,22.026,2754,0.860,44.052,5083,5212,17020
1982,452,14572,36073,1862815,1889402,2799,7.676,3586,9.834,188834,80077,108757,4.238,9.994,245849,59649,186200,3.157,13.012,-57015,-3.018,19.989,1866,1923,12600
1982,453,69924,80604,412392,411434,12091,14.939,12757,15.762,97786,42065,55721,10.224,23.767,95454,40053,55401,9.735,23.200,2332,0.567,46.401,9650,9812,28947
1982,454,26636,35578,373580,378779,3586,9.997,4172,11.631,64386,22778,41608,6.014,16.998,75075,23337,51738,6.161,19.820,-10689,-2.822,33.997,2821,2852,12352
1982,481,1473,3256,297034,303604,463,14.535,322,10.108,19809,4315,15494,1.421,6.525,32628,3116,29512,1.026,10.747,-12819,-4.222,13.049,217,223,1772
1982,483,785,1122,54464,54120,108,9.549,126,11.141,8893,1933,6960,3.572,16.432,8399,2067,6332,3.819,15.519,494,0.913,31.038,83,83,1161
1982,484,59044,69041,1000495,1019557,10605,15.302,11128,16.057,152747,55491,97256,5.443,14.982,190901,57477,133424,5.637,18.724,-38154,-3.742,29.963,8561,8626,38887
1982,485,10953,11739,234273,239046,1296,10.850,1708,14.299,34075,11590,22485,4.848,14.255,43695,14529,29166,6.078,18.279,-9620,-4.024,28.509,1361,1364,8848
1982,486,331,1829,79062,77276,179,10.022,93,5.207,8319,2707,5612,3.503,10.765,4843,1548,3295,2.003,6.267,3476,4.498,12.534,35,35,530
1982,487,945,973,11812,12018,160,16.260,182,18.496,2420,806,1614,6.707,20.136,2766,1339,1427,11.142,23.015,-346,-2.879,40.273,154,154,901
1982,488,11891,15399,317527,319602,2221,14.636,1773,11.684,55725,17469,38256,5.466,17.436,59662,16716,42946,5.230,18.668,-3937,-1.232,34.872,1294,1306,10728
1982,492,1814,2456,67940,66606,538,21.759,571,23.094,9782,2425,7357,3.641,14.686,7050,2724,4326,4.090,10.585,2732,4.102,21.169,459,460,2117
1982,493,6093,9710,376369,381558,919,9.580,685,7.141,54982,18244,36738,4.781,14.410,65335,10907,54428,2.859,17.123,-10353,-2.713,28.820,292,292,1974
1982,511,19807,22827,717199,703084,3746,16.869,2504,11.276,99099,35328,63771,5.025,14.095,70383,21268,49115,3.025,10.011,28716,4.084,20.021,1868,1879,12328
1982,512,10455,15894,201254,203229,2439,15.481,2160,13.710,52143,20318,31825,9.998,25.657,56133,17091,39042,8.410,27.621,-3990,-1.963,51.315,1350,1388,9261
1982,515,5781,6845,209157,204938,804,11.940,581,8.628,29951,12373,17578,6.037,14.615,21713,8217,13496,4.010,10.595,8238,4.020,21.190,470,475,6147
1982,517,3584,17011,1091185,1109140,820,4.838,693,4.089,92879,10171,82708,0.917,8.374,128152,8361,119791,0.754,11.554,-35273,-3.180,16.748,496,499,4660
1982,518,5687,7472,210637,204314,1275,17.489,912,12.509,48787,18498,30289,9.054,23.878,36626,10866,25760,5.318,17.926,12161,5.952,35.853,561,583,4845
1982,519,1890,2109,22361,21988,214,10.092,237,11.177,3511,1076,2435,4.894,15.968,2822,1088,1734,4.948,12.834,689,3.134,25.669,172,172,749
1982,521,30,66,24624,25026,5,7.752,D,D,198,27,171,0.108,0.791,983,D,834,D,3.928,-785,-3.137,1.582,D,D,D
1982,522,46140,111078,2228975,2220145,5730,5.129,7007,6.272,211504,51144,160360,2.304,9.527,193957,52725,141232,2.375,8.736,17547,0.790,17.472,2832,2920,23032
1982,523,16702,21874,370428,351432,4131,19.588,2561,12.144,85010,32020,52990,9.111,24.190,46907,15379,31528,4.376,13.347,38103,10.842,26.695,1980,1995,9538
1982,524,93920,122889,2132655,2116721,12318,10.030,12165,9.905,316130,93721,222409,4.428,14.935,281991,90597,191394,4.280,13.322,34139,1.613,26.644,7907,7923,36870
1982,525,612,805,10340,11009,87,10.943,67,8.428,1779,402,1377,3.652,16.160,3074,2329,745,21.156,27.924,-1295,-11.764,32.320,54,54,138
1982,531,147679,151986,842114,854352,19734,12.704,26442,17.022,184343,76309,108034,8.932,21.577,208016,88055,119961,10.307,24.348,-23673,-2.771,43.154,21159,21200,67551
1982,532,20803,27991,270949,269124,4782,17.454,3597,13.128,61960,25551,36409,9.494,23.023,58192,21384,36808,7.946,21.623,3768,1.400,43.245,2535,2572,12356
1982,533,879,937,10906,10327,187,20.493,138,15.123,2942,1211,1731,11.727,28.488,1775,843,932,8.163,17.188,1167,11.300,34.376,109,109,514
1982,541,279427,298145,2659810,2620822,48508,16.529,39178,13.349,574024,230411,343613,8.792,21.902,498633,188532,310101,7.194,19.026,75391,2.877,38.052,29529,29690,122142
1982,551,22131,42820,2807631,2794058,4660,11.058,3305,7.842,522373,182875,339498,6.545,18.696,492294,116340,375954,4.164,17.619,30079,1.077,35.239,644,657,8487
1982,561,135204,152178,2390485,2359946,28816,19.437,20969,14.144,575818,200485,375333,8.495,24.400,515699,158170,357529,6.702,21.852,60119,2.547,43.704,15933,15991,92421
1982,562,11140,11957,169047,169892,1588,13.299,1555,13.023,28066,9260,18806,5.451,16.520,29601,11214,18387,6.601,17.423,-1535,-0.904,33.040,1194,1194,7958
1982,611,31671,34126,1494966,1484195,3703,10.872,3572,10.487,157772,27144,130628,1.829,10.630,135950,22796,113154,1.536,9.160,21822,1.470,18.320,2732,2744,15146
1982,621,309075,321917,1828705,1775952,34847,11.053,21536,6.831,363274,139288,223986,7.843,20.455,259433,84079,175354,4.734,14.608,103841,5.847,29.216,16718,16836,61891
1982,622,4402,5689,3172730,3104982,309,5.484,200,3.550,235816,49117,186699,1.582,7.595,99176,28659,70517,0.923,3.194,136640,4.401,6.388,133,133,19292
1982,623,19738,27139,1324576,1307700,2628,9.805,1958,7.305,182626,79722,102904,6.096,13.965,148476,54359,94117,4.157,11.354,34150,2.611,22.708,1411,1429,39434
1982,624,43276,56128,760039,775123,6626,11.932,5437,9.790,142087,44230,97857,5.706,18.331,171615,40706,130909,5.252,22.140,-29528,-3.809,36.662,3835,3932,28467
1982,711,14636,14946,211508,210269,3291,21.883,3477,23.120,52895,17835,35060,8.482,25.156,50218,18322,31896,8.714,23.883,2677,1.273,47.766,2615,2622,14365
1982,712,1810,1934,33878,33875,155,8.042,142,7.367,5185,855,4330,2.524,15.306,5154,800,4354,2.362,15.215,31,0.092,30.430,94,94,523
1982,713,32602,35001,524528,513418,5439,15.957,3608,10.585,101484,39998,61486,7.791,19.766,79501,24292,55209,4.731,15.485,21983,4.282,30.969,2785,2800,18704
1982,721,36442,40984,1125868,1112237,4671,11.318,5245,12.709,219726,96946,122780,8.716,19.755,193542,77527,116015,6.970,17.401,26184,2.354,34.802,3905,3947,48677
1982,722,252234,315866,4717963,4692315,49323,15.604,49757,15.742,1126329,588135,538194,12.534,24.004,1070689,442534,628155,9.431,22.818,55640,1.186,45.636,37628,38238,299323
1982,811,135211,143318,754198,752499,21204,14.796,21190,14.786,165998,69849,96149,9.282,22.060,162572,67569,95003,8.979,21.604,3426,0.455,43.209,16222,16266,49943
1982,812,144578,167879,1107956,1108061,21462,12.733,22825,13.541,225851,97202,128649,8.772,20.383,224464,83190,141274,7.508,20.257,1387,0.125,40.515,16994,17217,57454
1982,813,170501,177045,1595411,1585014,12862,7.320,10171,5.789,253688,58081,195607,3.664,16.005,231550,39229,192321,2.475,14.609,22138,1.397,29.217,6359,6382,25117
1983,113,10305,10440,85841,84888,1658,15.971,1540,14.835,21450,6847,14603,8.066,25.269,19498,7175,12323,8.452,22.969,1952,2.300,45.938,1115,1116,5136
1983,114,1423,1457,8970,9666,251,16.851,316,21.215,2584,1018,1566,10.532,26.733,3922,1518,2404,15.705,40.575,-1338,-13.842,53.466,224,226,1009
1983,115,6398,6851,73843,75404,994,14.480,1021,14.874,18719,7432,11287,9.856,24.825,21892,7547,14345,10.009,29.033,-3173,-4.208,49.650,718,721,4338
1983,211,7725,9770,169864,177573,1338,13.724,1297,13.303,31906,12051,19855,6.787,17.968,47246,14047,33199,7.911,26.607,-15340,-8.639,35.936,895,900,5603
1983,212,6739,9120,327545,371248,1011,10.690,1686,17.827,37132,15846,21286,4.268,10.002,125311,30452,94859,8.203,33.754,-88179,-23.752,20.004,1125,1132,12096
1983,213,11299,12774,291762,355613,1969,15.002,2671,20.350,50499,22560,27939,6.344,14.201,178071,43820,134251,12.322,50.074,-127572,-35.874,28.401,1916,1925,24614
1983,221,5668,12090,751781,747532,585,4.864,458,3.808,51811,14999,36812,2.006,6.931,43054,6092,36962,0.815,5.759,8757,1.171,11.519,226,229,1048
1983,236,112129,113189,944160,963659,21130,18.672,21080,18.628,270506,90105,180401,9.350,28.071,310382,91414,218968,9.486,32.209,-39876,-4.138,56.141,14544,14552,63610
1983,237,33405,34268,628612,657684,4810,13.996,5009,14.575,131635,37626,94009,5.721,20.015,189754,36377,153377,5.531,28.852,-58119,-8.837,40.030,3650,3655,22613
1983,238,246893,250180,2216651,2246292,37645,15.094,36080,14.467,555866,161684,394182,7.198,24.746,614827,163199,451628,7.265,27.371,-58961,-2.625,49.492,25723,25746,119455
1983,311,21397,27058,1305178,1322102,2551,9.460,2365,8.771,133867,32286,101581,2.442,10.125,167645,46148,121497,3.491,12.680,-33778,-2.555,20.251,1577,1606,19973
1983,312,2114,2739,218022,222131,163,5.894,216,7.811,17527,3253,14274,1.464,7.890,26078,7462,18616,3.359,11.740,-8551,-3.850,15.781,133,135,2029
1983,313,6075,7410,530835,546242,552,7.528,398,5.428,37307,8269,29038,1.514,6.830,67616,17257,50359,3.159,12.378,-30309,-5.549,13.660,235,236,3938
1983,314,7289,7726,226071,228124,828,10.629,956,12.272,33055,10127,22928,4.439,14.490,37361,12967,24394,5.684,16.377,-4306,-1.888,28.980,733,738,7621
1983,315,15229,17178,1065647,1095324,2023,11.553,2689,15.356,134648,42976,91672,3.924,12.293,194464,75035,119429,6.850,17.754,-59816,-5.461,24.586,2173,2197,45210
1983,316,2150,2503,196802,206021,220,8.734,252,10.004,17226,3616,13610,1.755,8.361,35430,7554,27876,3.667,17.197,-18204,-8.836,16.723,200,202,2990
1983,321,14048,15772,453419,445441,1579,9.931,1836,11.547,79261,19569,59692,4.393,17.794,63262,23062,40200,5.177,14.202,15999,3.592,28.404,1320,1326,12383
1983,322,3736,5723,579665,587956,239,4.152,305,5.299,34840,9113,25727,1.550,5.926,51838,14506,37332,2.467,8.817,-16998,-2.891,11.851,187,196,3073
1983,323,34488,36037,676247,676816,4215,11.911,2916,8.240,81436,24513,56923,3.622,12.032,82404,24367,58037,3.600,12.175,-968,-0.143,24.064,2311,2316,14921
1983,324,1354,2158,143720,147136,152,6.934,220,10.036,10774,2191,8583,1.489,7.323,17537,5400,12137,3.670,11.919,-6763,-4.596,14.645,107,109,1281
1983,325,8223,11906,896349,919293,901,7.587,841,7.082,60663,15846,44817,1.724,6.599,106190,23784,82406,2.587,11.551,-45527,-4.952,13.198,500,506,4926
1983,326,11625,13540,658729,664770,1161,8.590,1112,8.228,79078,21898,57180,3.294,11.896,91460,24916,66544,3.748,13.758,-12382,-1.863,23.791,763,768,10481
1983,327,11816,14813,477115,488285,1161,7.795,1323,8.883,51749,11778,39971,2.412,10.598,74012,17974,56038,3.681,15.158,-22263,-4.559,21.196,895,900,7621
1983,331,4581,5714,676906,767188,361,6.249,487,8.430,29868,7150,22718,0.932,3.893,211423,21804,189619,2.842,27.558,-181555,-23.665,7.786,311,314,5544
1983,332,48190,52235,1506378,1608054,4051,7.687,4975,9.441,143994,39390,104604,2.450,8.955,347705,61745,285960,3.840,21.623,-203711,-12.668,17.909,3573,3590,33494
1983,333,25979,28964,1383282,1550329,1874,6.393,2573,8.778,94619,27583,67036,1.779,6.103,429574,57739,371835,3.724,27.709,-334955,-21.605,12.206,1766,1773,17193
1983,334,11838,13826,1748827,1774900,1674,12.293,1256,9.224,188977,51476,137501,2.900,10.647,238809,63067,175742,3.553,13.455,-49832,-2.808,21.294,873,875,13422
1983,335,5275,6512,630590,663311,511,7.839,524,8.039,44281,6709,37572,1.011,6.676,109066,18455,90611,2.782,16.443,-64785,-9.767,13.352,335,335,4672
1983,336,8186,9665,1712010,1752105,925,9.588,889,9.215,159533,20519,139014,1.171,9.105,240042,39899,200143,2.277,13.700,-80509,-4.595,18.210,632,635,13781
1983,337,15051,16006,489183,491802,1765,10.995,1858,11.575,63339,17715,45624,3.602,12.879,68244,22363,45881,4.547,13.876,-4905,-0.997,25.758,1427,1437,13300
1983,339,24133,25348,611044,625969,3137,12.483,2702,10.752,70298,22192,48106,3.545,11.230,100436,24653,75783,3.938,16.045,-30138,-4.815,22.461,2063,2066,13555
1983,423,149878,191621,2188046,2231834,22057,11.560,20413,10.699,345139,124271,220868,5.568,15.464,432534,137813,294721,6.175,19.380,-87395,-3.916,30.929,13244,13529,72144
1983,424,93215,118349,1612449,1631595,12334,10.424,12284,10.382,243828,76445,167383,4.685,14.944,282078,93642,188436,5.739,17.288,-38250,-2.344,29.888,8323,8492,49455
1983,425,27440,30059,274188,278314,3394,11.409,2774,9.325,43430,15058,28372,5.410,15.605,51291,15316,35975,5.503,18.429,-7861,-2.825,31.209,1769,1778,8594
1983,441,90711,109656,1239851,1233483,10942,10.017,10089,9.237,183053,64605,118448,5.238,14.840,170595,66399,104196,5.383,13.830,12458,1.010,27.661,7390,7516,50054
1983,442,41684,49826,326178,327759,6004,12.045,6048,12.133,61311,24265,37046,7.403,18.706,64069,24548,39521,7.490,19.548,-2758,-0.841,37.412,4328,4510,16472
1983,443,28374,40074,221991,218469,5341,13.440,4673,11.759,51047,21508,29539,9.845,23.366,43915,18068,25847,8.270,20.101,7132,3.265,40.203,2861,3016,10161
1983,444,72438,91454,791814,790588,7971,8.727,7742,8.476,120930,40430,80500,5.114,15.296,118479,36667,81812,4.638,14.986,2451,0.310,29.972,5315,5443,21601
1983,445,115158,158934,2112643,2086074,19850,12.539,18595,11.746,362666,171257,191409,8.210,17.385,310778,129703,181075,6.218,14.898,51888,2.487,29.795,12712,13066,62448
1983,446,46492,65911,569962,568279,6803,10.381,6048,9.229,89571,37304,52267,6.564,15.762,85856,31272,54584,5.503,15.108,3715,0.654,30.216,3842,4005,17752
1983,447,100025,141889,840943,849262,17477,12.246,19139,13.410,180454,83965,96489,9.887,21.248,197063,82450,114613,9.708,23.204,-16609,-1.956,42.497,12611,12893,50349
1983,448,87431,156909,1110886,1114785,16971,10.786,17844,11.341,218694,94190,124504,8.449,19.618,228938,82481,146457,7.399,20.537,-10244,-0.919,39.235,10139,10904,41422
1983,451,39385,53882,331389,325695,7419,13.847,6808,12.707,71823,29917,41906,9.186,22.052,60774,24658,36116,7.571,18.660,11049,3.392,37.320,4910,5091,16211
1983,452,14499,35243,1758682,1810524,2900,8.133,3727,10.453,162787,71256,91531,3.936,8.991,265270,97026,168244,5.359,14.652,-102483,-5.660,17.982,1595,1639,7328
1983,453,77061,90513,455172,444914,14251,16.075,10526,11.874,111433,55210,56223,12.409,25.046,91693,34922,56771,7.849,20.609,19740,4.437,41.218,7668,7856,24251
1983,454,26765,35493,370328,372776,3834,10.784,3953,11.119,64901,21717,43184,5.826,17.410,69940,25559,44381,6.856,18.762,-5039,-1.352,34.820,2557,2596,11281
1983,481,1506,3349,303280,300411,466,14.096,380,11.494,39360,12802,26558,4.262,13.102,32408,7298,25110,2.429,10.788,6952,2.314,21.576,194,194,1545
1983,483,755,1094,48642,50490,90,8.126,117,10.564,7655,3318,4337,6.572,15.162,11151,2323,8828,4.601,22.086,-3496,-6.924,30.323,62,62,479
1983,484,59221,69038,962625,982578,10766,15.578,10910,15.786,157558,54820,102738,5.579,16.035,199150,65931,133219,6.710,20.268,-41592,-4.233,32.070,7856,7907,36367
1983,485,10950,11721,237427,236142,1480,12.609,1513,12.890,38301,13036,25265,5.520,16.220,35287,12781,22506,5.412,14.943,3014,1.276,29.886,1240,1248,9072
1983,486,341,1927,80109,79775,197,10.493,98,5.220,8236,4649,3587,5.828,10.324,7623,1887,5736,2.365,9.556,613,0.768,19.111,30,30,294
1983,487,948,975,11336,11501,153,15.765,144,14.838,2262,770,1492,6.695,19.669,2607,883,1724,7.678,22.669,-345,-3.000,39.337,106,106,702
1983,488,12303,15840,299458,309189,2362,15.106,1955,12.503,49332,17824,31508,5.765,15.955,69009,18088,50921,5.850,22.319,-19677,-6.364,31.911,1367,1409,10878
1983,492,2134,2793,70068,68621,835,31.797,501,19.078,12525,5916,6609,8.621,18.252,9464,3582,5882,5.220,13.792,3061,4.461,27.583,379,379,1804
1983,493,5959,9417,358684,366813,744,7.815,950,9.979,50871,13448,37423,3.666,13.868,66871,18598,48273,5.070,18.230,-16000,-4.362,27.737,326,341,2922
1983,511,20215,23348,732634,730328,2941,12.692,2588,11.169,79269,21655,57614,2.965,10.854,74801,23472,51329,3.214,10.242,4468,0.612,20.484,1904,1918,12652
1983,512,10401,15669,188345,193841,2643,16.936,2516,16.123,47504,17884,29620,9.226,24.507,58051,16222,41829,8.369,29.948,-10547,-5.441,49.013,1402,1486,8789
1983,515,6011,7068,216453,212682,820,11.791,593,8.527,31638,13497,18141,6.346,14.876,23972,9640,14332,4.533,11.271,7666,3.604,22.543,446,447,7112
1983,517,3957,15474,1060042,1087260,1912,11.770,3454,21.262,496316,44593,451723,4.101,45.648,563017,248280,314737,22.835,51.783,-66701,-6.135,91.297,331,331,3362
1983,518,5782,7556,221263,216394,1201,16.029,1074,14.334,48678,17071,31607,7.889,22.495,39069,13406,25663,6.195,18.055,9609,4.441,36.109,669,675,5275
1983,519,2045,2476,28798,28460,280,11.585,162,6.703,3952,1449,2503,5.091,13.886,3231,494,2737,1.736,11.353,721,2.533,22.706,121,121,390
1983,521,37,75,24518,24585,10,13.986,3,4.196,742,384,358,1.562,3.018,886,213,673,0.866,3.604,-144,-0.586,6.036,D,D,D
1983,522,45518,111642,2268045,2248013,7567,6.799,6861,6.165,285191,81912,203279,3.644,12.686,246160,70385,175775,3.131,10.950,39031,1.736,21.900,2987,3120,28490
1983,523,19185,24685,436264,403882,5756,24.677,3037,13.020,120795,51749,69046,12.813,29.908,56735,21756,34979,5.387,14.047,64060,15.861,28.095,2186,2208,11205
1983,524,100551,130181,2237712,2130856,20362,16.169,11870,9.425,498221,182600,315621,8.569,23.381,282275,112390,169885,5.274,13.247,215946,10.134,26.494,7155,7177,59783
1983,525,654,849,10210,10301,102,12.304,62,7.479,2536,1114,1422,10.815,24.620,2526,226,2300,2.194,24.523,10,0.097,49.046,47,48,152
1983,531,147202,151676,853471,848015,21528,14.185,21699,14.298,191827,87910,103917,10.367,22.621,181010,80660,100350,9.512,21.345,10817,1.276,42.690,16887,16922,58230
1983,532,22338,29648,276099,275848,5240,18.080,3909,13.487,67785,25298,42487,9.171,24.573,67845,25670,42175,9.306,24.595,-60,-0.022,49.147,2486,2543,12767
1983,533,869,927,10176,10526,141,15.016,165,17.572,2370,896,1474,8.513,22.517,3096,1120,1976,10.641,29.414,-726,-6.898,45.033,126,126,744
1983,541,314590,335272,2943281,2913014,57825,17.818,36336,11.197,568010,239432,328578,8.219,19.499,508355,168419,339936,5.782,17.451,59655,2.048,34.902,26294,26551,107012
1983,551,22683,42569,2751064,2780568,4164,9.754,4405,10.319,445061,134943,310118,4.853,16.006,503635,121085,382550,4.355,18.113,-58574,-2.107,32.012,644,660,7382
1983,561,130054,145717,2231483,2219506,28508,20.010,22007,15.447,545693,187618,358075,8.453,24.586,520536,171225,349311,7.715,23.453,25157,1.133,46.906,16516,16626,104642
1983,562,11306,12182,175082,172087,1626,13.483,1381,11.452,34705,15414,19291,8.957,20.167,28464,9918,18546,5.763,16.541,6241,3.627,33.081,1047,1048,6160
1983,611,32677,35045,1505799,1479192,4292,12.442,3192,9.254,159408,33063,126345,2.235,10.777,106138,20452,85686,1.383,7.175,53270,3.601,14.351,2396,2437,14008
1983,621,322850,337221,1940397,1884797,34959,10.605,19801,6.007,364985,143201,221784,7.598,19.365,253203,75518,177685,4.007,13.434,111782,5.931,26.868,15038,15195,54763
1983,622,4360,5742,3262069,3210749,311,5.450,239,4.189,232838,95434,137404,2.972,7.252,130879,33471,97408,1.042,4.076,101959,3.176,8.153,121,126,17273
1983,623,20362,28348,1363851,1346866,3143,11.327,1944,7.006,185796,79250,106546,5.884,13.795,150541,58726,91815,4.360,11.177,35255,2.618,22.354,1218,1288,37979
1983,624,45828,59107,784562,772234,8055,13.983,5055,8.775,165451,53914,111537,6.982,21.425,140081,34628,105453,4.484,18.140,25370,3.285,36.279,3234,3334,19776
1983,711,16652,16946,216869,212600,4495,27.818,2920,18.071,57399,24056,33343,11.315,26.999,48997,16850,32147,7.926,23.047,8402,3.952,46.093,2108,2116,11252
1983,712,2047,2195,35212,35705,190,8.813,112,5.195,3457,610,2847,1.708,9.682,4406,721,3685,2.019,12.340,-949,-2.658,19.365,65,66,282
1983,713,33862,36328,524771,523672,5598,15.728,4126,11.592,95204,39383,55821,7.521,18.180,92673,29282,63391,5.592,17.697,2531,0.483,35.394,3132,3160,20819
1983,721,36981,41619,1106322,1115331,5189,12.551,4635,11.211,186140,90670,95470,8.129,16.689,204918,76053,128865,6.819,18.373,-18778,-1.684,33.378,3314,3349,45541
1983,722,261449,327050,4881504,4800574,56891,17.699,45675,14.209,1179148,645264,533884,13.441,24.563,1014267,429459,584808,8.946,21.128,164881,3.435,42.256,33336,33975,273912
1983,811,140230,148703,761189,759690,24280,16.621,19031,13.028,164604,78332,86272,10.311,21.667,161438,62394,99044,8.213,21.251,3166,0.417,42.501,14359,14448,46040
1983,812,141333,165746,1068345,1062045,22285,13.511,20676,12.535,214815,91453,123362,8.611,20.227,203468,87465,116003,8.236,19.158,11347,1.068,38.316,14994,15321,59623
1983,813,175475,181947,1623963,1604218,15502,8.636,10623,5.918,247406,64076,183330,3.994,15.422,208141,43663,164478,2.722,12.975,39265,2.448,25.949,6693,6756,27314
1984,113,10924,11054,93610,89826,1974,18.350,1381,12.838,24723,8206,16517,9.135,27.523,17063,6260,10803,6.969,18.996,7660,8.528,37.991,1029,1031,4367
1984,114,1383,1400,9177,9083,233,16.334,286,20.049,3185,976,2209,10.745,35.066,3001,1327,1674,14.610,33.040,184,2.026,66.079,184,184,771
1984,115,6580,7013,75386,74531,1032,14.889,869,12.537,19894,7670,12224,10.291,26.692,18449,5153,13296,6.914,24.754,1445,1.939,49.507,606,609,3997
1984,211,7970,9950,186688,176624,1267,12.784,1189,11.997,52201,8999,43202,5.095,29.555,33518,10822,22696,6.127,18.977,18683,10.578,37.954,775,791,4444
1984,212,6738,9147,328707,328296,1150,12.574,1147,12.542,56347,14681,41666,4.472,17.163,55123,17121,38002,5.215,16.791,1224,0.373,33.581,808,813,8309
1984,213,10972,12621,284046,286427,2051,16.203,2125,16.788,65584,20907,44677,7.299,22.897,70649,24932,45717,8.704,24.666,-5065,-1.768,45.795,1616,1625,14323
1984,221,5743,12240,756305,752892,739,6.114,433,3.582,41813,11675,30138,1.551,5.554,34889,5694,29195,0.756,4.634,6924,0.920,9.268,231,231,1141
1984,236,124355,125441,1106497,1029872,27754,23.085,17327,14.412,391429,124895,266534,12.127,38.008,237764,73776,163988,7.164,23.087,153665,14.921,46.174,12491,12497,55701
1984,237,35035,35993,667823,648926,6215,17.675,4555,12.954,180298,45288,135010,6.979,27.784,144309,31998,112311,4.931,22.238,35989,5.546,44.476,3444,3446,22035
1984,238,263589,266862,2514808,2365578,47349,18.322,30484,11.796,784767,217168,567599,9.180,33.174,486437,144687,341750,6.116,20.563,298330,12.611,41.126,22793,22811,110527
1984,311,21684,27273,1321122,1314838,2682,9.865,2508,9.225,151934,36532,115402,2.778,11.555,139864,42589,97275,3.239,10.637,12071,0.918,21.275,1761,1785,18279
1984,312,2097,2719,214331,215878,185,6.791,195,7.159,18456,3999,14457,1.852,8.549,21713,5795,15918,2.684,10.058,-3257,-1.509,17.099,132,132,2763
1984,313,6339,7676,547729,538584,633,8.391,369,4.891,57845,8642,49203,1.605,10.740,39739,12538,27201,2.328,7.378,18106,3.362,14.757,233,233,3630
1984,314,7533,7972,250734,238963,1038,13.218,800,10.187,47557,11592,35965,4.851,19.901,24032,11078,12954,4.636,10.057,23525,9.845,20.114,636,637,6407
1984,315,15133,17050,1130659,1099060,2203,12.864,2354,13.746,190332,55551,134781,5.054,17.318,127804,54464,73340,4.956,11.628,62528,5.689,23.257,1984,1999,37787
1984,316,2093,2412,188520,192622,215,8.767,296,12.069,19999,4720,15279,2.450,10.383,28268,7991,20277,4.149,14.675,-8269,-4.293,20.765,222,226,3809
1984,321,14526,16223,510180,482198,1963,12.266,1524,9.523,103009,22582,80427,4.683,21.362,46859,16061,30798,3.331,9.718,56150,11.645,19.436,1142,1149,8845
1984,322,3788,5786,599628,590521,307,5.332,250,4.342,48648,6282,42366,1.064,8.238,30465,8683,21782,1.470,5.159,18183,3.079,10.318,162,164,2856
1984,323,35946,37523,721213,699387,4448,12.090,2981,8.103,109626,24276,85350,3.471,15.675,65633,24714,40919,3.534,9.384,43993,6.290,18.769,2386,2389,14158
1984,324,1372,2204,137673,140594,226,10.386,170,7.813,10023,3322,6701,2.363,7.129,15917,5011,10906,3.564,11.321,-5894,-4.192,14.258,81,82,1079
1984,325,8294,11911,890345,886690,994,8.419,786,6.657,78062,22278,55784,2.512,8.804,70370,18683,51687,2.107,7.936,7692,0.867,15.873,456,467,4930
1984,326,12086,14135,752788,712956,1320,9.454,974,6.976,134950,24009,110941,3.368,18.928,55697,21517,34180,3.018,7.812,79253,11.116,15.624,698,700,8603
1984,327,11833,14889,510302,493149,1303,8.793,1162,7.842,82152,15299,66853,3.102,16.659,47855,15406,32449,3.124,9.704,34297,6.955,19.408,795,804,5563
1984,331,4567,5662,730711,703210,402,7.111,385,6.810,105440,17842,87598,2.537,14.994,51179,18589,32590,2.643,7.278,54261,7.716,14.556,239,244,3291
1984,332,49124,53087,1643096,1574852,5014,9.519,4191,7.956,283404,50549,232855,3.210,17.996,147594,51651,95943,3.280,9.372,135810,8.624,18.744,3205,3214,27067
1984,333,26094,28952,1450891,1418852,2241,7.746,2201,7.607,213707,37539,176168,2.646,15.062,150124,50629,99495,3.568,10.581,63583,4.481,21.161,1540,1547,13652
1984,334,12432,14491,1921533,1839138,1889,13.320,1271,8.962,323565,75233,248332,4.091,17.593,158909,48232,110677,2.623,8.640,164656,8.953,17.281,850,854,9567
1984,335,5389,6618,686874,658981,579,8.819,474,7.220,103674,12634,91040,1.917,15.732,47748,13980,33768,2.121,7.246,55926,8.487,14.491,336,337,3682
1984,336,8393,9892,1929892,1833280,1044,10.672,825,8.433,300865,45639,255226,2.489,16.411,107792,40069,67723,2.186,5.880,193073,10.532,11.759,582,583,7877
1984,337,15724,16699,554961,521984,2328,14.229,1651,10.091,109065,24507,84558,4.695,20.894,42993,19451,23542,3.726,8.236,66072,12.658,16.473,1288,1311,13225
1984,339,24644,25813,644872,627107,3203,12.538,2670,10.452,107701,24624,83077,3.927,17.174,72388,28499,43889,4.545,11.543,35313,5.631,23.086,2096,2101,12797
1984,423,153688,195907,2371120,2281764,23347,12.051,19002,9.808,477963,157872,320091,6.919,20.947,298521,117672,180849,5.157,13.083,179442,7.864,26.166,12887,13134,61482
1984,424,94404,119806,1675105,1646171,12619,10.583,11482,9.630,276698,76538,200160,4.649,16.809,218911,77894,141017,4.732,13.298,57787,3.510,26.596,8135,8298,47797
1984,425,28240,30899,290705,282602,3562,11.699,2659,8.733,52920,17030,35890,6.026,18.726,36683,12560,24123,4.444,12.980,16237,5.746,25.961,1823,1834,7990
1984,441,93077,112602,1375458,1309712,11894,10.696,9082,8.168,252258,75521,176737,5.766,19.261,120768,50607,70161,3.864,9.221,131490,10.040,18.442,6847,6989,37568
1984,442,42627,51120,355122,340780,6705,13.286,5396,10.692,77890,27438,50452,8.052,22.856,49067,21176,27891,6.214,14.398,28823,8.458,28.797,3964,4100,14965
1984,443,29730,41912,249056,235889,6078,14.827,4242,10.348,63022,27175,35847,11.520,26.717,36909,15413,21496,6.534,15.647,26113,11.070,31.294,2891,3060,10396
1984,444,73495,92635,848543,820685,8401,9.124,7277,7.904,151611,46340,105271,5.647,18.474,95702,32856,62846,4.003,11.661,55909,6.812,23.322,5261,5334,21502
1984,445,115628,159117,2202132,2157590,19101,12.013,18860,11.862,373516,161822,211694,7.500,17.312,285987,118403,167584,5.488,13.255,87529,4.057,26.510,13631,13872,62574
1984,446,47589,68498,609361,590227,7316,10.878,4833,7.186,110809,45412,65397,7.694,18.774,71041,26285,44756,4.453,12.036,39768,6.738,24.072,3438,3523,16565
1984,447,97492,139623,878837,860290,15357,10.913,17560,12.478,192241,76372,115869,8.877,22.346,155430,73154,82276,8.503,18.067,36811,4.279,36.134,11949,12207,47544
1984,448,87846,158660,1124029,1117681,18149,11.500,16471,10.437,224338,98946,125392,8.853,20.072,208842,72444,136398,6.482,18.685,15496,1.386,37.371,10083,10683,39376
1984,451,40008,54661,345589,340857,7348,13.522,6711,12.349,69379,29331,40048,8.605,20.354,59680,25207,34473,7.395,17.509,9699,2.845,35.018,4822,5031,16166
1984,452,14729,35924,1885047,1820842,3575,10.051,2866,8.057,244724,95044,149680,5.220,13.440,117631,37354,80277,2.051,6.460,127093,6.980,12.921,1501,1537,5996
1984,453,81179,95125,498831,477564,15693,16.893,11234,12.093,124586,53615,70971,11.227,26.088,81923,37456,44467,7.843,17.154,42663,8.933,34.309,8436,8622,26799
1984,454,27171,35952,383124,375682,3943,11.042,3454,9.673,65011,21777,43234,5.797,17.305,49879,18795,31084,5.003,13.277,15132,4.028,26.554,2460,2483,10282
1984,481,1496,3471,315847,310732,497,14.553,385,11.274,35765,4616,31149,1.486,11.510,25974,3617,22357,1.164,8.359,9791,3.151,16.718,214,219,1849
1984,483,731,1047,47666,48178,88,8.240,130,12.172,7781,2293,5488,4.759,16.151,8842,2404,6438,4.990,18.353,-1061,-2.202,32.301,68,68,794
1984,484,61712,71482,1055745,1009402,12309,17.518,9871,14.049,232543,63097,169446,6.251,23.038,140095,62064,78031,6.149,13.879,92448,9.159,27.758,7349,7413,33758
1984,485,10890,11670,239014,236648,1621,13.877,1643,14.066,37419,12844,24575,5.427,15.812,32782,12846,19936,5.428,13.853,4637,1.959,27.705,1339,1340,9709
1984,486,345,1947,77316,79040,136,7.027,113,5.838,6702,1947,4755,2.463,8.479,9931,4692,5239,5.936,12.565,-3229,-4.085,16.959,33,34,1905
1984,487,966,1000,11773,11531,194,19.576,176,17.760,2919,941,1978,8.161,25.315,2438,963,1475,8.352,21.144,481,4.172,42.288,137,137,777
1984,488,12924,16603,317152,308607,2758,17.009,1982,12.223,73495,24249,49246,7.858,23.815,56670,15874,40796,5.144,18.363,16825,5.452,36.726,1361,1374,8442
1984,492,2515,3366,78391,73906,1091,35.509,504,16.404,18994,8832,10162,11.950,25.700,10127,2643,7484,3.576,13.703,8867,11.998,27.405,388,391,1754
1984,493,5969,9360,378068,368741,679,7.231,739,7.870,62372,14382,47990,3.900,16.915,43406,11978,31428,3.248,11.771,18966,5.143,23.543,276,285,2102
1984,511,20706,23942,770998,751192,3223,13.628,2637,11.151,108661,30746,77915,4.093,14.465,69543,25203,44340,3.355,9.258,39118,5.207,18.515,2011,2028,13659
1984,512,10865,15873,197716,193810,2529,16.043,2311,14.660,51481,14879,36602,7.677,26.563,43388,13850,29538,7.146,22.387,8093,4.176,44.774,1320,1375,7219
1984,515,6263,7357,226773,222389,953,13.208,670,9.286,33531,15155,18376,6.815,15.078,24823,11232,13591,5.051,11.162,8708,3.916,22.324,510,513,6867
1984,517,4643,18915,1074495,1069736,5477,31.880,2007,11.682,374708,270626,104082,25.298,35.028,362462,123125,239337,11.510,33.883,12246,1.145,67.767,433,436,4674
1984,518,5835,7724,238046,230011,1193,15.630,1011,13.245,48023,17515,30508,7.615,20.879,31953,10105,21848,4.393,13.892,16070,6.987,27.784,630,637,3760
1984,519,2224,2654,29722,29020,402,15.728,206,8.059,4965,1612,3353,5.555,17.109,3523,1379,2144,4.752,12.140,1442,4.969,24.280,149,149,694
1984,521,36,77,24159,24349,D,D,5,6.536,540,D,455,D,2.218,923,108,815,0.444,3.791,-383,-1.573,4.436,4,4,63
1984,522,46098,113821,2349323,2309577,8318,7.378,6145,5.451,317515,95069,222446,4.116,13.748,237692,61832,175860,2.677,10.292,79823,3.456,20.583,2805,2909,28936
1984,523,20760,26968,497340,475165,5932,22.962,3664,14.183,145610,50892,94718,10.710,30.644,99508,47611,51897,10.020,20.942,46102,9.702,41.884,2768,2789,36353
1984,524,102755,132285,1988601,1982986,17247,13.188,14230,10.881,347357,130177,217180,6.565,17.517,337390,155438,181952,7.839,17.014,9967,0.503,34.028,9372,9389,100268
1984,525,691,894,8765,8408,127,14.581,81,9.300,1993,942,1051,11.204,23.705,1246,571,675,6.792,14.820,747,8.885,29.640,57,58,463
1984,531,152206,157175,919226,885669,25677,16.628,20171,13.062,234752,101866,132886,11.502,26.506,167676,78106,89570,8.819,18.932,67076,7.573,37.864,16035,16057,57168
1984,532,24718,33754,346156,312464,8007,25.242,3941,12.424,123849,72209,51640,23.110,39.636,53125,22543,30582,7.215,17.002,70724,22.634,34.004,2658,2743,13705
1984,533,873,917,11195,10554,141,15.452,132,14.466,2793,1011,1782,9.580,26.465,1500,581,919,5.505,14.213,1293,12.252,28.427,103,103,440
1984,541,335227,356632,3229632,3090929,59892,17.307,38727,11.191,721786,265610,456176,8.593,23.352,443998,172557,271441,5.583,14.365,277788,8.987,28.729,28523,28744,113739
1984,551,23398,43591,2851828,2797586,4347,10.098,3258,7.569,471911,136317,335594,4.873,16.869,363594,84569,279025,3.023,12.997,108317,3.872,25.993,713,731,8541
1984,561,139995,156323,2574044,2406313,30944,20.486,20400,13.505,720997,212210,508787,8.819,29.963,383656,136221,247435,5.661,15.944,337341,14.019,31.887,15557,15668,88631
1984,562,11562,12503,186167,181386,1681,13.610,1377,11.149,39235,11498,27737,6.339,21.631,29839,10203,19636,5.625,16.451,9396,5.180,32.901,1043,1046,6269
1984,611,33823,36329,1524676,1502274,4573,12.816,3279,9.190,162773,27588,135185,1.836,10.835,118134,22567,95567,1.502,7.864,44639,2.971,15.727,2511,2535,15651
1984,621,332130,347358,2099750,2020277,31523,9.209,21430,6.260,400339,143192,257147,7.088,19.816,240748,83167,157581,4.117,11.917,159591,7.899,23.833,16356,16563,61362
1984,622,4320,5801,3339526,3307998,257,4.452,201,3.482,222317,107727,114590,3.257,6.721,157480,31235,126245,0.944,4.761,64837,1.960,9.521,126,126,19999
1984,623,21090,29480,1401749,1382976,3134,10.835,2026,7.004,181054,69414,111640,5.019,13.092,143538,67800,75738,4.902,10.379,37516,2.713,20.758,1347,1378,43067
1984,624,49159,62888,827472,805478,8826,14.473,5018,8.228,157655,49725,107930,6.173,19.573,113775,32278,81497,4.007,14.125,43880,5.448,28.250,3503,3597,20068
1984,711,18181,18465,236999,226644,4867,27.563,3253,18.422,67917,25301,42616,11.163,29.966,47216,17048,30168,7.522,20.833,20701,9.134,41.665,2402,2406,11416
1984,712,2134,2286,36157,35462,237,10.649,116,5.212,4228,737,3491,2.078,11.923,2810,563,2247,1.588,7.924,1418,3.999,15.848,88,88,381
1984,713,33908,36480,546564,535291,5050,13.879,4862,13.362,103183,38020,65163,7.103,19.276,80767,29172,51595,5.450,15.088,22416,4.188,30.177,3805,3853,21944
1984,721,37335,42118,1183955,1145236,5490,13.104,5044,12.040,234677,107779,126898,9.411,20.492,157643,68618,89025,5.992,13.765,77034,6.726,27.530,3669,3703,44201
1984,722,265681,333738,5205159,5046263,55694,16.852,49192,14.885,1240755,650743,590012,12.896,24.588,923933,449843,474090,8.914,18.309,316822,6.278,36.619,36789,37445,288164
1984,811,147400,156027,842220,801505,26188,17.181,18989,12.458,211014,88235,122779,11.009,26.327,129361,58155,71206,7.256,16.140,81653,10.187,32.280,14613,14693,43242
1984,812,143399,168039,1108024,1089510,22428,13.437,20172,12.085,222454,93943,128511,8.623,20.418,184921,81690,103231,7.498,16.973,37533,3.445,33.946,15082,15503,57500
1984,813,213133,219689,1804299,1717418,47632,23.707,10094,5.024,369340,147828,221512,8.608,21.506,195967,40096,155871,2.335,11.411,173373,10.095,22.821,6871,6884,25658
1985,113,11038,11164,92393,92840,1719,15.482,1598,14.392,20595,7423,13172,7.995,22.183,21522,7185,14337,7.739,23.182,-927,-0.998,44.367,1163,1163,4892
1985,114,1318,1333,7979,8601,213,15.599,278,20.359,2314,1010,1304,11.744,26.905,3615,1018,2597,11.837,42.032,-1301,-15.127,53.811,210,210,740
1985,115,6559,6968,76853,75848,1062,15.242,1061,15.228,22152,7159,14993,9.439,29.206,19934,6809,13125,8.977,26.282,2218,2.924,52.563,738,742,4656
1985,211,8044,9946,163395,163710,1264,12.695,1286,12.916,30569,9910,20659,6.053,18.673,31192,13080,18112,7.990,19.053,-623,-0.381,37.345,860,874,5099
1985,212,6567,8964,315149,322222,1071,11.819,1267,13.981,45818,15964,29854,4.954,14.219,60393,19366,41027,6.010,18.743,-14575,-4.523,28.439,903,909,10758
1985,213,10920,12595,283508,283954,1930,15.271,2016,15.952,63274,16713,46561,5.886,22.283,64233,25334,38899,8.922,22.621,-959,-0.338,44.566,1520,1522,14157
1985,221,5769,12210,764587,760128,639,5.242,597,4.898,44320,8968,35352,1.180,5.831,35446,8329,27117,1.096,4.663,8874,1.167,9.326,317,317,1933
1985,236,130266,131372,1216307,1161995,27418,21.347,21553,16.781,410106,130109,279997,11.197,35.293,301159,109588,191571,9.431,25.917,108947,9.376,51.835,15397,15403,80174
1985,237,36598,37606,723332,703987,6490,17.609,4989,13.537,216567,80276,136291,11.403,30.763,177736,44214,133522,6.281,25.247,38831,5.516,50.494,3765,3775,33124
1985,238,277308,280618,2714337,2614759,50085,18.302,36168,13.216,806953,230800,576153,8.827,30.861,609442,202625,406817,7.749,23.308,197511,7.554,46.616,27228,27242,153135
1985,311,21470,26939,1311855,1314543,2660,9.821,2950,10.892,156847,32502,124345,2.472,11.932,162375,63410,98965,4.824,12.352,-5528,-0.421,23.863,2054,2141,29065
1985,312,2059,2643,207859,210230,161,6.050,197,7.403,15358,3017,12341,1.435,7.305,19992,5118,14874,2.434,9.510,-4634,-2.204,14.611,134,135,2226
1985,313,6588,7920,503530,526044,702,8.998,466,5.973,37059,11219,25840,2.133,7.045,81870,23079,58791,4.387,15.563,-44811,-8.518,14.090,302,304,5436
1985,314,7542,7981,244700,248209,999,12.549,959,12.046,33647,10765,22882,4.337,13.556,40686,14509,26177,5.845,16.392,-7039,-2.836,27.112,755,759,9999
1985,315,14986,16822,1041907,1085970,2207,13.036,2423,14.312,131041,45491,85550,4.189,12.067,217778,83828,133950,7.719,20.054,-86737,-7.987,24.133,2011,2030,50887
1985,316,2018,2298,163253,175514,196,8.349,295,12.567,16587,5234,11353,2.982,9.451,41302,14086,27216,8.026,23.532,-24715,-14.082,18.901,205,207,5557
1985,321,14638,16295,499189,504347,1848,11.365,1780,10.946,69794,20614,49180,4.087,13.838,80063,30021,50042,5.952,15.875,-10269,-2.036,27.677,1331,1339,17223
1985,322,3752,5717,593561,596162,306,5.330,355,6.183,46886,11659,35227,1.956,7.865,52099,21014,31085,3.525,8.739,-5213,-0.874,15.729,216,216,6703
1985,323,37105,38720,747825,734321,4513,11.840,3308,8.678,107729,27504,80225,3.746,14.671,80254,34281,45973,4.668,10.929,27475,3.742,21.858,2618,2629,21921
1985,324,1358,2206,130166,133589,182,8.258,178,8.076,10667,4122,6545,3.086,7.985,17499,8077,9422,6.046,13.099,-6832,-5.114,15.970,102,103,2916
1985,325,8271,11939,906137,913052,1003,8.414,966,8.104,77013,24487,52526,2.682,8.435,90345,38222,52123,4.186,9.895,-13332,-1.460,16.869,581,590,8436
1985,326,12294,14381,769518,761291,1360,9.543,1102,7.732,102464,23646,78818,3.106,13.459,85605,31012,54593,4.074,11.245,16859,2.215,22.489,788,797,14980
1985,327,11734,14867,507423,509042,1304,8.767,1318,8.861,63248,15314,47934,3.008,12.425,66508,21832,44676,4.289,13.065,-3260,-0.640,24.850,927,933,10162
1985,331,4516,5568,692333,711152,368,6.555,460,8.194,51656,15399,36257,2.165,7.264,89593,31319,58274,4.404,12.598,-37937,-5.335,14.527,281,281,6605
1985,332,50235,54088,1672383,1656537,5239,9.779,4208,7.855,225460,46293,179167,2.795,13.610,193989,71919,122070,4.342,11.711,31471,1.900,23.421,3172,3192,38651
1985,333,26137,28867,1447991,1447278,2241,7.755,2303,7.969,177139,38479,138660,2.659,12.239,175855,67951,107904,4.695,12.151,1284,0.089,24.301,1607,1611,23251
1985,334,12854,14917,1956945,1931431,1940,13.232,1428,9.740,273574,59433,214141,3.077,14.164,222417,74562,147855,3.860,11.516,51157,2.649,23.031,981,990,23125
1985,335,5502,6719,673951,680888,621,9.313,519,7.783,68246,15052,53194,2.211,10.023,81332,23316,58016,3.424,11.945,-13086,-1.922,20.046,331,334,6306
1985,336,8572,10071,2000348,1964434,1122,11.246,934,9.362,254286,84002,170284,4.276,12.944,181615,82552,99063,4.202,9.245,72671,3.699,18.490,654,663,13429
1985,337,16348,17374,569789,562602,2478,14.531,1837,10.772,84883,22287,62596,3.961,15.088,70934,27064,43870,4.811,12.608,13949,2.479,25.216,1472,1481,17804
1985,339,24847,25924,626166,633595,3190,12.367,2932,11.367,83023,22495,60528,3.550,13.103,97788,36875,60913,5.820,15.434,-14765,-2.330,26.207,2271,2283,20678
1985,423,155709,198308,2472568,2426725,23706,12.024,21403,10.856,460258,147206,313052,6.066,18.966,369525,168011,201514,6.923,15.227,90733,3.739,30.455,14787,15106,96385
1985,424,93929,118990,1695884,1688733,12701,10.632,13650,11.426,281224,82852,198372,4.906,16.653,266730,110249,156481,6.529,15.795,14494,0.858,31.589,9821,10033,70332
1985,425,28972,31625,302492,297644,3791,12.124,3077,9.841,55815,18294,37521,6.146,18.752,46221,18132,28089,6.092,15.529,9594,3.223,31.058,2106,2118,11025
1985,441,93287,111225,1414496,1393969,11796,10.542,13136,11.740,231137,76168,154969,5.464,16.581,188602,94947,93655,6.811,13.530,42535,3.051,27.060,8258,8470,56837
1985,442,42644,51694,367864,361320,6974,13.575,6334,12.329,74706,28958,45748,8.015,20.676,61641,29476,32165,8.158,17.060,13065,3.616,34.120,4779,4974,21935
1985,443,29941,42485,276820,263335,6300,14.937,5687,13.483,73761,30801,42960,11.697,28.010,47031,24500,22531,9.304,17.860,26730,10.151,35.720,3822,4033,17042
1985,444,73404,93035,885016,867057,8770,9.442,8456,9.104,151034,50222,100812,5.792,17.419,115497,47159,68338,5.439,13.321,35537,4.099,26.641,6304,6436,31614
1985,445,113657,156328,2291223,2247137,18842,11.947,21603,13.698,406401,176802,229599,7.868,18.085,317976,153349,164627,6.824,14.150,88425,3.935,28.301,15514,16183,80849
1985,446,47882,69390,635912,623017,7031,10.196,6168,8.945,107506,41352,66154,6.637,17.256,81188,35397,45791,5.682,13.031,26318,4.224,26.063,4309,4430,23767
1985,447,94149,136225,907337,892944,14857,10.774,18207,13.203,198041,80331,117710,8.996,22.178,168830,85517,83313,9.577,18.907,29211,3.271,37.814,12359,12768,54169
1985,448,85432,158328,1185649,1155202,18640,11.760,18994,11.983,260844,105202,155642,9.107,22.580,201100,85307,115793,7.385,17.408,59744,5.172,34.816,12114,13166,54720
1985,451,39644,52518,349587,347903,7403,13.807,9601,17.907,75677,31822,43855,9.147,21.752,71073,38863,32210,11.171,20.429,4604,1.323,40.858,5630,5884,19347
1985,452,14242,35592,1949592,1915480,3109,8.690,3478,9.721,205103,72749,132354,3.798,10.708,139614,48677,90937,2.541,7.289,65489,3.419,14.577,1943,1994,11933
1985,453,82524,96619,530385,514710,15368,16.025,13929,14.525,128720,54880,73840,10.662,25.008,97487,47466,50021,9.222,18.940,31233,6.068,37.880,10621,10826,35387
1985,454,26958,35526,391430,386041,3725,10.428,4113,11.515,74448,22115,52333,5.729,19.285,63970,30371,33599,7.867,16.571,10478,2.714,33.142,2950,3022,16604
1985,481,1463,3577,350912,333953,492,13.961,386,10.953,57030,5749,51281,1.722,17.077,23202,5123,18079,1.534,6.948,33828,10.130,13.895,247,247,3616
1985,483,724,1052,48422,48316,120,11.500,103,9.871,8045,1887,6158,3.906,16.651,7943,1342,6601,2.778,16.440,102,0.211,32.879,73,73,1005
1985,484,63039,72665,1096754,1076757,12576,17.441,11455,15.887,212018,65243,146775,6.059,19.690,173194,72611,100583,6.743,16.085,38824,3.606,32.170,8638,8694,43095
1985,485,10909,11627,241460,240213,1674,14.378,1705,14.645,35191,10105,25086,4.207,14.650,32582,15119,17463,6.294,13.564,2609,1.086,27.128,1354,1355,10107
1985,486,361,1993,76917,76641,176,8.948,124,6.304,7126,2987,4139,3.897,9.298,6621,1906,4715,2.487,8.639,505,0.659,17.278,24,25,562
1985,487,981,1019,12922,12298,200,19.900,172,17.114,3593,1276,2317,10.376,29.217,2361,747,1614,6.074,19.199,1232,10.018,38.398,137,137,645
1985,488,13388,17146,311529,314017,2829,16.772,2271,13.464,67307,22293,45014,7.099,21.434,71738,30831,40907,9.818,22.845,-4431,-1.411,42.868,1604,1630,14549
1985,492,2880,3881,87823,82733,1130,31.246,601,16.618,21388,8199,13189,9.910,25.852,11151,4400,6751,5.318,13.478,10237,12.374,26.957,481,481,3548
1985,493,5980,9440,394461,386251,795,8.427,784,8.310,63151,16566,46585,4.289,16.350,46934,16256,30678,4.209,12.151,16217,4.199,24.302,351,362,3422
1985,511,20616,23820,806531,791561,2972,12.445,3094,12.956,109278,25751,83527,3.253,13.805,79127,35557,43570,4.492,9.996,30151,3.809,19.993,2273,2298,17518
1985,512,11311,16220,231389,215021,2795,17.415,2454,15.290,76244,37778,38466,17.569,35.459,45046,16354,28692,7.606,20.950,31198,14.509,41.899,1583,1642,10052
1985,515,6294,7433,230413,228713,959,12.996,851,11.533,34500,17059,17441,7.459,15.084,31330,15350,15980,6.711,13.698,3170,1.386,27.397,677,687,10691
1985,517,4870,20529,1057992,1072223,3148,15.966,1524,7.729,199630,88112,111518,8.218,18.618,230589,29606,200983,2.761,21.506,-30959,-2.887,37.237,663,675,8927
1985,518,5879,7830,256186,245841,1273,16.362,1173,15.077,64767,24040,40727,9.779,26.345,42989,23023,19966,9.365,17.487,21778,8.859,34.973,698,712,8686
1985,519,2329,2765,33517,31620,353,13.069,225,8.330,7055,1593,5462,5.038,22.312,3243,1225,2018,3.874,10.256,3812,12.056,20.512,177,177,923
1985,521,42,81,24895,24832,6,7.547,3,3.774,867,244,623,0.983,3.491,733,221,512,0.890,2.952,134,0.540,5.904,D,D,D
1985,522,45849,115536,2419671,2384817,9190,8.016,7417,6.469,347653,99571,248082,4.175,14.578,277716,86690,191026,3.635,11.645,69937,2.933,23.290,3445,3554,34647
1985,523,20266,27181,557797,537237,5364,19.855,5033,18.630,134578,41054,93524,7.642,25.050,96376,45534,50842,8.476,17.939,38202,7.111,35.878,3868,3883,32547
1985,524,102785,132242,2043545,1998487,16442,12.441,16282,12.320,374281,112595,261686,5.634,18.728,284394,120642,163752,6.037,14.230,89887,4.498,28.461,10826,10856,64157
1985,525,705,921,9622,9100,115,12.735,79,8.749,2527,955,1572,10.495,27.771,1415,713,702,7.836,15.550,1112,12.220,31.101,53,53,432
1985,531,153479,159303,971610,943452,26961,17.053,24565,15.537,254144,113950,140194,12.078,26.938,197479,98181,99298,10.407,20.932,56665,6.006,41.863,19805,19840,75129
1985,532,28676,38033,402027,374710,8921,24.806,4781,13.294,122916,60606,62310,16.174,32.803,70209,30830,39379,8.228,18.737,52707,14.066,37.474,3072,3137,16435
1985,533,885,926,10942,10880,154,16.821,133,14.528,2645,906,1739,8.328,24.312,2511,1072,1439,9.853,23.080,134,1.232,46.160,109,109,914
1985,541,351911,374213,3483914,3359483,63402,17.348,45908,12.561,783238,286472,496766,8.527,23.314,532580,228120,304460,6.790,15.853,250658,7.461,31.706,34757,34992,164251
1985,551,23750,43751,3003002,2927933,4118,9.430,3958,9.063,543319,140691,402628,4.805,18.556,395884,122549,273335,4.186,13.521,147435,5.035,27.042,981,993,11313
1985,561,148204,165484,2948537,2762140,33339,20.722,24144,15.007,876343,253447,622896,9.176,31.727,502115,180938,321177,6.551,18.178,374228,13.548,36.357,18825,18990,124312
1985,562,11800,12800,200794,193684,1799,14.215,1510,11.932,41697,11533,30164,5.955,21.528,27667,12024,15643,6.208,14.285,14030,7.244,28.569,1175,1175,8606
1985,611,34096,36715,1550583,1538620,4423,12.115,4009,10.981,184890,27733,157157,1.802,12.017,160931,49384,111547,3.210,10.459,23959,1.557,20.919,3101,3132,31049
1985,621,338344,354170,2246237,2178078,33010,9.410,26238,7.480,462641,161696,300945,7.424,21.241,326528,131709,194819,6.047,14.992,136113,6.249,29.983,20505,20820,94454
1985,622,4232,5800,3389008,3355015,283,4.881,279,4.812,323965,166667,157298,4.968,9.656,255800,85900,169900,2.560,7.624,68165,2.032,15.249,185,188,62820
1985,623,21549,30481,1473039,1437275,3413,11.384,2411,8.042,220015,87179,132836,6.066,15.308,148354,70996,77358,4.940,10.322,71661,4.986,20.644,1726,1763,52413
1985,624,51358,65497,890149,859630,8440,13.142,5890,9.171,174939,51156,123783,5.951,20.350,113479,42810,70669,4.980,13.201,61460,7.150,26.402,4355,4411,31249
1985,711,19609,19912,230724,235630,5170,26.976,3676,19.181,73869,28508,45361,12.099,31.350,85133,47478,37655,20.149,36.130,-11264,-4.780,62.699,2800,2807,18210
1985,712,2220,2372,38280,37208,240,10.311,151,6.488,5377,1006,4371,2.704,14.451,3208,847,2361,2.276,8.622,2169,5.829,17.244,103,103,476
1985,713,34247,36812,568263,556940,5179,14.133,4843,13.216,115231,39472,75759,7.087,20.690,92338,32941,59397,5.915,16.580,22893,4.110,33.159,3731,3774,24127
1985,721,37087,42055,1249155,1218892,5423,12.877,5539,13.153,257435,124837,132598,10.242,21.120,197486,92986,104500,7.629,16.202,59949,4.918,32.404,4093,4139,61693
1985,722,264720,334724,5430289,5320704,56467,16.889,55701,16.660,1336365,704655,631710,13.244,25.116,1111510,562691,548819,10.576,20.890,224855,4.226,41.781,41745,42733,350119
1985,811,152035,160808,901429,872428,27008,17.042,22354,14.105,217366,92364,125002,10.587,24.915,159761,77869,81892,8.926,18.312,57605,6.603,36.624,17481,17619,58435
1985,812,142585,167431,1135220,1121649,23221,13.849,23706,14.138,231509,95339,136170,8.500,20.640,203594,98824,104770,8.811,18.151,27915,2.489,36.303,18119,18534,73789
1985,813,217745,224320,1881940,1844390,19925,8.974,15366,6.920,309671,70807,238864,3.839,16.790,235573,66409,169164,3.601,12.772,74098,4.017,25.545,9235,9270,41234
1986,113,10664,10778,90049,91168,1532,13.974,1903,17.358,20840,6799,14041,7.458,22.859,22981,9050,13931,9.927,25.207,-2141,-2.348,45.718,1366,1367,5630
1986,114,1251,1261,7713,7862,205,15.855,269,20.804,2370,973,1397,12.377,30.147,2613,1259,1354,16.015,33.238,-243,-3.091,60.294,210,210,778
1986,115,6618,7040,76204,76553,1107,15.826,1017,14.539,21057,7751,13306,10.125,27.506,21924,7762,14162,10.139,28.639,-867,-1.133,55.013,715,715,4792
1986,211,7835,9618,150963,157042,1087,11.107,1424,14.551,24498,8087,16411,5.150,15.600,36867,10285,26582,6.549,23.476,-12369,-7.876,31.199,985,995,4614
1986,212,6478,8830,305894,310858,1014,11.388,1162,13.050,48056,14829,33227,4.770,15.459,58308,20174,38134,6.490,18.757,-10252,-3.298,30.918,751,755,7706
1986,213,10181,11679,230055,256782,1342,11.053,2266,18.664,39954,16332,23622,6.360,15.560,93164,23055,70109,8.978,36.281,-53210,-20.722,31.119,1659,1674,14473
1986,221,5930,12473,773470,770126,791,6.407,538,4.358,51548,16689,34859,2.167,6.693,43963,5822,38141,0.756,5.709,7585,0.985,11.417,276,276,1548
1986,236,136218,137333,1282759,1250292,27934,20.793,21956,16.343,400226,129453,270773,10.354,32.011,334869,110505,224364,8.838,26.783,65357,5.227,53.567,15822,15832,80957
1986,237,37518,38502,706001,701849,6180,16.241,5280,13.876,184677,50784,133893,7.236,26.313,175142,44390,130752,6.325,24.954,9535,1.359,49.909,3941,3946,26937
1986,238,289675,292718,2827090,2766459,49845,17.394,37529,13.096,778264,226319,551945,8.181,28.132,657415,209267,448148,7.564,23.764,120849,4.368,47.528,27712,27743,154114
1986,311,21218,26687,1295702,1297501,2741,10.239,2909,10.866,153663,40907,112756,3.153,11.843,156676,47952,108724,3.696,12.075,-3013,-0.232,23.686,2056,2087,21660
1986,312,2004,2554,197116,200639,181,7.028,224,8.697,18123,4376,13747,2.181,9.033,25377,9287,16090,4.629,12.648,-7254,-3.615,18.065,139,141,2684
1986,313,6806,8170,484597,490348,764,9.512,488,6.076,46955,11010,35945,2.245,9.576,58792,18129,40663,3.697,11.990,-11837,-2.414,19.152,298,301,4493
1986,314,7470,7908,242993,242796,1016,12.815,1056,13.320,36489,10310,26179,4.246,15.029,36107,14012,22095,5.771,14.871,382,0.157,29.743,848,854,9188
1986,315,14547,16303,1007822,1016704,2186,13.229,2629,15.910,156802,47069,109733,4.630,15.423,173507,72883,100624,7.169,17.066,-16705,-1.643,30.845,2161,2169,45330
1986,316,1864,2121,141916,150571,162,7.377,312,14.208,13744,3751,9993,2.491,9.128,30973,12209,18764,8.108,20.570,-17229,-11.442,18.256,235,239,4912
1986,321,14470,16114,502919,498403,1743,10.771,1881,11.623,80442,24754,55688,4.967,16.140,71206,27124,44082,5.442,14.287,9236,1.853,28.574,1397,1401,13349
1986,322,3728,5729,593459,591386,353,6.190,301,5.278,50277,13458,36819,2.276,8.502,45923,13428,32495,2.271,7.765,4354,0.736,15.531,202,205,4324
1986,323,38078,39717,761111,751076,4604,11.747,3557,9.075,103246,28068,75178,3.737,13.746,83045,28019,55026,3.731,11.057,20201,2.690,22.114,2838,2846,20078
1986,324,1328,2206,124938,127075,213,9.680,202,9.180,9112,2122,6990,1.670,7.171,13452,2804,10648,2.207,10.586,-4340,-3.415,14.341,114,114,817
1986,325,8254,11942,878287,890321,1009,8.468,955,8.015,76538,24174,52364,2.715,8.597,99911,30490,69421,3.425,11.222,-23373,-2.625,17.193,561,568,9566
1986,326,12176,14326,769136,765882,1275,8.905,1257,8.780,100421,26341,74080,3.439,13.112,94021,29937,64084,3.909,12.276,6400,0.836,24.552,933,939,14425
1986,327,11609,14847,494600,499446,1286,8.661,1288,8.675,60093,13745,46348,2.752,12.032,69637,16640,52997,3.332,13.943,-9544,-1.911,24.064,916,941,9756
1986,331,4394,5377,630340,652812,351,6.448,484,8.891,44698,15751,28947,2.413,6.847,89972,24210,65762,3.709,13.782,-45274,-6.935,13.694,306,309,8314
1986,332,50090,53866,1651534,1654079,4720,8.761,4740,8.798,217533,51982,165551,3.143,13.151,223897,62698,161199,3.791,13.536,-6364,-0.385,26.303,3558,3567,35026
1986,333,25889,28547,1379071,1408364,2162,7.548,2352,8.212,138394,38217,100177,2.714,9.827,197506,52459,145047,3.725,14.024,-59112,-4.197,19.653,1645,1653,21560
1986,334,12657,14742,1825750,1875744,1580,10.693,1649,11.160,181338,53110,128228,2.831,9.668,280473,69922,210551,3.728,14.953,-99135,-5.285,19.335,1171,1175,17269
1986,335,5536,6779,659099,665194,596,8.840,522,7.743,58656,13186,45470,1.982,8.818,70621,17255,53366,2.594,10.617,-11965,-1.799,17.636,321,322,5247
1986,336,8555,10128,1991957,1976597,1089,10.821,961,9.549,217521,69974,147547,3.540,11.005,187247,68366,118881,3.459,9.473,30274,1.532,18.946,689,693,13779
1986,337,16561,17625,561477,562220,2421,13.841,2155,12.320,76828,23030,53798,4.096,13.665,78386,28113,50273,5.000,13.942,-1558,-0.277,27.330,1709,1716,17636
1986,339,24928,25981,615281,616048,3211,12.412,2988,11.550,90110,26460,63650,4.295,14.627,91401,33823,57578,5.490,14.837,-1291,-0.210,29.254,2277,2287,16930
1986,423,157946,202239,2504942,2494586,24762,12.348,21366,10.654,427443,150920,276523,6.050,17.135,406007,151973,254034,6.092,16.276,21436,0.859,32.551,14408,14711,82201
1986,424,93788,118784,1727956,1712996,13267,11.160,13457,11.320,295396,87164,208232,5.088,17.244,264917,98355,166562,5.742,15.465,30479,1.779,30.930,9422,9575,53887
1986,425,29622,32316,308044,305589,3802,11.896,3092,9.674,55146,17888,37258,5.854,18.046,50360,16981,33379,5.557,16.480,4786,1.566,32.959,2143,2150,10272
1986,441,93933,113209,1476841,1446432,12831,11.431,10914,9.723,247335,91304,156031,6.312,17.100,186514,67234,119280,4.648,12.895,60821,4.205,25.790,8022,8183,50056
1986,442,43488,53709,385186,376620,7765,14.730,5778,10.961,84533,36745,47788,9.757,22.445,67674,24210,43464,6.428,17.969,16859,4.476,35.938,4205,4357,16766
1986,443,30211,43688,299152,287869,6616,15.370,5329,12.380,79548,37899,41649,13.165,27.633,57569,23076,34493,8.016,19.998,21979,7.635,39.997,3622,3812,15796
1986,444,73923,94485,921997,904314,9423,10.046,8054,8.586,164566,62799,101767,6.944,18.198,129595,42677,86918,4.719,14.331,34971,3.867,28.662,5699,5815,25689
1986,445,113003,156200,2386436,2340685,19912,12.743,20039,12.824,433280,192857,240423,8.239,18.511,342494,137294,205200,5.866,14.632,90786,3.879,29.264,14230,14598,74749
1986,446,48245,71559,650669,644594,8099,11.492,5932,8.417,113026,52960,60066,8.216,17.534,100382,33953,66429,5.267,15.573,12644,1.962,31.146,4173,4263,21823
1986,447,91749,135895,925369,916582,16069,11.813,16346,12.016,204997,90374,114623,9.860,22.365,187872,80886,106986,8.825,20.497,17125,1.868,40.994,10988,11324,49913
1986,448,85590,162473,1243823,1214518,22134,13.801,17954,11.194,281593,124155,157438,10.223,23.186,222113,83950,138163,6.912,18.288,59480,4.897,36.576,10633,11480,45324
1986,451,40177,53970,368019,358945,8120,15.253,6649,12.490,85042,36750,48292,10.238,23.692,67149,25467,41682,7.095,18.707,17893,4.985,37.415,4738,4877,15306
1986,452,14021,35932,1978447,1965771,3393,9.481,3101,8.665,243555,106250,137305,5.405,12.390,219159,51680,167479,2.629,11.149,24396,1.241,22.298,1748,1798,9267
1986,453,84461,99330,551111,540472,16331,16.677,13521,13.808,132121,60278,71843,11.153,24.445,110709,46598,64111,8.622,20.484,21412,3.962,40.968,9942,10221,33950
1986,454,26310,34499,381398,385818,3693,10.556,4665,13.334,68619,22182,46437,5.749,17.785,78424,32605,45819,8.451,20.327,-9805,-2.541,35.571,3158,3177,13252
1986,481,1473,3747,370916,361124,540,14.734,376,10.259,58274,10310,47964,2.855,16.137,39280,14914,24366,4.130,10.877,18994,5.260,21.754,214,215,5723
1986,483,704,1060,44929,46405,120,11.401,105,9.976,6845,3122,3723,6.728,14.751,9770,1939,7831,4.178,21.054,-2925,-6.303,29.501,66,66,818
1986,484,63432,73567,1107471,1101502,12616,17.258,11684,15.983,211016,73859,137157,6.705,19.157,199129,68268,130861,6.198,18.078,11887,1.079,36.156,8883,9014,46398
1986,485,10842,11595,247277,244858,1711,14.742,1733,14.932,43025,14772,28253,6.033,17.571,38068,14943,23125,6.103,15.547,4957,2.024,31.094,1391,1393,10617
1986,486,355,1972,75822,76345,102,5.142,125,6.302,6426,2133,4293,2.794,8.417,7521,2071,5450,2.713,9.851,-1095,-1.434,16.834,44,44,341
1986,487,1032,1075,13906,13470,220,20.942,171,16.278,3352,1402,1950,10.409,24.886,2499,976,1523,7.246,18.553,853,6.333,37.106,116,116,639
1986,488,13946,17800,316254,313899,3089,17.667,2459,14.063,65646,23233,42413,7.401,20.913,59952,19822,40130,6.315,19.099,5694,1.814,38.198,1678,1738,12510
1986,492,3332,4479,104304,96108,1275,30.521,672,16.086,28531,14205,14326,14.780,29.687,12392,5385,7007,5.603,12.894,16139,16.793,25.788,497,497,3113
1986,493,6048,9549,395867,395143,924,9.732,815,8.584,62469,19154,43315,4.847,15.809,61369,15864,45505,4.015,15.531,1100,0.278,31.062,332,336,3042
1986,511,20256,23382,828512,818582,2887,12.243,3285,13.931,112625,31222,81403,3.814,13.759,92992,36964,56028,4.516,11.360,19633,2.398,22.720,2387,2403,19371
1986,512,11452,16285,246715,239406,2829,17.404,2769,17.035,67195,23261,43934,9.716,28.067,53261,18943,34318,7.913,22.247,13934,5.820,44.494,1661,1723,9582
1986,515,6389,7575,239664,236330,1043,13.914,885,11.806,44983,19516,25467,8.258,19.034,39229,14754,24475,6.243,16.599,5754,2.435,33.198,673,684,9994
1986,517,5042,21277,1040980,1049214,2488,11.902,1742,8.333,146902,43352,103550,4.132,14.001,165642,28555,137087,2.722,15.787,-18740,-1.786,28.002,711,718,6793
1986,518,5948,7811,254577,254493,1211,15.487,1228,15.704,52591,19355,33236,7.605,20.665,52383,24072,28311,9.459,20.583,208,0.082,41.167,613,619,4437
1986,519,2384,2846,36448,34716,354,12.609,277,9.866,9090,4912,4178,14.149,26.184,5227,1616,3611,4.655,15.057,3863,11.128,30.113,197,197,832
1986,521,46,83,25760,25328,7,8.537,5,6.098,1479,298,1181,1.177,5.840,595,202,393,0.798,2.349,884,3.490,4.698,D,D,D
1986,522,45370,118489,2534414,2478306,10595,9.055,7641,6.530,423712,138488,285224,5.588,17.097,311863,89834,222029,3.625,12.584,111849,4.513,25.167,3560,3759,36718
1986,523,21127,28326,573622,553441,5139,18.497,4053,14.588,132559,37234,95325,6.728,23.952,93940,41431,52509,7.486,16.974,38619,6.978,33.948,2868,2875,28275
1986,524,105357,134771,2155238,2099743,15753,11.802,13160,9.860,357786,101963,255823,4.856,17.040,244446,88007,156439,4.191,11.642,113340,5.398,23.283,8526,8541,40762
1986,525,754,958,10215,9927,116,12.360,77,8.205,2310,640,1670,6.447,23.271,1659,493,1166,4.967,16.713,651,6.558,33.426,39,39,256
1986,531,155329,162172,1018859,993787,26591,16.549,23613,14.695,259805,107827,151978,10.850,26.143,208013,94021,113992,9.461,20.931,51792,5.212,41.863,18619,18685,68357
1986,532,33339,43881,445995,419618,11053,27.008,5140,12.560,132080,55848,76232,13.309,31.476,79009,33621,45388,8.012,18.829,53071,12.647,37.658,3374,3482,21357
1986,533,873,913,10764,10826,155,16.912,162,17.676,3194,1439,1755,13.292,29.503,3220,1584,1637,14.627,29.743,-26,-0.240,59.006,126,127,1039
1986,541,368757,392780,3709025,3595070,64784,16.900,45892,11.972,806214,295224,510990,8.212,22.426,576818,215712,361106,6.000,16.045,229396,6.381,32.089,34212,34405,150907
1986,551,24503,44778,3071927,3040602,5055,11.422,4016,9.074,541071,171671,369400,5.646,17.795,476865,113968,362897,3.748,15.683,64206,2.112,31.366,902,957,10070
1986,561,157962,176711,3205701,3075767,36040,21.068,24754,14.470,856884,294210,562674,9.565,27.859,596914,191995,404919,6.242,19.407,259970,8.452,38.814,18726,18833,123852
1986,562,11995,13017,209192,204993,1821,14.102,1614,12.499,38698,11023,27675,5.377,18.878,30347,12332,18015,6.016,14.804,8351,4.074,29.608,1224,1229,8581
1986,611,34679,37562,1596455,1578152,4761,12.821,3904,10.513,180162,31042,149120,1.967,11.416,143872,29411,114461,1.864,9.116,36290,2.300,18.233,2978,3022,19942
1986,621,345249,364004,2418701,2338419,35057,9.761,25333,7.054,510771,180250,330521,7.708,21.843,349289,115092,234197,4.922,14.937,161482,6.906,29.874,19458,19649,82758
1986,622,4565,6117,3473526,3469896,317,5.207,258,4.238,241813,95205,146608,2.744,6.969,231376,48526,182850,1.398,6.668,10437,0.301,13.336,162,163,41344
1986,623,22241,32188,1568352,1523012,4237,13.517,2554,8.148,258069,114993,143076,7.550,16.945,166502,68176,98326,4.476,10.932,91567,6.012,21.865,1713,1781,49017
1986,624,53406,68599,936152,913477,9262,13.817,6135,9.152,179894,60943,118951,6.672,19.693,134820,38385,96435,4.202,14.759,45074,4.934,29.518,4247,4325,23863
1986,711,20376,20681,243222,237832,4874,23.983,4158,20.460,70093,24572,45521,10.332,29.472,59456,21157,38299,8.896,24.999,10637,4.472,49.998,3197,3200,14473
1986,712,2299,2452,41082,39706,233,9.648,159,6.584,5314,1052,4262,2.649,13.383,2568,529,2039,1.332,6.468,2746,6.916,12.935,109,109,374
1986,713,35122,38177,596500,582421,5805,15.475,4477,11.935,122855,51397,71458,8.825,21.094,94628,34891,59737,5.991,16.247,28227,4.846,32.495,3341,3366,23769
1986,721,37309,42616,1327669,1289788,5845,13.796,5345,12.616,285017,141257,143760,10.952,22.098,208330,88469,119861,6.859,16.152,76687,5.946,32.305,3853,3905,57204
1986,722,267645,343158,5741482,5590085,61287,18.081,52871,15.598,1463845,850788,613057,15.220,26.186,1161745,518251,643494,9.271,20.782,302100,5.404,41.564,38920,39768,344647
1986,811,156186,165933,943743,923158,27569,16.873,22480,13.759,222192,104121,118071,11.279,24.069,181196,75673,105523,8.197,19.628,40996,4.441,39.256,17232,17326,58027
1986,812,143166,168664,1165648,1149791,24901,14.823,23543,14.015,245284,111066,134218,9.660,21.333,213909,97995,115914,8.523,18.604,31375,2.729,37.208,17276,17738,69812
1986,813,223659,230430,1943779,1912728,17620,7.748,11582,5.093,286509,66823,219686,3.494,14.979,224310,44272,180038,2.315,11.727,62199,3.252,23.454,7077,7120,27466
1987,113,10832,10945,89565,89232,1728,15.914,1555,14.321,23024,7970,15054,8.932,25.803,22105,7672,14433,8.598,24.773,919,1.030,49.545,1149,1150,5338
1987,114,1218,1223,8529,8104,231,18.865,234,19.110,3100,1070,2030,13.204,38.255,2243,1009,1234,12.451,27.679,857,10.576,55.359,173,173,725
1987,115,6378,6809,72764,73166,1150,17.050,1022,15.152,21043,8143,12900,11.130,28.761,21741,10097,11644,13.800,29.715,-698,-0.954,57.522,736,737,5542
1987,211,7297,8942,130532,142230,909,9.665,1836,19.520,19496,7354,12142,5.170,13.707,42920,15291,27629,10.751,30.176,-23424,-16.469,27.415,1204,1216,5416
1987,212,6245,8515,285319,296796,1120,13.007,1312,15.236,47729,19807,27922,6.674,16.081,70599,28991,41608,9.768,23.787,-22870,-7.706,32.163,767,775,9355
1987,213,8315,9765,162956,193482,1262,11.900,2942,27.742,30660,14267,16393,7.374,15.846,91515,31566,59949,16.315,47.299,-60855,-31.453,31.693,2061,2073,17203
1987,221,5844,12393,774290,772758,654,5.294,575,4.655,45838,13958,31880,1.806,5.932,43066,7975,35091,1.032,5.573,2772,0.359,11.146,313,315,1606
1987,236,142686,143904,1314537,1289451,29853,21.289,22495,16.042,411043,140368,270675,10.886,31.877,360965,131875,229090,10.227,27.994,50078,3.884,55.987,16395,16401,87876
1987,237,37604,38594,715029,713794,6456,16.874,5790,15.133,183869,46677,137192,6.539,25.759,182333,61232,121101,8.578,25.544,1536,0.215,51.088,4436,4442,36578
1987,238,306161,309564,2935451,2874585,54170,17.948,38671,12.813,812427,254894,557533,8.867,28.262,690847,216314,474533,7.525,24.033,121580,4.229,48.066,29076,29091,157993
1987,311,20961,26440,1307091,1300055,2843,10.749,2860,10.813,167531,42908,124623,3.300,12.886,152407,50193,102214,3.861,11.723,15124,1.163,23.446,2017,2036,21710
1987,312,1868,2383,179861,184135,225,9.334,280,11.616,16192,4389,11803,2.384,8.794,24266,9552,14714,5.188,13.178,-8074,-4.385,17.587,194,197,4836
1987,313,7258,8680,490717,489668,869,10.192,561,6.580,56624,12355,44269,2.523,11.564,54838,27613,27225,5.639,11.199,1786,0.365,22.398,313,318,6425
1987,314,7205,7626,232922,234056,902,11.726,1035,13.455,36055,9214,26841,3.937,15.404,38407,17222,21185,7.358,16.409,-2352,-1.005,30.809,821,822,8601
1987,315,14381,16044,995669,1003292,2385,14.804,2518,15.630,158861,53069,105792,5.289,15.834,175617,74248,101369,7.400,17.504,-16756,-1.670,31.668,2039,2061,45349
1987,316,1794,2021,130272,134593,174,8.416,267,12.914,14099,2837,11262,2.108,10.475,23048,9553,13495,7.098,17.124,-8949,-6.649,20.951,180,183,3004
1987,321,14489,16107,517089,510664,1884,11.717,1828,11.369,84106,22267,61839,4.360,16.470,71067,35725,35342,6.996,13.917,13039,2.553,27.833,1320,1328,18984
1987,322,3683,5633,572571,572627,330,5.847,351,6.220,42902,11418,31484,1.994,7.492,43096,12901,30195,2.253,7.526,-194,-0.034,14.984,227,228,5271
1987,323,39929,41670,797309,789266,5076,12.393,3653,8.919,108054,31469,76585,3.987,13.690,92073,31697,60376,4.016,11.666,15981,2.025,23.331,2897,2900,21902
1987,324,1274,2126,113645,116649,193,8.975,242,11.253,8881,1754,7127,1.504,7.613,14916,6224,8692,5.336,12.787,-6035,-5.174,15.227,111,114,1438
1987,325,8335,11958,867115,884032,926,7.658,1194,9.874,71132,17287,53845,1.955,8.046,104224,38141,66083,4.314,11.790,-33092,-3.743,16.093,625,630,7662
1987,326,11580,13909,802850,793130,1345,9.702,1252,9.032,108521,32798,75723,4.135,13.683,89385,28942,60443,3.649,11.270,19136,2.413,22.540,850,859,13199
1987,327,11638,14944,500140,500444,1381,9.227,1426,9.528,65659,16283,49376,3.254,13.120,66762,23163,43599,4.628,13.341,-1103,-0.220,26.240,885,901,9076
1987,331,4272,5226,593204,613502,427,8.112,502,9.537,51445,23224,28221,3.785,8.385,92486,32264,60222,5.259,15.075,-41041,-6.690,16.771,283,287,7596
1987,332,50137,53860,1594875,1618208,4970,9.236,4868,9.047,188573,51195,137378,3.164,11.653,235058,71903,163155,4.443,14.526,-46485,-2.873,23.306,3519,3549,35233
1987,333,25238,27760,1290619,1328819,2094,7.482,2551,9.114,128073,37841,90232,2.848,9.638,204486,61715,142771,4.644,15.389,-76413,-5.750,19.276,1727,1736,20225
1987,334,12170,14216,1772485,1807782,1678,11.775,1746,12.253,167979,49523,118456,2.739,9.292,240950,88929,152021,4.919,13.328,-72971,-4.036,18.584,1135,1151,21348
1987,335,5719,6884,629422,642087,583,8.443,625,9.051,58369,16042,42327,2.498,9.091,84571,31322,53249,4.878,13.171,-26202,-4.081,18.181,329,333,5676
1987,336,8940,10566,1925782,1937573,1031,9.767,1010,9.568,183911,49837,134074,2.572,9.492,208531,49453,159078,2.552,10.762,-24620,-1.271,18.984,725,728,10244
1987,337,17106,18228,585114,578070,2441,13.525,2080,11.525,85676,23570,62106,4.077,14.821,71789,26834,44955,4.642,12.419,13887,2.402,24.837,1601,1608,17732
1987,339,25380,26456,623683,619799,3369,12.823,3005,11.437,95069,26017,69052,4.198,15.339,86784,32757,54027,5.285,14.002,8285,1.337,28.004,2252,2258,15070
1987,423,161482,206531,2562495,2556281,25114,12.182,24380,11.826,480304,174985,305319,6.845,18.789,465955,187216,278739,7.324,18.228,14349,0.561,36.456,14829,15208,86753
1987,424,93297,118823,1815835,1788455,14172,11.898,14745,12.379,344053,110393,233660,6.173,19.237,289021,113711,175310,6.358,16.160,55032,3.077,32.321,9644,9830,59698
1987,425,29539,31918,293508,292617,4069,12.845,3589,11.330,58727,21640,37087,7.395,20.070,57113,24245,32868,8.286,19.518,1614,0.552,39.036,2240,2252,12935
1987,441,94238,114420,1531450,1503421,13189,11.602,11704,10.296,266023,107891,158132,7.176,17.695,210169,84102,126067,5.594,13.979,55854,3.715,27.959,8279,8448,61557
1987,442,44719,55889,410070,400158,7850,14.202,6617,11.972,94498,37202,57296,9.297,23.615,74674,31184,43490,7.793,18.661,19824,4.954,37.322,4390,4564,18948
1987,443,28874,42710,296707,294832,6020,14.033,6399,14.916,75555,34649,40906,11.752,25.626,72067,33391,38676,11.325,24.443,3488,1.183,48.887,3889,4155,18966
1987,444,74174,94976,960188,939748,9343,9.855,8998,9.491,185580,66204,119376,7.045,19.748,145541,60855,84686,6.476,15.487,40039,4.261,30.974,5986,6100,30013
1987,445,111575,153053,2483733,2432685,19897,12.897,22333,14.476,468620,216008,252612,8.879,19.263,367271,167428,199843,6.882,15.097,101349,4.166,30.195,14591,14940,80916
1987,446,50037,76622,709432,685224,7778,10.236,6506,8.562,148472,53891,94581,7.865,21.668,99137,38312,60825,5.591,14.468,49335,7.200,28.936,4137,4259,22138
1987,447,88226,136021,959660,942594,16844,12.407,16332,12.030,227833,99677,128156,10.575,24.171,193128,83234,109894,8.830,20.489,34705,3.682,40.978,10367,10619,48739
1987,448,85032,166564,1291166,1271122,23714,14.397,20018,12.153,302283,146442,155841,11.521,23.781,260748,98343,162405,7.737,20.513,41535,3.268,41.026,11118,11973,47027
1987,451,40019,53835,375045,365819,8199,15.348,7369,13.794,89354,39156,50198,10.704,24.426,70742,30969,39773,8.466,19.338,18612,5.088,38.676,5024,5206,19066
1987,452,13215,35264,1974597,1974868,3416,9.678,3478,9.854,220717,103332,117385,5.232,11.176,222059,65055,157004,3.294,11.244,-1342,-0.068,22.353,1745,1794,10502
1987,453,81784,96113,532791,531704,16226,17.027,14595,15.315,131245,57503,73742,10.815,24.684,128605,65104,63501,12.244,24.187,2640,0.497,48.375,10459,10734,37666
1987,454,26157,34488,398707,390621,3868,11.197,3979,11.519,82410,26159,56251,6.697,21.097,66762,25505,41257,6.529,17.091,15648,4.006,34.182,2764,2786,14415
1987,481,1181,3477,372244,369898,468,13.078,671,18.751,54308,9148,45160,2.473,14.682,48480,31124,17356,8.414,13.106,5828,1.576,26.213,231,241,2839
1987,483,603,946,44671,44645,114,11.692,172,17.641,10634,3249,7385,7.277,23.819,10648,3880,6768,8.691,23.851,-14,-0.031,47.639,82,82,1120
1987,484,64486,74932,1041379,1024706,13782,18.613,12006,16.215,226262,82883,143379,8.088,22.081,193064,86039,107025,8.396,18.841,33198,3.240,37.682,8716,8762,49367
1987,485,10700,11540,254014,249180,1747,15.190,1669,14.512,46640,15717,30923,6.307,18.717,36713,16323,20390,6.551,14.734,9927,3.984,29.467,1347,1350,12911
1987,486,344,1948,74755,75927,109,5.556,137,6.983,7569,1634,5935,2.152,9.969,9829,2279,7550,3.002,12.945,-2260,-2.977,19.938,37,37,315
1987,487,1006,1056,12288,11538,232,22.426,189,18.270,4029,1721,2308,14.916,34.919,2461,1191,1270,10.322,21.330,1568,13.590,42.659,142,142,648
1987,488,14774,18454,305646,301814,3324,18.436,2475,13.728,75245,29082,46163,9.636,24.931,67402,27515,39887,9.117,22.332,7843,2.599,44.665,1664,1746,16088
1987,492,5361,7028,350711,326149,1527,22.957,774,11.636,83697,20801,62896,6.378,25.662,35280,7365,27915,2.258,10.817,48417,14.845,21.634,511,513,2577
1987,493,5687,9296,396848,395848,1057,11.428,963,10.412,71091,26086,45005,6.590,17.959,68435,29224,39211,7.383,17.288,2656,0.671,34.576,361,368,4362
1987,511,16389,19023,734938,734788,2421,12.396,3437,17.598,89950,29225,60725,3.977,12.242,89244,44734,44510,6.088,12.146,706,0.096,24.291,2469,2487,19660
1987,512,11341,15971,231272,239393,2803,17.475,2942,18.341,52022,20645,31377,8.624,21.731,67537,20563,46974,8.590,28.212,-15515,-6.481,43.462,1757,1821,10589
1987,515,6095,7460,234937,237461,1265,17.020,1210,16.280,47299,28978,18321,12.203,19.919,51645,28172,23473,11.864,21.749,-4346,-1.830,39.837,936,970,18396
1987,517,5125,23710,1060289,1057050,4244,18.790,1997,8.842,261879,171082,90797,16.185,24.775,255809,46923,208886,4.439,24.200,6070,0.574,48.401,899,935,14904
1987,518,5469,7165,241721,238479,1132,15.671,1249,17.291,55045,22038,33007,9.241,23.082,48497,22065,26432,9.252,20.336,6548,2.746,40.672,643,651,5547
1987,519,2279,2743,35960,35690,315,11.467,323,11.758,5162,2019,3143,5.657,14.463,4645,2324,2321,6.512,13.015,517,1.449,26.030,238,239,1159
1987,521,46,84,24588,24882,4,4.819,D,D,602,194,408,0.780,2.419,1169,D,1147,D,4.698,-567,-2.279,4.839,0,0,0
1987,522,44377,118979,2614385,2570467,9128,7.715,7802,6.594,402682,131858,270824,5.130,15.666,315681,97490,218191,3.793,12.281,87001,3.385,24.562,3471,3780,40589
1987,523,21929,29660,564365,531242,5974,20.755,4222,14.668,143013,52123,90890,9.812,26.920,76581,31273,45308,5.887,14.415,66432,12.505,28.831,3196,3205,19625
1987,524,107630,139512,2277478,2231102,18812,13.733,13761,10.046,408200,136192,272008,6.104,18.296,311985,88720,223265,3.977,13.983,96215,4.312,27.967,9118,9148,39131
1987,525,868,1084,12684,12200,165,15.759,91,8.691,3006,951,2055,7.795,24.640,1981,1039,942,8.517,16.238,1025,8.402,32.477,69,69,676
1987,531,156008,163557,1060463,1040057,26961,16.564,25380,15.593,272535,122136,150399,11.743,26.204,231591,111261,120330,10.698,22.267,40944,3.937,44.534,20506,20591,82156
1987,532,36819,48593,428453,429946,11551,24.934,7016,15.145,119678,58864,60814,13.691,27.836,125055,58440,66615,13.592,29.086,-5377,-1.251,55.671,4092,4221,23923
1987,533,801,838,11639,10814,171,20.189,189,22.314,3880,1938,1942,17.921,35.879,2251,1118,1133,10.338,20.816,1629,15.064,41.631,151,151,677
1987,541,386477,413483,4008483,3910913,66571,16.417,50630,12.485,889880,319984,569896,8.182,22.754,693088,279931,413157,7.158,17.722,196792,5.032,35.444,37221,37437,175171
1987,551,24505,44524,3024400,3051148,5330,11.976,5294,11.895,555466,172971,382495,5.669,18.205,610700,178671,432029,5.856,20.015,-55234,-1.810,36.410,1001,1036,13891
1987,561,168439,188646,3393136,3305875,38799,21.176,27946,15.253,950773,371432,579341,11.236,28.760,776043,267061,508982,8.078,23.475,174730,5.285,46.949,20881,21157,149812
1987,562,11626,12730,163674,157430,1996,15.920,1611,12.849,38469,13453,25016,8.545,24.436,25934,11038,14896,7.011,16.473,12535,7.962,32.947,1240,1240,7971
1987,611,34784,38441,1637972,1610982,4642,12.180,3981,10.446,184652,33790,150862,2.097,11.462,129957,30872,99085,1.916,8.067,54695,3.395,16.134,3011,3036,19655
1987,621,349621,370904,2586664,2512970,35015,9.524,28470,7.744,562207,195489,366718,7.779,22.372,415397,150350,265047,5.983,16.530,146810,5.842,33.060,21497,21686,101963
1987,622,5046,6836,4047504,3932678,950,14.617,277,4.262,736427,504981,231446,12.841,18.726,507264,60261,447003,1.532,12.899,229163,5.827,25.797,159,159,30741
1987,623,22800,34257,1645434,1610455,4669,13.965,3024,9.045,284478,143228,141250,8.894,17.664,215827,103204,112623,6.408,13.402,68651,4.263,26.803,1963,2044,70086
1987,624,55366,70973,963492,942512,8603,12.307,6467,9.251,182922,55333,127589,5.871,19.408,141983,40354,101629,4.282,15.064,40939,4.344,30.129,4455,4510,24635
1987,711,19399,19746,238203,234863,4540,22.914,4675,23.595,75253,24565,50688,10.459,32.041,68705,25609,43096,10.904,29.253,6548,2.788,58.506,3675,3678,17415
1987,712,2684,2876,53115,51721,228,8.027,157,5.527,6976,1436,5540,2.776,13.488,4154,710,3444,1.373,8.032,2822,5.456,16.063,108,108,548
1987,713,36737,40681,647584,632328,6499,16.362,4577,11.523,138859,58827,80032,9.303,21.960,108163,38193,69970,6.040,17.106,30696,4.854,34.211,3415,3440,27279
1987,721,37088,42640,1330072,1329612,6134,14.458,5708,13.454,264472,136740,127732,10.284,19.891,263230,120422,142808,9.057,19.798,1242,0.093,39.595,3998,4086,69597
1987,722,272267,356635,6075932,5923770,66259,18.908,53844,15.365,1555777,868243,687534,14.657,26.263,1254258,566305,687953,9.560,21.173,301519,5.090,42.347,40007,40813,375022
1987,811,162888,174293,996053,981911,29185,17.018,23594,13.758,236915,111083,125832,11.313,24.128,207863,89498,118365,9.115,21.169,29052,2.959,42.338,17834,17933,64621
1987,812,138415,164940,1101884,1095833,24628,14.953,24153,14.665,242892,110260,132632,10.062,22.165,230439,109091,121348,9.955,21.029,12453,1.136,42.057,17841,18193,73511
1987,813,227137,233892,1977061,1950683,16634,7.164,13226,5.696,289728,65420,224308,3.354,14.853,237232,53521,183711,2.744,12.161,52496,2.691,24.323,8588,8612,32314
1988,113,11074,11187,93722,91932,1791,16.156,1589,14.333,23184,8360,14824,9.094,25.219,19604,7790,11814,8.474,21.324,3580,3.894,42.649,1192,1193,5061
1988,114,1192,1201,8278,8245,232,19.189,248,20.513,3278,1468,1810,17.805,39.757,3208,1610,1598,19.527,38.908,70,0.849,77.817,188,188,863
1988,115,6499,6845,76943,74655,1116,16.368,1062,15.576,24321,10890,13431,14.587,32.578,19686,9238,10448,12.374,26.369,4635,6.209,52.739,682,684,5202
1988,211,7151,8713,123731,127361,1031,11.678,1262,14.295,21465,6593,14872,5.177,16.854,28933,9812,19121,7.704,22.717,-7468,-5.864,33.707,808,819,3209
1988,212,6193,8497,291876,290537,1096,12.874,1129,13.261,52361,19388,32973,6.673,18.022,49998,17604,32394,6.059,17.209,2363,0.813,34.418,755,761,9152
1988,213,8119,9289,161265,161219,1299,13.648,1757,18.460,46143,10109,36034,6.270,28.621,45985,22858,23127,14.178,28.523,158,0.098,57.047,1084,1098,6479
1988,221,6043,12627,771124,772304,944,7.547,706,5.644,49403,18212,31191,2.358,6.397,52326,17792,34534,2.304,6.775,-2923,-0.378,12.794,243,325,6622
1988,236,145554,146781,1344932,1333854,27689,19.042,24950,17.158,395216,123213,272003,9.237,29.630,372059,130595,241464,9.791,27.894,23157,1.736,55.787,18551,18564,93969
1988,237,37784,38875,719831,717972,5746,14.855,5356,13.847,170646,45206,125440,6.296,23.768,167746,43387,124359,6.043,23.364,2900,0.404,46.728,4152,4173,29016
1988,238,313258,316693,3009537,2979419,50394,16.086,43575,13.909,764269,226288,537981,7.595,25.652,703925,219754,484171,7.376,23.626,60344,2.025,47.253,33258,33292,171666
1988,311,21109,26605,1352584,1336401,2857,10.739,2856,10.735,184400,61004,123396,4.565,13.798,153423,56581,96842,4.234,11.480,30977,2.318,22.961,1969,1992,21816
1988,312,1878,2428,185302,182978,245,10.147,218,9.029,24725,8299,16426,4.536,13.513,19744,5245,14499,2.866,10.790,4981,2.722,21.581,146,148,2337
1988,313,7434,8896,517125,507149,897,10.147,785,8.880,65027,28471,36556,5.614,12.822,45780,13383,32397,2.639,9.027,19247,3.795,18.054,578,582,5312
1988,314,7324,7754,241136,238180,951,12.343,853,11.071,37783,14099,23684,5.919,15.863,31616,10848,20768,4.555,13.274,6167,2.589,26.548,656,667,7771
1988,315,14471,16144,991689,1002029,2520,15.601,2537,15.707,156989,60676,96313,6.055,15.667,176685,72497,104188,7.235,17.633,-19696,-1.966,31.334,2128,2135,45700
1988,316,1815,2038,135439,133878,200,9.799,206,10.093,19960,5139,14821,3.839,14.909,16624,6370,10254,4.758,12.417,3336,2.492,24.835,146,146,1698
1988,321,14840,16499,540086,532590,1931,11.809,1636,10.005,84794,30959,53835,5.813,15.921,69602,27267,42335,5.120,13.069,15192,2.852,26.137,1221,1232,13045
1988,322,3747,5740,588065,584081,350,6.119,309,5.403,47219,13065,34154,2.237,8.084,39516,11048,28468,1.892,6.765,7703,1.319,13.531,212,215,5172
1988,323,40961,42793,831293,818641,4905,11.600,3888,9.195,115837,34724,81113,4.242,14.150,90550,34442,56108,4.207,11.061,25287,3.089,22.122,3141,3146,22249
1988,324,1271,2131,113727,113439,193,9.106,170,8.021,11168,5455,5713,4.809,9.845,10462,3732,6730,3.290,9.223,706,0.622,18.445,93,96,2262
1988,325,8527,12266,903832,890976,1126,9.269,891,7.334,107309,35794,71515,4.017,12.044,83419,28623,54796,3.213,9.363,23890,2.681,18.725,526,535,7950
1988,326,11846,14253,846501,828523,1334,9.450,1062,7.523,120159,31656,88503,3.821,14.503,84585,27752,56833,3.350,10.209,35574,4.294,20.418,749,759,12333
1988,327,11724,15201,513184,509224,1423,9.419,1237,8.188,73000,21868,51132,4.294,14.336,64724,22574,42150,4.433,12.710,8276,1.625,25.421,858,866,10798
1988,331,4363,5320,645880,628777,443,8.366,393,7.422,84456,26621,57835,4.234,13.432,49697,19963,29734,3.175,7.904,34759,5.528,15.808,248,252,5592
1988,332,51034,54817,1656428,1633377,5054,9.278,4361,8.006,239491,60811,178680,3.723,14.662,192397,61546,130851,3.768,11.779,47094,2.883,23.558,3286,3294,33768
1988,333,25628,28155,1352864,1331380,2195,7.820,2021,7.200,192663,52481,140182,3.942,14.471,149369,59041,90328,4.435,11.219,43294,3.252,22.438,1444,1451,20426
1988,334,12784,14908,1800362,1794952,1987,13.567,1463,9.989,218972,66916,152056,3.728,12.199,208631,69604,139027,3.878,11.623,10341,0.576,23.246,1011,1023,17302
1988,335,5777,6945,642625,639290,629,9.071,608,8.768,83784,29251,54533,4.576,13.106,75983,33656,42327,5.265,11.886,7801,1.220,23.771,398,403,7962
1988,336,9212,10904,1933404,1922595,1176,10.903,940,8.715,212764,67807,144957,3.527,11.067,194332,54806,139526,2.851,10.108,18432,0.959,20.216,670,672,14165
1988,337,17555,18748,612665,603358,2501,13.490,2083,11.236,97576,34621,62955,5.738,16.172,79278,31654,47624,5.246,13.139,18298,3.033,26.279,1619,1626,17793
1988,339,26002,27097,656526,644968,3419,12.736,2916,10.862,106125,30459,75666,4.723,16.454,83534,27794,55740,4.309,12.952,22591,3.503,25.903,2298,2306,18462
1988,423,164008,210047,2642338,2608438,24918,11.948,21935,10.518,486054,166198,319856,6.372,18.634,419653,174853,244800,6.703,16.088,66401,2.546,32.177,14601,15080,85012
1988,424,94357,120644,1842282,1836145,14204,11.842,12814,10.683,324454,109493,214961,5.963,17.670,313744,117945,195799,6.424,17.087,10710,0.583,34.174,8795,8967,69658
1988,425,30291,32724,296707,294962,3813,11.789,3055,9.445,56358,20966,35392,7.108,19.107,53064,18761,34303,6.360,17.990,3294,1.117,35.980,2037,2045,10865
1988,441,94654,115642,1569269,1556919,12046,10.454,11227,9.743,242659,95498,147161,6.134,15.586,217403,81417,135986,5.229,13.964,25256,1.622,27.927,8205,8473,59359
1988,442,45480,57442,430467,422275,7482,13.175,6176,10.875,91551,37966,53585,8.991,21.680,74960,28425,46535,6.731,17.751,16591,3.929,35.503,4373,4594,19562
1988,443,29378,44098,313655,305569,6341,14.586,5091,11.711,76874,36573,40301,11.969,25.158,60435,23402,37033,7.659,19.778,16439,5.380,39.556,3374,3595,15093
1988,444,74611,95898,992317,979357,8779,9.184,8172,8.549,169809,58081,111728,5.931,17.339,144298,50105,94193,5.116,14.734,25511,2.605,29.468,5606,5753,27357
1988,445,111012,152854,2556591,2521046,19809,12.943,20206,13.202,467695,229674,238021,9.110,18.552,398036,167599,230437,6.648,15.789,69659,2.763,31.577,13770,14170,75522
1988,446,50686,78277,722849,718607,8144,10.490,6864,8.841,132811,58525,74286,8.144,18.482,123740,43357,80383,6.033,17.219,9071,1.262,34.439,4245,4378,20350
1988,447,87217,138075,973238,969020,16929,12.343,15093,11.004,218772,103389,115383,10.669,22.577,209625,80087,129538,8.265,21.633,9147,0.944,43.265,9539,9946,46226
1988,448,85382,170331,1325643,1312202,22614,13.402,19435,11.518,303975,137266,166709,10.461,23.165,274655,94078,180577,7.169,20.931,29320,2.234,41.862,10832,11614,45954
1988,451,40828,55272,398826,387747,7971,14.583,6743,12.337,91513,40015,51498,10.320,23.601,69581,27044,42537,6.975,17.945,21932,5.656,35.890,4800,5005,16927
1988,452,13039,35568,2082410,2032939,3350,9.453,3090,8.719,292178,121840,170338,5.993,14.372,196858,65257,131601,3.210,9.683,95320,4.689,19.367,1648,1765,14681
1988,453,85106,100174,562289,548548,16904,17.193,13190,13.416,139673,63528,76145,11.581,25.462,112565,48463,64102,8.835,20.521,27108,4.942,41.041,9255,9750,34813
1988,454,26659,35145,423670,411693,4250,12.196,3654,10.486,97136,32488,64648,7.891,23.594,72044,29914,42130,7.266,17.499,25092,6.095,34.999,2459,2500,15913
1988,481,1528,3636,433261,417745,509,14.090,462,12.789,67779,8248,59531,1.974,16.225,35554,13548,22006,3.243,8.511,32225,7.714,17.022,154,180,9029
1988,483,615,940,44745,44640,115,12.131,131,13.819,8514,1751,6763,3.922,19.073,8294,3577,4717,8.013,18.580,220,0.493,37.159,52,52,552
1988,484,65155,76381,1102380,1072454,13241,17.503,11778,15.569,261940,94315,167625,8.794,24.424,200611,75658,124953,7.055,18.706,61329,5.719,37.412,8977,9089,46281
1988,485,10783,11563,255977,255506,1903,16.485,1865,16.156,48991,22796,26195,8.922,19.174,48055,22198,25857,8.688,18.808,936,0.366,37.616,1374,1389,14743
1988,486,355,1981,72898,74088,236,11.998,208,10.574,9751,3142,6609,4.241,13.161,12144,3499,8645,4.723,16.391,-2393,-3.230,26.323,32,33,415
1988,487,1108,1133,12538,12207,249,22.834,164,15.039,3503,1325,2178,10.855,28.698,2871,1021,1850,8.364,23.520,632,5.178,47.041,123,124,543
1988,488,15344,19311,312360,307921,3423,18.160,2499,13.258,76562,31114,45448,10.105,24.864,67741,27803,39938,9.029,21.999,8821,2.865,43.999,1709,1734,14392
1988,492,5201,7794,360759,345632,1720,23.038,1064,14.251,72822,29246,43576,8.462,21.069,40182,11083,29099,3.207,11.626,32640,9.444,23.251,753,758,6224
1988,493,5828,9371,406249,402214,1044,11.179,980,10.494,75310,24220,51090,6.022,18.724,67339,23974,43365,5.961,16.742,7971,1.982,33.484,310,320,2871
1988,511,16818,19592,731442,727881,2775,14.411,2104,10.926,86626,30372,56254,4.173,11.901,79627,29539,50088,4.058,10.940,6999,0.962,21.879,1589,1599,15939
1988,512,11476,16027,230297,230470,2934,18.304,2939,18.335,70797,28659,42138,12.435,30.719,71019,24662,46357,10.701,30.815,-222,-0.096,61.437,1814,1942,10619
1988,515,6257,7835,244200,240396,1087,14.050,890,11.504,43131,21380,21751,8.894,17.942,35529,17165,18364,7.140,14.779,7602,3.162,29.559,651,656,9756
1988,517,5845,23840,1080226,1076902,2568,10.628,3215,13.305,110097,39542,70555,3.672,10.223,104433,33920,70513,3.150,9.698,5664,0.526,19.395,707,721,9147
1988,518,5469,7296,256358,249669,1155,15.956,1040,14.368,62924,27008,35916,10.818,25.203,49042,18740,30302,7.506,19.643,13882,5.560,39.286,645,654,5826
1988,519,2402,2857,34373,35690,370,13.207,259,9.245,4990,2042,2948,5.721,13.982,7857,4919,2938,13.783,22.015,-2867,-8.033,27.963,185,186,899
1988,521,47,86,24884,24762,4,4.678,3,3.509,951,64,887,0.258,3.841,731,26,705,0.105,2.952,220,0.888,5.904,D,D,D
1988,522,44377,122053,2586765,2601331,12311,10.220,9130,7.579,390232,159764,230468,6.142,15.001,417544,125400,292144,4.821,16.051,-27312,-1.050,30.002,3330,3510,40137
1988,523,21916,29597,527004,533272,5559,18.905,5176,17.602,114508,41177,73331,7.722,21.473,124863,43690,81173,8.193,23.415,-10355,-1.942,42.945,3331,3367,18359
1988,524,107188,142533,2099802,2103107,19271,13.754,14438,10.304,356293,119313,236980,5.673,16.941,361480,117188,244292,5.572,17.188,-5187,-0.247,33.883,9371,9393,55297
1988,525,848,1059,12947,12743,100,9.315,129,12.017,2142,792,1350,6.215,16.809,1731,991,740,7.777,13.584,411,3.225,27.168,97,98,665
1988,531,159030,167545,1094741,1078930,26041,15.728,22084,13.338,272237,129847,142390,12.035,25.232,239411,106523,132888,9.873,22.190,32826,3.042,44.379,16998,17099,74050
1988,532,38105,51943,477354,453480,10115,20.104,6854,13.623,141464,71099,70365,15.679,31.195,94036,37246,56790,8.213,20.737,47428,10.459,41.473,4876,5089,24627
1988,533,920,998,13031,12841,272,29.044,149,15.910,4754,2384,2370,18.566,37.023,4375,1472,2903,11.464,34.072,379,2.952,68.144,105,105,723
1988,541,401361,430790,4266791,4153682,69661,16.484,53301,12.612,934436,354921,579515,8.545,22.497,708559,281015,427544,6.765,17.059,225877,5.438,34.117,39556,39935,172570
1988,551,25544,47447,3065068,3051563,8204,17.842,5272,11.466,647254,215247,432007,7.054,21.211,619915,189129,430786,6.198,20.315,27339,0.896,40.629,869,920,14636
1988,561,177255,199659,3694312,3550574,39824,20.500,29027,14.942,1100125,414269,685856,11.668,30.984,809811,295174,514637,8.313,22.808,290314,8.177,45.616,21905,22121,170931
1988,562,11905,13171,177997,171075,2126,16.420,1680,12.975,44034,17723,26311,10.360,25.740,29774,13777,15997,8.053,17.404,14260,8.336,34.808,1256,1301,10004
1988,611,35964,39963,1696012,1678654,5142,13.100,3721,9.480,179508,35965,143543,2.142,10.694,145140,27530,117610,1.640,8.646,34368,2.047,17.292,2755,2802,19920
1988,621,354996,378507,2661137,2628579,34344,9.158,27329,7.288,517838,181179,336659,6.893,19.700,452980,148524,304456,5.650,17.233,64858,2.467,34.466,20562,20896,99268
1988,622,4422,6289,4057991,4002189,326,5.177,343,5.447,366524,137788,228736,3.443,9.158,256471,129318,127153,3.231,6.408,110053,2.750,12.817,166,179,78722
1988,623,23851,36823,1706660,1676475,5231,14.719,2665,7.499,264447,119400,145047,7.122,15.774,205018,78570,126448,4.687,12.229,59429,3.545,24.458,1629,1689,45285
1988,624,57733,74574,1015466,989846,9583,13.163,6037,8.292,197733,67628,130105,6.832,19.976,146242,39226,107016,3.963,14.774,51491,5.202,29.548,4058,4142,24630
1988,711,21341,21720,248158,244980,5975,28.690,4187,20.105,77521,28766,48755,11.742,31.644,70781,26105,44676,10.656,28.893,6740,2.751,57.785,3134,3142,16747
1988,712,2833,3057,55740,54317,336,11.313,162,5.455,7522,1462,6060,2.692,13.848,4734,1303,3431,2.399,8.716,2788,5.133,17.431,107,110,851
1988,713,38682,42656,679766,663748,6885,16.518,4938,11.847,145569,56237,89332,8.473,21.931,113159,43787,69372,6.597,17.048,32410,4.883,34.097,3717,3793,30297
1988,721,37630,43842,1369438,1351841,6190,14.303,5064,11.701,286319,135376,150943,10.014,21.180,252129,118455,133674,8.762,18.651,34190,2.529,37.302,3565,3669,69862
1988,722,277758,367117,6284376,6188067,62945,17.380,53060,14.650,1504548,802369,702179,12.966,24.314,1319277,527680,791597,8.527,21.320,185271,2.994,42.639,37219,38128,339000
1988,811,167153,179328,1057952,1031331,28627,16.175,23943,13.528,250855,111453,139402,10.807,24.323,198160,83253,114907,8.072,19.214,52695,5.109,38.428,18206,18406,61377
1988,812,140389,167919,1108683,1097654,25131,15.129,21516,12.953,242343,116195,126148,10.586,22.078,219988,94281,125707,8.589,20.042,22355,2.037,40.083,15415,15736,62255
1988,813,230678,237840,2032103,2009553,16027,6.794,12180,5.163,291613,62410,229203,3.106,14.511,246161,51500,194661,2.563,12.250,45452,2.262,24.499,7977,7991,30633
1989,113,11249,11366,93156,93594,1746,15.464,1595,14.127,21592,7939,13653,8.482,23.070,22396,7574,14822,8.092,23.929,-804,-0.859,46.140,1204,1204,5879
1989,114,1160,1171,8403,8250,210,17.714,239,20.160,2858,1432,1426,17.358,34.642,2552,1121,1431,13.588,30.933,306,3.709,61.867,180,180,858
1989,115,6664,7040,77669,77947,1064,15.331,864,12.450,20121,7823,12298,10.036,25.814,20794,6176,14618,7.923,26.677,-673,-0.863,51.627,620,621,4062
1989,211,6898,8391,116210,120664,837,9.783,1167,13.640,16377,4432,11945,3.673,13.572,25210,9599,15611,7.955,20.893,-8833,-7.320,27.145,805,814,3414
1989,212,6059,8413,288614,290512,986,11.656,1079,12.755,44220,16689,27531,5.745,15.221,47851,18123,29728,6.238,16.471,-3631,-1.250,30.443,735,743,8471
1989,213,7795,8911,154595,158149,1131,12.415,1529,16.784,41082,16747,24335,10.589,25.977,48447,21728,26719,13.739,30.634,-7365,-4.657,51.954,1015,1034,10207
1989,221,6317,12872,766130,769107,817,6.394,630,4.930,40384,12955,27429,1.684,5.251,46124,10914,35210,1.419,5.997,-5740,-0.746,10.502,287,287,1740
1989,236,148859,150078,1378116,1362405,27378,18.431,24311,16.366,391687,125159,266528,9.187,28.750,361172,116801,244371,8.573,26.510,30515,2.240,53.020,18020,18041,87501
1989,237,37816,38900,709548,713931,5286,13.587,5297,13.615,158475,43296,115179,6.064,22.198,167336,43751,123585,6.128,23.439,-8861,-1.241,44.395,4120,4126,27204
1989,238,318353,321580,3116876,3060917,47699,14.951,42622,13.359,807558,219497,588061,7.171,26.383,694414,232120,462294,7.583,22.686,113144,3.696,45.373,32753,32796,173117
1989,311,21110,26480,1373450,1366208,2634,9.916,2798,10.534,164639,41177,123462,3.014,12.051,150888,51328,99560,3.757,11.044,13751,1.007,22.089,1931,1973,23297
1989,312,1842,2351,177692,180581,202,8.484,262,11.004,17363,4878,12485,2.701,9.615,23182,9320,13862,5.161,12.837,-5819,-3.222,19.230,172,173,3048
1989,313,7291,8750,515595,516951,723,8.190,878,9.946,53508,14389,39119,2.783,10.351,56038,16028,40010,3.100,10.840,-2530,-0.489,20.701,648,655,6347
1989,314,7549,7970,250540,246164,1061,13.478,865,10.988,41250,13157,28093,5.345,16.757,32217,11721,20496,4.761,13.088,9033,3.670,26.175,702,709,7455
1989,315,14404,16045,986623,988769,2404,14.942,2491,15.483,149511,49079,100432,4.964,15.121,153493,64243,89250,6.497,15.524,-3982,-0.403,30.242,2117,2131,41733
1989,316,1786,2000,131093,133365,190,9.408,229,11.339,13505,2192,11313,1.644,10.126,18055,6097,11958,4.572,13.538,-4550,-3.412,20.253,183,184,2706
1989,321,14837,16535,542549,539337,1776,10.752,1743,10.552,80865,23564,57301,4.369,14.993,74403,28375,46028,5.261,13.795,6462,1.198,27.591,1311,1314,13618
1989,322,3721,5724,592624,590219,313,5.459,332,5.791,44008,7975,36033,1.351,7.456,39304,12361,26943,2.094,6.659,4704,0.797,13.318,221,224,5536
1989,323,41602,43516,849322,840588,4755,11.017,4044,9.370,109736,28846,80890,3.432,13.055,92007,32350,59657,3.848,10.946,17729,2.109,21.891,3183,3203,20365
1989,324,1252,2155,112258,112373,168,7.825,152,7.080,8514,2909,5605,2.589,7.577,8827,1619,7208,1.441,7.855,-313,-0.279,15.153,82,83,474
1989,325,8512,12345,921181,912239,1014,8.235,951,7.723,91286,21286,70000,2.333,10.007,73158,31783,41375,3.484,8.020,18128,1.987,16.039,552,562,7330
1989,326,11997,14470,882697,865405,1352,9.416,1129,7.863,121886,27444,94442,3.171,14.084,86833,28990,57843,3.350,10.034,35053,4.050,20.068,760,776,11365
1989,327,11634,15258,518542,516237,1354,8.890,1298,8.523,64842,15930,48912,3.086,12.561,59945,18969,40976,3.674,11.612,4897,0.949,23.224,863,872,9541
1989,331,4371,5352,657498,652317,400,7.486,382,7.150,57229,13024,44205,1.997,8.773,47336,20905,26431,3.205,7.257,9893,1.517,14.513,245,249,4887
1989,332,51802,55609,1710771,1681799,5124,9.277,4371,7.914,238160,57099,181061,3.395,14.161,180052,63474,116578,3.774,10.706,58108,3.455,21.412,3296,3334,34320
1989,333,25855,28391,1402007,1377298,2239,7.917,2017,7.132,177509,36805,140704,2.672,12.888,127744,47506,80238,3.449,9.275,49765,3.613,18.550,1445,1451,17804
1989,334,13173,15278,1804213,1803135,1814,12.015,1454,9.630,221567,63300,158267,3.511,12.288,220778,74616,146162,4.138,12.244,789,0.044,24.488,964,972,18099
1989,335,5761,6921,643947,642804,546,7.874,572,8.249,64320,13750,50570,2.139,10.006,61860,23358,38502,3.634,9.623,2460,0.383,19.247,365,372,4228
1989,336,9349,11080,1950262,1927130,1128,10.259,958,8.713,234819,91167,143652,4.731,12.185,187597,47925,139672,2.487,9.735,47222,2.450,19.469,657,664,14585
1989,337,17865,19030,610625,611878,2455,12.985,2207,11.674,79141,22081,57060,3.609,12.934,81960,30004,51956,4.904,13.395,-2819,-0.461,25.868,1725,1746,18333
1989,339,26538,27568,680725,668724,3318,12.134,2873,10.506,106929,28002,78927,4.187,15.990,83189,34127,49062,5.103,12.440,23740,3.550,24.880,2211,2212,15996
1989,423,165153,212119,2726036,2683515,24071,11.407,21871,10.364,493475,159202,334273,5.933,18.389,408503,179191,229312,6.677,15.223,84972,3.166,30.445,14431,14912,84385
1989,424,95144,121883,1888626,1867759,13913,11.463,12888,10.619,319799,99494,220305,5.327,17.122,277750,112195,165555,6.007,14.871,42049,2.251,29.742,9130,9333,61521
1989,425,30877,33367,307241,302245,3709,11.228,3044,9.215,57532,19184,38348,6.347,19.035,47653,18491,29162,6.118,15.766,9879,3.269,31.533,2093,2104,9804
1989,441,94299,116089,1601934,1585391,11441,9.879,10896,9.408,246839,94663,152176,5.971,15.570,213745,86012,127733,5.425,13.482,33094,2.087,26.964,8153,8435,64132
1989,442,45538,58276,446195,438837,6970,12.049,6111,10.564,89447,34006,55441,7.749,20.383,75039,27837,47202,6.343,17.100,14408,3.283,34.199,4492,4763,19711
1989,443,29514,45002,334749,324318,5844,13.120,4925,11.057,76693,33003,43690,10.176,23.647,55652,23293,32359,7.182,17.160,21041,6.488,34.319,3353,3585,15074
1989,444,74701,97023,1019685,1006616,8569,8.881,7506,7.779,164197,60864,103333,6.046,16.312,138924,43039,95885,4.276,13.801,25273,2.511,27.602,5494,5650,28553
1989,445,110429,151723,2684519,2620757,17818,11.697,19019,12.486,450725,202442,248283,7.725,17.198,324745,141073,183672,5.383,12.391,125980,4.807,24.783,13454,13830,72591
1989,446,50818,79473,754402,739326,7608,9.643,6456,8.183,136515,55906,80609,7.562,18.465,107164,39281,67883,5.313,14.495,29351,3.970,28.990,4283,4463,23368
1989,447,85610,137779,998467,985449,14294,10.365,14548,10.549,213498,88389,125109,8.969,21.665,186958,80534,106424,8.172,18.972,26540,2.693,37.944,9307,9826,48555
1989,448,84609,172241,1352651,1340631,21595,12.606,19725,11.514,287882,125302,162580,9.346,21.474,265598,100611,164987,7.505,19.811,22284,1.662,39.623,11204,12374,51863
1989,451,41654,57056,415241,407152,8271,14.720,6535,11.631,88817,42898,45919,10.536,21.814,71894,29030,42864,7.130,17.658,16923,4.156,35.316,4752,4934,18147
1989,452,12852,36085,2113742,2100275,3355,9.355,2915,8.128,279452,123464,155988,5.878,13.305,256881,63322,193559,3.015,12.231,22571,1.075,24.462,1534,1637,13453
1989,453,88627,103930,594038,578334,16751,16.386,13344,13.053,140952,61461,79491,10.627,24.372,110160,47044,63116,8.134,19.048,30792,5.324,38.096,9776,10559,34656
1989,454,27138,35749,425410,424941,4329,12.217,3697,10.434,76543,28317,48226,6.664,18.013,75099,23635,51464,5.562,17.673,1444,0.340,35.346,2620,2690,14264
1989,481,1578,3685,416792,424708,481,13.119,444,12.110,53854,9863,43991,2.322,12.680,70565,12036,58529,2.834,16.615,-16711,-3.935,25.361,186,186,2580
1989,483,646,971,45309,44789,146,15.336,108,11.345,8442,2604,5838,5.814,18.849,7330,2370,4960,5.292,16.366,1112,2.483,32.732,54,55,729
1989,484,66302,77494,1129292,1115306,12509,16.257,11416,14.836,224969,72324,152645,6.485,20.171,196143,88276,107867,7.915,17.586,28826,2.585,35.173,8676,8771,48004
1989,485,11009,11972,266231,262716,2020,17.167,1610,13.682,46455,17578,28877,6.691,17.683,39040,18922,20118,7.202,14.860,7415,2.822,29.720,1298,1304,14967
1989,486,352,2109,69826,70821,304,14.880,172,8.419,10230,4657,5573,6.576,14.445,12283,3338,8945,4.713,17.344,-2053,-2.899,28.890,35,36,383
1989,487,1163,1193,14111,13384,243,20.858,187,16.052,3944,1509,2435,11.275,29.468,2565,1020,1545,7.621,19.165,1379,10.303,38.329,139,139,827
1989,488,16005,20035,331120,321865,3175,16.180,2350,11.976,71950,23489,48461,7.298,22.354,54072,19812,34260,6.155,16.800,17878,5.555,33.599,1592,1692,12624
1989,492,5160,7893,399827,379803,1219,15.577,1084,13.852,86038,29375,56663,7.734,22.653,46931,17219,29712,4.534,12.357,39107,10.297,24.713,801,812,5290
1989,493,5899,9612,423433,415154,1073,11.282,870,9.148,80268,34938,45330,8.416,19.335,64477,20062,44415,4.832,15.531,15791,3.804,31.062,312,321,2930
1989,511,17729,20682,756896,744265,3225,15.969,2252,11.151,95688,32673,63015,4.390,12.857,70758,27217,43541,3.657,9.507,24930,3.350,19.014,1685,1706,14169
1989,512,11802,16148,220512,224629,2702,16.763,2644,16.403,53066,20938,32128,9.321,23.624,60651,22312,38339,9.933,27.001,-7585,-3.377,47.248,1550,1633,9542
1989,515,6302,7963,248251,246498,1101,13.940,971,12.294,41081,20348,20733,8.255,16.666,37458,18727,18731,7.597,15.196,3623,1.470,30.392,692,701,10279
1989,517,6045,26050,1095903,1087819,4645,18.615,2452,9.826,194126,62609,131517,5.755,17.845,178565,58876,119689,5.412,16.415,15561,1.430,32.830,923,955,10969
1989,518,5429,7582,274384,272085,1319,17.706,1054,14.149,55653,21114,34539,7.760,20.454,51114,20609,30505,7.574,18.786,4539,1.668,37.572,619,626,5899
1989,519,2607,3071,37420,36376,399,13.307,254,8.471,7599,4063,3536,11.170,20.890,5524,2992,2532,8.225,15.186,2075,5.704,30.372,186,186,846
1989,521,47,85,25426,25004,6,7.018,7,8.187,1303,85,1218,0.340,5.211,468,103,365,0.412,1.872,835,3.340,3.743,4,4,88
1989,522,44478,124643,2593662,2594317,11773,9.546,9149,7.418,390529,148609,241920,5.728,15.053,388616,137108,251508,5.285,14.980,1913,0.074,29.959,3448,3627,42225
1989,523,22001,30670,531633,533371,5718,18.999,4571,15.188,121859,57889,63970,10.853,22.847,126374,43393,82981,8.136,23.693,-4515,-0.847,45.694,3196,3223,25219
1989,524,108910,145880,2185600,2140691,26186,18.163,22772,15.795,422863,194291,228572,9.076,19.754,346910,156516,190394,7.311,16.206,75953,3.548,32.411,8869,8887,59607
1989,525,813,1022,12452,13078,72,6.916,110,10.567,2483,411,2072,3.143,18.986,3826,578,3248,4.420,29.255,-1343,-10.269,37.972,82,82,327
1989,531,161675,170636,1128518,1110486,26201,15.498,23058,13.639,259723,112920,146803,10.169,23.388,223472,100360,123112,9.037,20.124,36251,3.264,40.248,17975,18085,75064
1989,532,38191,53206,489635,484132,8761,16.676,7424,14.131,127609,50152,77457,10.359,26.358,115193,38763,76430,8.007,23.794,12416,2.565,47.587,5221,5562,25345
1989,533,982,1029,13502,12816,223,22.289,166,16.592,4284,1410,2874,11.002,33.428,2976,1836,1140,14.326,23.222,1308,10.206,46.444,113,113,1407
1989,541,412647,443504,4556624,4414368,66410,15.206,52895,12.111,994675,360009,634666,8.155,22.533,711645,296728,414917,6.722,16.121,283030,6.412,32.242,39543,39957,172953
1989,551,26566,49793,3181866,3126658,6778,13.941,4433,9.118,617713,234608,383105,7.503,19.756,509600,123783,385817,3.959,16.299,108113,3.458,32.597,956,989,14571
1989,561,186267,211305,4024876,3862184,40737,19.803,29551,14.365,1127966,400374,727592,10.367,29.205,805057,278265,526792,7.205,20.845,322909,8.361,41.689,22614,22847,174108
1989,562,12293,13695,202382,191142,2069,15.394,1559,11.600,52133,18946,33187,9.912,27.274,30040,13069,16971,6.837,15.716,22093,11.558,31.432,1188,1188,8393
1989,611,37277,41519,1759880,1725415,5172,12.668,3788,9.278,203669,43483,160186,2.520,11.804,134581,34262,100319,1.986,7.800,69088,4.004,15.600,2820,2891,24446
1989,621,359527,384992,2826103,2745267,33754,8.841,27379,7.171,550359,182746,367613,6.657,20.048,387850,134674,253176,4.906,14.128,162509,5.920,28.256,21187,21610,93465
1989,622,4132,6058,4150161,4089224,271,4.436,372,6.090,286402,72065,214337,1.762,7.004,163832,79117,84715,1.935,4.006,122570,2.997,8.013,220,225,42863
1989,623,24889,39132,1797970,1753238,5060,13.314,2806,7.383,273290,109644,163646,6.254,15.588,184617,83904,100713,4.786,10.530,88673,5.058,21.060,1735,1867,52921
1989,624,60724,78622,1083108,1051253,10098,13.174,6158,8.034,200488,68550,131938,6.521,19.071,136807,40799,96008,3.881,13.014,63681,6.058,26.027,4380,4463,25352
1989,711,23459,23832,257325,254972,5872,25.579,4121,17.951,73779,29701,44078,11.649,28.936,68248,21776,46472,8.541,26.767,5531,2.169,53.534,3061,3076,14445
1989,712,2962,3227,61222,58577,321,10.210,155,4.930,9470,1675,7795,2.859,16.167,4145,683,3462,1.166,7.076,5325,9.091,14.152,118,119,549
1989,713,38922,43105,715842,697740,6097,14.239,5528,12.910,143358,47944,95414,6.871,20.546,106958,43249,63709,6.198,15.329,36400,5.217,30.658,4342,4438,33501
1989,721,37936,44581,1450998,1412370,5805,13.125,5101,11.533,285977,132786,153191,9.402,20.248,210536,104055,106481,7.367,14.907,75441,5.341,29.813,3694,3780,65248
1989,722,283262,376371,6489152,6388340,61391,16.510,52311,14.068,1454945,755658,699287,11.829,22.775,1251274,549920,701354,8.608,19.587,203671,3.188,39.174,38224,39493,362063
1989,811,171902,185118,1129555,1094600,28673,15.730,22999,12.617,267218,120545,146673,11.013,24.412,197287,87355,109932,7.981,18.024,69931,6.389,36.047,17678,17976,65391
1989,812,142254,171126,1136987,1122965,24858,14.650,21963,12.944,246564,113675,132889,10.123,21.957,218395,95895,122500,8.539,19.448,28169,2.508,38.896,16680,17313,69039
1989,813,234846,242332,2115738,2075523,15873,6.606,11805,4.913,300446,58931,241515,2.839,14.476,220565,48656,171909,2.344,10.627,79881,3.849,21.254,7930,8009,32803
1990,113,11568,11706,94489,93823,1919,16.625,1593,13.801,21918,8890,13028,9.475,23.361,20638,7250,13388,7.727,21.997,1280,1.364,43.993,1190,1190,5637
1990,114,1156,1170,9462,8972,202,17.272,201,17.187,3243,1356,1887,15.115,36.148,2231,1105,1126,12.317,24.868,1012,11.280,49.735,148,148,807
1990,115,6993,7377,79420,78909,1203,16.675,878,12.170,20941,8701,12240,11.027,26.538,19949,7220,12729,9.150,25.281,992,1.257,50.562,596,608,3910
1990,211,6816,8215,119471,117701,850,10.237,1027,12.368,21241,8242,12999,7.003,18.047,17780,5761,12019,4.895,15.106,3461,2.941,30.212,661,674,2808
1990,212,5913,8335,287608,287060,903,10.779,988,11.793,44282,13479,30803,4.696,15.426,43238,16342,26896,5.693,15.062,1044,0.364,30.125,680,688,7351
1990,213,7836,8864,161018,157650,1229,13.803,1309,14.701,38129,9390,28739,5.956,24.186,31171,14529,16642,9.216,19.772,6958,4.414,39.545,866,876,6285
1990,221,6428,13214,777011,771654,983,7.542,622,4.772,50872,19205,31667,2.489,6.593,40623,6817,33806,0.883,5.264,10249,1.328,10.529,339,339,2056
1990,236,152947,154133,1402356,1388702,28685,18.850,24765,16.274,391089,127092,263997,9.152,28.162,363325,117733,245592,8.478,26.163,27764,1.999,52.326,18344,18354,90470
1990,237,37648,38759,738413,723871,4998,12.866,5174,13.319,183330,36653,146677,5.063,25.326,153965,42115,111850,5.818,21.270,29365,4.057,42.539,4044,4052,30881
1990,238,324035,327276,3183117,3151378,48091,14.825,42339,13.051,796908,221874,575034,7.041,25.288,733896,224033,509863,7.109,23.288,63012,2.000,46.576,32658,32700,178390
1990,311,20923,26231,1382383,1376652,2498,9.482,2727,10.351,151526,35818,115708,2.602,11.007,140301,41298,99003,3.000,10.191,11225,0.815,20.383,1994,2023,21000
1990,312,1844,2322,177229,176147,218,9.421,202,8.729,22378,11169,11209,6.341,12.704,20252,7894,12358,4.481,11.497,2126,1.207,22.994,139,140,1494
1990,313,7272,8777,503709,509159,787,8.977,767,8.749,50384,18349,32035,3.604,9.896,61211,19732,41479,3.875,12.022,-10827,-2.126,19.791,564,567,7397
1990,314,7493,7927,249053,249735,982,12.364,1013,12.754,37483,15398,22085,6.166,15.009,39250,15354,23896,6.148,15.717,-1767,-0.708,30.018,830,835,8231
1990,315,14436,16059,937955,961844,2486,15.486,2475,15.417,129734,50023,79711,5.201,13.488,178109,64155,113954,6.670,18.517,-48375,-5.029,26.976,2051,2080,43469
1990,316,1720,1927,125451,128022,166,8.456,238,12.124,11948,2689,9259,2.100,9.333,17218,5793,11425,4.525,13.449,-5270,-4.116,18.666,181,187,3188
1990,321,14760,16486,531467,537654,1644,9.951,1715,10.380,62672,18161,44511,3.378,11.657,75435,24020,51415,4.468,14.030,-12763,-2.374,23.313,1316,1322,15059
1990,322,3688,5740,599055,595690,316,5.514,297,5.183,43160,11340,31820,1.904,7.245,36634,9923,26711,1.666,6.150,6526,1.096,12.300,201,201,3369
1990,323,42101,44080,854081,856408,4531,10.347,3956,9.034,101921,30429,71492,3.553,11.901,107374,33617,73757,3.925,12.538,-5453,-0.637,23.802,3226,3234,22226
1990,324,1257,2170,112564,112147,171,7.924,147,6.812,7461,1648,5813,1.469,6.653,6602,1554,5048,1.386,5.887,859,0.766,11.774,83,83,662
1990,325,8610,12495,928167,925609,995,8.005,866,6.967,75040,15890,59150,1.717,8.107,69267,17414,51853,1.881,7.483,5773,0.624,14.967,546,549,6581
1990,326,12140,14709,870837,876721,1286,8.822,1024,7.024,92115,24663,67452,2.813,10.507,103654,25328,78326,2.889,11.823,-11539,-1.316,21.014,722,727,10774
1990,327,11711,15533,515456,517081,1444,9.375,1182,7.674,60145,18055,42090,3.492,11.632,63247,16115,47132,3.117,12.232,-3102,-0.600,23.263,806,820,8431
1990,331,4435,5446,643468,650536,414,7.664,326,6.035,36574,11181,25393,1.719,5.622,50807,7958,42849,1.223,7.810,-14233,-2.188,11.244,228,228,3319
1990,332,52419,56240,1680867,1695478,4759,8.506,4172,7.457,182467,50563,131904,2.982,10.762,212352,56015,156337,3.304,12.525,-29885,-1.763,21.524,3227,3239,29832
1990,333,25977,28525,1389816,1393612,2052,7.214,1893,6.655,138981,34935,104046,2.507,9.973,145749,41101,104648,2.949,10.458,-6768,-0.486,19.945,1409,1412,14991
1990,334,13567,15670,1755856,1780606,1743,11.258,1368,8.836,172659,49494,123165,2.780,9.697,221671,56875,164796,3.194,12.449,-49012,-2.753,19.393,933,937,12347
1990,335,5746,6927,628589,637561,511,7.373,518,7.474,52888,14767,38121,2.316,8.295,70763,14925,55838,2.341,11.099,-17875,-2.804,16.591,359,361,4281
1990,336,9462,11225,1901786,1939381,1086,9.738,940,8.429,154363,53612,100751,2.764,7.959,228137,49249,178888,2.539,11.763,-73774,-3.804,15.919,716,720,11158
1990,337,17907,19041,597691,604231,2349,12.338,2343,12.307,73140,23224,49916,3.844,12.105,86047,27146,58901,4.493,14.241,-12907,-2.136,24.209,1850,1876,18613
1990,339,26822,27918,681500,679953,3317,11.973,2889,10.428,89164,26582,62582,3.909,13.113,85579,24269,61310,3.569,12.586,3585,0.527,25.172,2318,2321,14344
1990,423,166336,214852,2771621,2746911,23488,11.005,20640,9.671,451680,148239,303441,5.397,16.443,402438,147834,254604,5.382,14.651,49242,1.793,29.301,14369,14832,88565
1990,424,95664,122895,1945193,1918748,13674,11.169,12747,10.412,320721,107014,213707,5.577,16.715,268072,100063,168009,5.215,13.971,52649,2.744,27.942,9158,9401,59240
1990,425,31547,34056,314184,310401,3677,10.912,2957,8.776,55037,18365,36672,5.917,17.731,47384,17220,30164,5.548,15.265,7653,2.466,30.531,2097,2113,11662
1990,441,93319,115454,1562765,1582816,10658,9.206,11303,9.763,203329,80741,122588,5.101,12.846,242858,93761,149097,5.924,15.343,-39529,-2.497,25.692,8455,8746,71912
1990,442,45454,58585,446147,445996,6560,11.234,6177,10.578,82441,33297,49144,7.466,18.485,82164,28514,53650,6.393,18.423,277,0.062,36.845,4565,4889,21195
1990,443,29932,45901,343295,338751,6000,13.207,5061,11.140,74074,32582,41492,9.618,21.867,64755,26240,38515,7.746,19.116,9319,2.751,38.232,3294,3630,16333
1990,444,74543,97194,1029489,1023707,7684,7.911,7557,7.780,150311,48704,101607,4.758,14.683,139403,43969,95434,4.295,13.617,10908,1.066,27.235,5561,5794,29164
1990,445,109204,150372,2788147,2742921,17625,11.668,18987,12.570,429346,181433,247913,6.615,15.653,338266,138978,199288,5.067,12.332,91080,3.321,24.665,13401,13738,72478
1990,446,50780,80428,766124,760944,7826,9.787,6904,8.634,121049,57522,63527,7.559,15.908,110675,41845,68830,5.499,14.544,10374,1.363,29.089,4422,4593,23136
1990,447,83286,136448,993035,995550,12761,9.309,14036,10.239,187391,78689,108702,7.904,18.823,192400,76877,115523,7.722,19.326,-5009,-0.503,37.646,9456,9952,50337
1990,448,82641,172638,1373587,1363344,19923,11.550,19640,11.386,275529,119503,156026,8.765,20.210,253472,94193,159279,6.909,18.592,22057,1.618,37.184,11563,12616,49943
1990,451,42117,58178,434918,425147,7467,12.951,6419,11.134,90105,34312,55793,8.071,21.194,71081,25285,45796,5.947,16.719,19024,4.475,33.438,4902,5111,18167
1990,452,12537,36330,2170598,2142847,3181,8.786,2935,8.106,257227,101346,155881,4.730,12.004,203995,43050,160945,2.009,9.520,53232,2.484,19.040,1513,1584,10255
1990,453,90674,106991,627447,611532,16350,15.489,13479,12.770,148404,70010,78394,11.448,24.268,117229,49190,68039,8.044,19.170,31175,5.098,38.339,10381,10788,37250
1990,454,27508,36365,438295,431529,4209,11.670,3615,10.023,77392,24932,52460,5.778,17.934,63723,22338,41385,5.176,14.767,13669,3.168,29.534,2655,2699,14458
1990,481,1620,3849,468115,443168,587,15.437,494,12.991,94571,19046,75525,4.298,21.340,43918,24670,19248,5.567,9.910,50653,11.430,19.820,198,207,3928
1990,483,643,959,44608,44654,123,12.866,117,12.238,7244,1851,5393,4.145,16.223,7191,3060,4131,6.853,16.104,53,0.119,32.208,65,72,1403
1990,484,66734,78038,1136304,1132281,12216,15.712,11637,14.967,216932,72285,144647,6.384,19.159,210558,76516,134042,6.758,18.596,6374,0.563,37.192,9010,9133,52407
1990,485,11141,12116,276082,270894,1752,14.545,1610,13.367,48788,17478,31310,6.452,18.010,38484,15979,22505,5.899,14.206,10304,3.804,28.413,1295,1298,12222
1990,486,352,2105,68783,69421,140,6.645,144,6.834,6863,1984,4879,2.858,9.886,8122,1309,6813,1.886,11.700,-1259,-1.814,19.772,37,37,202
1990,487,1261,1298,15519,14875,272,21.751,177,14.154,4246,1846,2400,12.410,28.545,2988,969,2019,6.514,20.087,1258,8.457,40.175,134,135,735
1990,488,16777,20840,348412,339691,3259,15.957,2427,11.883,72312,24367,47945,7.173,21.288,54563,20592,33971,6.062,16.063,17749,5.225,32.125,1682,1711,10768
1990,492,5183,8049,415266,407188,1240,15.581,1059,13.307,53616,17466,36150,4.289,13.167,37658,14855,22803,3.648,9.248,15958,3.919,18.497,769,781,5848
1990,493,6074,9933,436907,430027,1019,10.423,705,7.212,74421,27669,46752,6.434,17.306,60226,15195,45031,3.534,14.005,14195,3.301,28.010,303,314,3150
1990,511,18318,21521,783398,770158,3204,15.175,2390,11.320,99623,32494,67129,4.219,12.935,73224,29001,44223,3.766,9.508,26399,3.428,19.015,1850,1868,14738
1990,512,11908,16506,262353,241305,2723,16.694,2333,14.303,81981,27423,54558,11.364,33.974,39417,15337,24080,6.356,16.335,42564,17.639,32.670,1553,1588,9165
1990,515,6403,8043,249608,249191,1027,12.824,958,11.962,36408,16739,19669,6.717,14.611,35943,14537,21406,5.834,14.424,465,0.187,28.848,640,657,8881
1990,517,6320,26080,1109681,1105154,2821,10.825,2781,10.672,140839,46640,94199,4.220,12.744,133224,39103,94121,3.538,12.055,7615,0.689,24.110,829,844,8667
1990,518,5471,7701,290723,282703,1216,15.898,1112,14.538,60833,25045,35788,8.859,21.518,44260,17699,26561,6.261,15.656,16573,5.862,31.312,604,613,4937
1990,519,2660,3048,35968,36685,345,11.289,361,11.813,5620,2257,3363,6.152,15.320,6841,4645,2196,12.662,18.648,-1221,-3.328,30.639,221,221,1056
1990,521,48,82,25144,25368,3,3.704,D,D,580,30,550,0.118,2.286,1016,D,871,D,4.005,-436,-1.719,4.573,0,0,0
1990,522,44504,127153,2654572,2625953,11464,9.102,9045,7.182,396739,143976,252763,5.483,15.108,340100,97557,242543,3.715,12.951,56639,2.157,25.903,3621,3695,36305
1990,523,22413,33263,530957,532008,7217,22.588,4593,14.375,128331,53619,74712,10.079,24.122,130239,48457,81782,9.108,24.481,-1908,-0.359,48.244,3015,3028,17599
1990,524,111012,149565,2256175,2237398,18528,12.543,14827,10.038,376130,138044,238086,6.170,16.811,337566,108504,229062,4.850,15.087,38564,1.724,30.175,8790,8816,45124
1990,525,819,1002,17267,14913,97,9.594,115,11.375,6556,961,5595,6.444,43.963,2103,1084,1019,7.269,14.102,4453,29.861,28.205,63,63,790
1990,531,163448,173145,1155354,1140639,25463,14.817,22871,13.309,260143,119307,140836,10.460,22.807,230443,99559,130884,8.728,20.203,29700,2.604,40.406,17657,17721,68605
1990,532,37924,53856,511226,500515,8071,15.081,7397,13.821,122734,47046,75688,9.400,24.522,101592,45027,56565,8.996,20.298,21142,4.224,40.595,5365,5708,30196
1990,533,1027,1101,16726,16032,234,21.637,195,18.031,4697,1264,3433,7.884,29.299,3177,1766,1411,11.016,19.817,1520,9.481,39.634,136,136,1269
1990,541,424217,456672,4781723,4669529,65608,14.581,52169,11.594,938787,332757,606030,7.126,20.105,716594,260819,455775,5.586,15.346,222193,4.758,30.692,39726,40049,179607
1990,551,27647,52036,3257969,3214607,6803,13.364,4544,8.926,559237,184855,374382,5.750,17.397,471939,116154,355785,3.613,14.681,87298,2.716,29.362,1034,1063,12361
1990,561,194883,221486,4358391,4204838,40884,18.890,30779,14.221,1168294,407225,761069,9.685,27.785,861620,292107,569513,6.947,20.491,306674,7.293,40.982,23749,24040,185233
1990,562,12557,14053,217035,210553,1983,14.289,1633,11.767,48706,14125,34581,6.709,23.132,35778,15941,19837,7.571,16.992,12928,6.140,33.985,1235,1236,9922
1990,611,38802,43218,1846392,1811350,5471,12.893,3906,9.205,211440,54487,156953,3.008,11.673,141974,41121,100853,2.270,7.838,69466,3.835,15.676,2898,2946,21538
1990,621,364790,392131,3031535,2932221,32670,8.407,25662,6.603,563524,177002,386522,6.036,19.218,363985,128261,235724,4.374,12.413,199539,6.805,24.827,20308,20656,94149
1990,622,4152,6160,4317929,4250917,233,3.796,190,3.095,276398,63954,212444,1.504,6.502,141119,43557,97562,1.025,3.320,135279,3.182,6.639,96,108,20926
1990,623,26025,41347,1893267,1847922,4894,12.147,2780,6.900,266484,103760,162724,5.615,14.421,175799,67364,108435,3.645,9.513,90685,4.907,19.027,1704,1800,38452
1990,624,63590,83036,1155686,1120245,10737,13.269,6501,8.034,205201,68469,136732,6.112,18.318,134211,38786,95425,3.462,11.981,70990,6.337,23.961,4845,4943,27342
1990,711,23031,23442,287695,271696,4193,17.822,4363,18.545,83155,24708,58447,9.094,30.606,51562,20314,31248,7.477,18.978,31593,11.628,37.956,3405,3409,15404
1990,712,3077,3340,64293,62750,331,10.081,218,6.639,8733,2522,6211,4.019,13.917,5613,1651,3962,2.631,8.945,3120,4.972,17.890,156,159,1475
1990,713,39572,43727,751011,733155,6125,14.101,5545,12.766,144779,50979,93800,6.953,19.747,108431,41185,67246,5.618,14.790,36348,4.958,29.579,4222,4292,30040
1990,721,38063,45024,1495832,1474535,5375,11.995,4948,11.042,265332,114464,150868,7.763,17.994,221422,96553,124869,6.548,15.016,43910,2.978,30.033,3566,3670,61870
1990,722,287087,383086,6647208,6568963,59968,15.790,53370,14.053,1419982,740207,679775,11.268,21.617,1264723,533879,730844,8.127,19.253,155259,2.364,38.506,39350,40417,359179
1990,811,176631,190748,1167831,1151805,28097,14.942,22679,12.061,248277,105595,142682,9.168,21.555,216241,87838,128403,7.626,18.774,32036,2.781,37.548,17871,18063,66933
1990,812,142801,172807,1166755,1152284,23934,13.918,22250,12.939,240611,107658,132953,9.343,20.881,211973,89826,122147,7.795,18.396,28638,2.485,36.792,17142,17624,66528
1990,813,239007,246633,2198554,2157541,15752,6.442,11535,4.717,304324,61150,243174,2.834,14.105,221151,42936,178215,1.990,10.250,83173,3.855,20.500,7755,7766,28165
1991,113,11480,11617,88734,92417,1571,13.372,1833,15.603,18330,6507,11823,7.041,19.834,25769,9083,16686,9.828,27.884,-7439,-8.049,39.668,1303,1306,6825
1991,114,1183,1197,11982,10868,188,15.712,187,15.629,4376,1486,2890,13.674,40.267,2223,860,1363,7.914,20.455,2153,19.811,40.911,135,135,567
1991,115,7485,7854,83130,82386,1145,14.799,911,11.775,21936,8163,13773,9.908,26.626,20652,6706,13946,8.140,25.067,1284,1.559,50.135,638,640,4556
1991,211,6878,8236,117045,117211,921,11.120,1014,12.243,18667,7744,10923,6.607,15.926,19215,7102,12113,6.059,16.394,-548,-0.468,31.852,658,670,3278
1991,212,5761,8190,275292,281692,800,9.621,1050,12.628,36082,13126,22956,4.660,12.809,48714,15965,32749,5.668,17.293,-12632,-4.484,25.618,688,695,8341
1991,213,8577,9621,177928,172757,1312,13.749,1155,12.104,45176,17286,27890,10.006,26.150,34877,13457,21420,7.790,20.188,10299,5.962,40.377,817,826,7330
1991,221,6498,13880,775093,777345,1227,9.005,719,5.277,53751,23571,30180,3.032,6.915,58046,11275,46771,1.450,7.467,-4295,-0.553,13.829,400,402,3218
1991,236,151015,152211,1233013,1319493,25184,16.377,28317,18.414,276096,93196,182900,7.063,20.924,449427,137696,311731,10.436,34.061,-173331,-13.136,41.849,19927,19942,100648
1991,237,37196,38344,690146,719419,4231,10.818,5761,14.731,137740,32331,105409,4.494,19.146,196086,48455,147631,6.735,27.256,-58346,-8.110,38.292,4408,4422,34857
1991,238,322886,326185,2832563,3018364,42026,12.776,47528,14.449,587104,178116,408988,5.901,19.451,960925,266102,694823,8.816,31.836,-373821,-12.385,38.902,34697,34746,203601
1991,311,21079,26281,1386349,1386472,2290,8.645,2704,10.208,153039,35859,117180,2.586,11.038,152708,55680,97028,4.016,11.014,331,0.024,22.028,1926,1957,32229
1991,312,1836,2298,173299,174419,151,6.502,200,8.611,14129,1985,12144,1.138,8.101,16248,3526,12722,2.022,9.316,-2119,-1.215,16.201,143,144,1725
1991,313,7003,8525,476503,487239,772,9.020,840,9.814,43680,16907,26773,3.470,8.965,65280,18385,46895,3.773,13.398,-21600,-4.433,17.930,600,609,11314
1991,314,7375,7795,232353,241374,871,11.050,1046,13.270,28686,9099,19587,3.770,11.884,46966,14222,32744,5.892,19.458,-18280,-7.573,23.769,864,875,10055
1991,315,14464,15982,874020,907039,2441,15.134,2736,16.963,120595,43419,77176,4.787,13.295,186831,82481,104350,9.093,20.598,-66236,-7.302,26.591,2206,2243,50685
1991,316,1714,1916,112688,118364,167,8.591,223,11.471,9572,3316,6256,2.802,8.087,21165,6644,14521,5.613,17.881,-11593,-9.794,16.174,170,172,4164
1991,321,14756,16449,468183,500254,1566,9.436,1860,11.208,44313,14750,29563,2.949,8.858,108163,32996,75167,6.596,21.622,-63850,-12.764,17.716,1384,1392,20527
1991,322,3687,5714,586759,592426,263,4.566,356,6.180,35944,7720,28224,1.303,6.067,47317,17445,29872,2.945,7.987,-11373,-1.920,12.135,227,229,7032
1991,323,42545,44496,817620,835901,4044,9.065,4274,9.581,82737,24355,58382,2.914,9.898,118972,45978,72994,5.500,14.233,-36235,-4.335,19.796,3447,3462,33935
1991,324,1283,2226,112800,113018,156,6.997,163,7.311,7191,1707,5484,1.510,6.363,7524,2540,4984,2.247,6.657,-333,-0.295,12.725,83,89,873
1991,325,8831,12717,918359,921882,861,6.746,954,7.474,71933,17042,54891,1.849,7.803,78610,26850,51760,2.913,8.527,-6677,-0.724,15.606,596,602,11574
1991,326,12309,14933,824797,848316,1227,8.241,1139,7.650,76912,21399,55513,2.523,9.066,124138,33715,90423,3.974,14.633,-47226,-5.567,18.133,830,847,20187
1991,327,11474,15408,465162,490665,1158,7.451,1427,9.181,39168,13033,26135,2.656,7.983,90237,23815,66422,4.854,18.391,-51069,-10.408,15.965,928,943,13395
1991,331,4418,5410,603078,623506,303,5.535,432,7.891,27839,6374,21465,1.022,4.465,68693,18233,50460,2.924,11.017,-40854,-6.552,8.930,313,317,10406
1991,332,52178,55993,1571135,1628459,4005,7.103,4788,8.492,149820,38516,111304,2.365,9.200,264276,81147,183129,4.983,16.229,-114456,-7.028,18.400,3693,3716,53922
1991,333,26440,29007,1313987,1352829,1870,6.418,2130,7.310,105526,27377,78149,2.024,7.800,183707,49698,134009,3.674,13.579,-78181,-5.779,15.601,1588,1597,29119
1991,334,14070,16082,1636634,1695388,1523,9.438,1634,10.125,138350,37888,100462,2.235,8.160,255800,78533,177267,4.632,15.088,-117450,-6.928,16.321,1149,1165,35221
1991,335,5782,6920,580923,605546,422,6.006,635,9.037,37273,7814,29459,1.290,6.155,86640,28686,57954,4.737,14.308,-49367,-8.152,12.311,417,421,10938
1991,336,9526,11260,1742608,1822948,878,7.719,1107,9.732,118210,40856,77354,2.241,6.485,279342,43137,236205,2.366,15.324,-161132,-8.839,12.969,779,790,17849
1991,337,17363,18443,532889,565417,2018,10.797,2514,13.450,51810,16990,34820,3.005,9.163,117243,41342,75901,7.312,20.736,-65433,-11.573,18.326,1952,1973,28615
1991,339,26102,27211,656435,668275,2828,10.348,3065,11.215,77268,20114,57154,3.010,11.562,100768,33929,66839,5.077,15.079,-23500,-3.517,23.125,2430,2439,20723
1991,423,157971,207373,2596720,2645426,23149,11.173,22778,10.994,391933,149288,242645,5.643,14.815,489820,186898,302922,7.065,18.516,-97887,-3.700,29.631,15332,15793,108721
1991,424,93712,121283,1865999,1889409,13427,11.043,14037,11.545,269760,91931,177829,4.866,14.277,317242,127598,189644,6.753,16.791,-47482,-2.513,28.555,9790,10014,76932
1991,425,30816,33348,299570,303030,3740,11.291,3289,9.930,46584,16595,29989,5.476,15.373,53739,19891,33848,6.564,17.734,-7155,-2.361,30.745,2251,2259,13669
1991,441,87870,110452,1445148,1492690,9843,8.828,11926,10.697,175205,72632,102573,4.866,11.738,269878,108198,161680,7.249,18.080,-94673,-6.342,23.475,8949,9244,86663
1991,442,42311,56014,408570,420580,6556,11.678,6810,12.130,68543,30266,38277,7.196,16.297,92552,32432,60120,7.711,22.006,-24009,-5.709,32.595,4741,5057,22857
1991,443,28598,45273,333081,334980,5845,12.999,5232,11.635,64571,28988,35583,8.654,19.276,67925,26960,40965,8.048,20.277,-3354,-1.001,38.552,3528,3754,17166
1991,444,70379,93173,966268,988194,6892,7.344,8228,8.768,123613,43851,79762,4.437,12.509,168048,54420,113628,5.507,17.006,-44435,-4.497,25.018,5815,6015,35106
1991,445,107053,146605,2732280,2758543,15755,10.603,19713,13.267,356617,167763,188854,6.082,12.928,408578,156558,252020,5.675,14.811,-51961,-1.884,25.855,13176,13564,94172
1991,446,51523,81639,794619,791262,6582,8.022,7395,9.013,124139,45724,78415,5.779,15.689,116636,48470,68166,6.126,14.741,7503,0.948,29.481,4743,4930,27342
1991,447,79626,133155,949385,971843,12014,8.912,15313,11.359,168436,73135,95301,7.525,17.332,212700,83510,129190,8.593,21.886,-44264,-4.555,34.663,9732,10184,51517
1991,448,78607,168304,1346096,1356743,17864,10.495,21669,12.731,256681,116390,140291,8.579,18.919,278085,110335,167750,8.132,20.497,-21404,-1.578,37.838,11587,13362,56418
1991,451,42757,59570,439483,440536,7127,11.981,6954,11.691,83828,37458,46370,8.503,19.029,85334,30669,54665,6.962,19.371,-1506,-0.342,38.057,5178,5418,21218
1991,452,12486,36257,2128182,2157626,2890,7.895,3590,9.807,208694,103565,105129,4.800,9.672,273962,69128,204834,3.204,12.697,-65268,-3.025,19.345,1563,1701,9920
1991,453,94222,111138,631582,638421,14770,13.296,14667,13.203,127847,57642,70205,9.029,20.026,141642,56257,85385,8.812,22.186,-13795,-2.161,40.051,11110,11440,41383
1991,454,27772,36546,420564,429368,4271,11.663,4421,12.072,67508,23418,44090,5.454,15.723,85070,35063,50007,8.166,19.813,-17562,-4.090,31.445,2917,3047,20203
1991,481,1644,4219,487217,478189,786,19.439,435,10.758,76051,14218,61833,2.973,15.904,58049,14679,43370,3.070,12.139,18002,3.765,24.279,201,201,2625
1991,483,688,1028,51248,47676,146,14.571,94,9.381,12662,4221,8441,8.854,26.558,5354,2059,3295,4.319,11.230,7308,15.328,22.460,49,52,960
1991,484,65747,76613,1082836,1109445,11166,14.425,12752,16.474,182414,63321,119093,5.707,16.442,236829,96823,140006,8.727,21.347,-54415,-4.905,32.884,9261,9401,59776
1991,485,11101,12673,277333,276581,2382,19.287,1737,14.064,59756,34774,24982,12.573,21.605,57916,18747,39169,6.778,20.940,1840,0.665,41.880,1373,1382,12276
1991,486,364,2177,69017,68819,203,9.363,185,8.533,9324,4540,4784,6.597,13.549,8923,3980,4943,5.783,12.966,401,0.583,25.932,49,49,852
1991,487,1360,1398,16435,16146,286,21.045,208,15.305,4755,2428,2327,15.038,29.451,4108,1665,2443,10.312,25.444,647,4.007,50.887,163,163,1281
1991,488,17734,21996,340476,341722,3459,16.089,2465,11.466,69153,27505,41648,8.049,20.237,72361,26601,45760,7.784,21.175,-3208,-0.939,40.473,1659,1716,14850
1991,492,5073,8062,434554,426635,1164,14.433,1170,14.507,54512,14110,40402,3.307,12.777,37497,18520,18977,4.341,8.789,17015,3.988,17.578,780,789,6117
1991,493,6205,10298,435722,436686,1096,10.832,737,7.284,69214,24859,44355,5.693,15.850,71542,18746,52796,4.293,16.383,-2328,-0.533,31.700,334,342,5996
1991,511,18994,22374,781152,786583,2971,13.377,2643,11.900,72778,22571,50207,2.870,9.252,83707,28132,55575,3.576,10.642,-10929,-1.389,18.505,2035,2060,20110
1991,512,11345,15967,256897,258448,2368,14.801,2432,15.201,46580,19027,27553,7.362,18.023,50189,22133,28056,8.564,19.419,-3609,-1.396,36.046,1511,1559,8657
1991,515,6159,8266,248184,249004,1262,15.578,932,11.505,38625,21903,16722,8.796,15.512,40766,15447,25319,6.204,16.372,-2141,-0.860,31.024,636,649,8120
1991,517,6110,29573,1100533,1107735,6576,23.580,3207,11.499,218856,131389,87467,11.861,19.757,234338,52254,182084,4.717,21.155,-15482,-1.398,39.514,918,930,8955
1991,518,5526,7784,284348,289337,1284,16.470,1308,16.778,52446,20491,31955,7.082,18.126,62185,26130,36055,9.031,21.492,-9739,-3.366,36.253,579,586,7658
1991,519,2586,3019,37736,38352,345,11.343,390,12.823,6839,3438,3401,8.964,17.832,7945,2937,5008,7.658,20.716,-1106,-2.884,35.664,279,293,2637
1991,521,44,77,24833,24929,5,6.711,0,0.000,630,232,398,0.931,2.527,828,0,828,0.000,3.321,-198,-0.794,5.054,0,0,0
1991,522,42776,142887,2614743,2642060,26540,19.631,11158,8.253,550200,348427,201773,13.188,20.825,605899,144529,461370,5.470,22.933,-55699,-2.108,41.649,4155,4610,61229
1991,523,21419,34045,489005,488963,6965,21.033,5103,15.410,107440,57934,49506,11.848,21.973,108754,42885,65869,8.771,22.242,-1314,-0.269,43.946,3022,3061,22229
1991,524,111567,156479,2411611,2423837,21801,14.210,15691,10.227,433784,206986,226798,8.540,17.897,462385,141038,321347,5.819,19.077,-28601,-1.180,35.793,9062,9089,60694
1991,525,928,1122,17994,18676,135,12.312,84,7.661,4340,1499,2841,8.027,23.239,6030,1775,4255,9.504,32.288,-1690,-9.049,46.478,51,51,907
1991,531,155193,170965,1071619,1096779,27313,16.104,24583,14.495,255134,138157,116977,12.597,23.262,304220,130091,174129,11.861,27.738,-49086,-4.475,46.524,19106,19214,84373
1991,532,36792,54237,503081,503660,8568,15.941,7590,14.121,118391,61413,56978,12.193,23.506,120448,50360,70088,9.999,23.915,-2057,-0.408,47.012,5110,5429,31619
1991,533,1056,1169,14525,15174,308,28.038,167,15.203,3526,1745,1781,11.500,23.237,4876,2871,2005,18.921,32.134,-1350,-8.897,46.474,130,131,2616
1991,541,422955,459337,4700470,4718433,64873,14.260,56059,12.323,826034,311248,514786,6.596,17.507,863749,327484,536265,6.941,18.306,-37715,-0.799,35.013,42342,42739,214835
1991,551,28507,54558,3247624,3250365,6869,12.855,4622,8.650,518219,183333,334886,5.640,15.943,522192,108360,413832,3.334,16.066,-3973,-0.122,31.887,1178,1211,13503
1991,561,200543,229395,4311532,4332880,39658,17.524,33476,14.792,1056750,419186,637564,9.675,24.389,1098535,387163,711372,8.935,25.353,-41785,-0.964,48.778,25302,25629,263785
1991,562,12409,14076,216617,215870,1999,14.316,1773,12.698,44578,16020,28558,7.421,20.650,43245,15965,27280,7.396,20.033,1333,0.618,40.066,1291,1292,9316
1991,611,41299,45934,1920627,1897570,5595,12.348,4351,9.602,196378,45600,150778,2.403,10.349,151657,37145,114512,1.958,7.992,44721,2.357,15.984,3160,3241,26764
1991,621,367370,397867,3153176,3093029,32356,8.183,27469,6.947,554368,181507,372861,5.868,17.923,432784,157993,274791,5.108,13.992,121584,3.931,27.984,21608,21951,114573
1991,622,4130,6218,4398554,4358551,229,3.680,239,3.841,266338,58726,207612,1.347,6.111,184545,80960,103585,1.857,4.234,81793,1.877,8.468,140,149,53274
1991,623,26639,43489,1964542,1930515,5048,11.873,3100,7.292,265211,101626,163585,5.264,13.738,198290,81025,117265,4.197,10.271,66921,3.466,20.543,1983,2054,49910
1991,624,64515,85677,1184623,1163820,11014,13.154,7124,8.508,207335,73081,134254,6.279,17.815,165725,52997,112728,4.554,14.240,41610,3.575,28.480,5054,5171,37257
1991,711,19470,19941,268991,270117,3573,17.639,4203,20.749,63731,22225,41506,8.228,23.594,66765,25675,41090,9.505,24.717,-3034,-1.123,47.188,3246,3253,19265
1991,712,3105,3388,64110,63402,286,8.541,207,6.182,7678,1999,5679,3.153,12.110,6243,2140,4103,3.375,9.847,1435,2.263,19.693,162,163,1919
1991,713,40328,44509,764344,757265,5594,12.605,5332,12.015,132703,50396,82307,6.655,17.524,118401,42968,75433,5.674,15.635,14302,1.889,31.271,4125,4247,32299
1991,721,37418,44693,1462405,1479806,5073,11.368,4934,11.057,228649,113605,115044,7.677,15.451,263428,101454,161974,6.856,17.802,-34779,-2.350,30.903,3552,3612,67892
1991,722,287111,385560,6481345,6558617,57150,14.891,53582,13.962,1252157,689871,562286,10.519,19.092,1404292,565681,838611,8.625,21.411,-152135,-2.320,38.184,39191,40578,388164
1991,811,177193,192734,1125773,1145022,26533,13.851,24196,12.631,216377,101602,114775,8.873,18.897,254723,95617,159106,8.351,22.246,-38346,-3.349,37.794,18443,18626,72933
1991,812,142781,174185,1147909,1162013,22128,12.687,22599,12.957,221615,102130,119485,8.789,19.072,249461,97118,152343,8.358,21.468,-27846,-2.396,38.143,16959,17449,69855
1991,813,245565,253909,2255513,2233316,15818,6.281,11669,4.634,296952,62695,234257,2.807,13.296,252461,55314,197147,2.477,11.304,44491,1.992,22.609,7874,7897,40740
1992,113,11418,11542,85937,85790,1676,14.517,1682,14.569,20570,6882,13688,8.022,23.977,20301,7036,13265,8.201,23.664,269,0.314,47.327,1265,1266,5261
1992,114,1210,1220,11270,11495,211,17.460,188,15.556,2995,1166,1829,10.144,26.056,3484,1356,2128,11.797,30.310,-489,-4.254,52.112,141,142,966
1992,115,7663,8027,89702,87038,1149,14.469,977,12.303,23303,7397,15906,8.499,26.773,17995,5861,12134,6.734,20.675,5308,6.098,41.350,703,708,4645
1992,211,6837,8071,115884,117809,779,9.465,1097,13.329,26314,6217,20097,5.277,22.336,29542,10450,19092,8.870,25.076,-3228,-2.740,44.672,620,623,3274
1992,212,5322,7713,259629,266292,752,9.564,1052,13.379,36063,14835,21228,5.571,13.543,49126,17561,31565,6.595,18.448,-13063,-4.906,27.085,658,674,7644
1992,213,7862,8866,144833,158798,1079,11.858,1546,16.990,25680,10776,14904,6.786,16.172,53891,17416,36475,10.967,33.937,-28211,-17.765,32.343,1037,1044,7149
1992,221,5717,13627,772695,772812,1127,8.419,647,4.833,82275,41305,40970,5.345,10.646,82499,23484,59015,3.039,10.675,-224,-0.029,21.292,300,301,1417
1992,236,148562,149706,1145732,1173711,26497,17.633,27617,18.379,295036,100334,194702,8.548,25.137,351786,114427,237359,9.749,29.972,-56750,-4.835,50.274,19543,19556,82392
1992,237,34234,35284,658957,669991,3845,10.636,5578,15.430,137106,24911,112195,3.718,20.464,158720,38549,120171,5.754,23.690,-21614,-3.226,40.928,4165,4176,26467
1992,238,316319,319736,2705111,2757317,42562,13.233,46338,14.408,627511,172599,454912,6.260,22.758,731392,213900,517492,7.758,26.525,-103881,-3.767,45.516,33860,33886,161393
1992,311,20559,25520,1376085,1380021,2269,8.823,2663,10.355,138256,30473,107783,2.208,10.018,146437,48434,98003,3.510,10.611,-8181,-0.593,20.037,1758,1782,20942
1992,312,1738,2209,168937,170387,162,7.324,168,7.595,13145,2588,10557,1.519,7.715,16291,3644,12647,2.139,9.561,-3146,-1.846,15.430,127,127,1532
1992,313,7064,8528,480726,477700,842,9.921,760,8.955,46144,9086,37058,1.902,9.660,40112,12470,27642,2.610,8.397,6032,1.263,16.794,508,522,4401
1992,314,6910,7330,233558,232066,722,9.663,1005,13.451,33756,6730,27026,2.900,14.546,30700,10793,19907,4.651,13.229,3056,1.317,26.458,822,826,8141
1992,315,13968,15448,873497,870808,2421,15.526,2712,17.392,139941,48128,91813,5.527,16.070,135055,62574,72481,7.186,15.509,4886,0.561,31.018,2286,2304,44658
1992,316,1666,1856,111126,111800,175,9.371,198,10.602,12861,2690,10171,2.406,11.504,14166,5377,8789,4.809,12.671,-1305,-1.167,23.007,140,141,1331
1992,321,14341,15980,471979,468219,1465,9.075,1791,11.095,66042,14008,52034,2.992,14.105,58377,20573,37804,4.394,12.468,7665,1.637,24.936,1337,1339,11835
1992,322,3622,5647,584865,587093,258,4.541,326,5.738,36684,9320,27364,1.587,6.248,41014,10505,30509,1.789,6.986,-4330,-0.738,12.497,198,202,3879
1992,323,42035,44047,812066,818945,3666,8.268,4256,9.598,89295,25928,63367,3.166,10.904,103683,33704,69979,4.116,12.661,-14388,-1.757,21.807,3468,3476,21955
1992,324,1106,2005,112735,112363,106,5.182,187,9.142,9226,2682,6544,2.387,8.211,8426,3955,4471,3.520,7.499,800,0.712,14.998,78,78,615
1992,325,8481,12258,917602,916371,757,6.126,954,7.721,78022,18946,59076,2.068,8.514,75130,22666,52464,2.473,8.199,2892,0.316,16.397,566,574,6778
1992,326,12295,14940,852890,843856,1068,7.145,1082,7.239,101868,20965,80903,2.484,12.072,83510,23528,59982,2.788,9.896,18358,2.175,19.792,748,757,10103
1992,327,11173,15041,454569,458853,998,6.575,1275,8.399,51372,13233,38139,2.884,11.196,59532,19024,40508,4.146,12.974,-8160,-1.778,22.392,797,805,7025
1992,331,4155,5119,582964,592913,261,5.018,425,8.172,34563,6324,28239,1.067,5.829,54289,14327,39962,2.416,9.156,-19726,-3.327,11.659,284,285,3665
1992,332,50767,54423,1513490,1534263,3779,6.888,4660,8.494,156935,35861,121074,2.337,10.229,198015,51443,146572,3.353,12.906,-41080,-2.678,20.457,3440,3462,27653
1992,333,25564,28061,1253285,1274234,1734,6.145,2049,7.261,109416,23143,86273,1.816,8.587,150998,36496,114502,2.864,11.850,-41582,-3.263,17.174,1433,1444,13099
1992,334,13623,15531,1528430,1585871,1452,9.299,1619,10.369,126161,31244,94917,1.970,7.955,240830,72558,168272,4.575,15.186,-114669,-7.231,15.911,1107,1112,19178
1992,335,5439,6541,555360,561052,431,6.525,560,8.478,46972,11807,35165,2.104,8.372,58571,15637,42934,2.787,10.439,-11599,-2.067,16.744,357,360,3937
1992,336,9463,11213,1786713,1787515,830,7.351,987,8.741,190666,55486,135180,3.104,10.667,191250,69668,121582,3.897,10.699,-584,-0.033,21.333,708,713,9037
1992,337,17171,18203,530679,535179,1906,10.336,2382,12.917,65598,16305,49293,3.047,12.257,74731,25567,49164,4.777,13.964,-9133,-1.707,24.514,1797,1809,15400
1992,339,25633,26731,653523,649755,2589,9.639,2848,10.603,87391,21578,65813,3.321,13.450,79877,27401,52476,4.217,12.293,7514,1.156,24.587,2221,2223,15200
1992,423,167164,214764,2601353,2631123,22231,10.326,23279,10.813,402064,129759,272305,4.932,15.281,460769,161019,299750,6.120,17.512,-58705,-2.231,30.562,13754,14487,75909
1992,424,96644,124008,1936440,1926638,13091,10.513,14120,11.339,337776,104562,233214,5.427,17.532,318561,127480,191081,6.617,16.535,19215,0.997,33.069,8812,8983,50517
1992,425,31274,33535,287416,290943,3771,11.299,3451,10.340,47766,16348,31418,5.619,16.418,54972,22325,32647,7.673,18.894,-7206,-2.477,32.835,2148,2169,10993
1992,441,87215,109183,1430299,1434187,9585,8.716,11156,10.145,198984,70188,128796,4.894,13.874,206384,85276,121108,5.946,14.390,-7400,-0.516,27.749,7414,7709,61223
1992,442,44836,58758,422237,424793,6535,11.086,6913,11.727,76336,30445,45891,7.167,17.970,81737,29101,52636,6.851,19.242,-5401,-1.271,35.940,4264,4552,17626
1992,443,29255,45222,333851,331983,5295,11.648,5769,12.691,72002,32806,39196,9.882,21.688,68362,29001,39361,8.736,20.592,3640,1.096,41.184,3173,3441,15057
1992,444,70757,93174,969608,969870,6515,6.932,8147,8.668,145947,47265,98682,4.873,15.048,147885,53355,94530,5.501,15.248,-1938,-0.200,30.096,5144,5293,25723
1992,445,103414,141308,2678677,2696357,15104,10.578,18065,12.652,331063,145332,185731,5.390,12.278,366102,124282,241820,4.609,13.578,-35039,-1.299,24.556,11593,12005,62031
1992,446,46761,77392,755314,757015,7292,9.400,7665,9.880,116165,51869,64296,6.852,15.345,119203,48105,71098,6.355,15.746,-3038,-0.401,30.690,4343,4504,22081
1992,447,74999,127511,897279,917027,10901,8.441,14153,10.960,153307,61105,92202,6.663,16.718,192243,76218,116025,8.311,20.964,-38936,-4.246,33.436,8098,8576,43362
1992,448,75343,164179,1326185,1341090,17594,10.579,21855,13.141,242090,113305,128785,8.449,18.052,271608,106939,164669,7.974,20.253,-29518,-2.201,36.103,10430,11844,45287
1992,451,40235,57276,432990,429746,7046,12.267,7372,12.834,87523,35497,52026,8.260,20.366,80846,31889,48957,7.420,18.813,6677,1.554,37.625,4842,5115,17823
1992,452,10425,33968,2067662,2085594,3056,8.931,3553,10.384,203296,96087,107209,4.607,9.748,241890,72424,169466,3.473,11.598,-38594,-1.851,19.495,1450,1543,10950
1992,453,88604,106004,598591,599995,15787,14.875,16038,15.112,138669,64226,74443,10.704,23.112,140448,64427,76021,10.738,23.408,-1779,-0.297,46.223,11144,11484,37398
1992,454,27697,36075,417832,417646,3883,10.705,4279,11.797,81424,28618,52806,6.852,19.496,80242,25264,54978,6.049,19.213,1182,0.283,38.426,2530,2573,13633
1992,481,1712,4211,458438,476760,437,10.333,473,11.185,37242,4875,32367,1.023,7.811,75895,8222,67673,1.725,15.919,-38653,-8.107,15.623,180,183,2071
1992,483,664,1012,52106,52279,119,11.794,113,11.199,9057,2452,6605,4.690,17.325,9328,1894,7434,3.623,17.843,-271,-0.518,34.649,67,67,991
1992,484,66524,77766,1106933,1098535,11772,15.190,11233,14.495,208583,67956,140627,6.186,18.987,190869,75085,115784,6.835,17.375,17714,1.613,34.750,8349,8450,46285
1992,485,11465,13213,279761,276452,1898,14.465,1715,13.070,56506,20773,35733,7.514,20.440,49723,18666,31057,6.752,17.986,6783,2.454,35.972,1282,1289,11028
1992,486,221,2071,58327,59883,298,14.745,198,9.797,9226,5941,3285,9.921,15.407,12293,4361,7932,7.283,20.529,-3067,-5.122,30.814,25,25,176
1992,487,1548,1620,19053,18743,309,19.782,193,12.356,4527,1606,2921,8.569,24.153,3946,1800,2146,9.604,21.053,581,3.100,42.106,151,151,1272
1992,488,17948,22567,325333,325726,3545,16.005,2710,12.235,67650,24326,43324,7.468,20.769,68709,25703,43006,7.891,21.094,-1059,-0.325,41.538,1803,1844,13785
1992,492,4800,7984,415614,420815,1273,16.161,1059,13.444,40870,13318,27552,3.165,9.712,52788,13650,39138,3.244,12.544,-11918,-2.832,19.424,731,735,5119
1992,493,6152,10331,446642,441789,958,9.303,891,8.653,81192,34167,47025,7.734,18.378,71555,16381,55174,3.708,16.197,9637,2.181,32.393,310,320,3206
1992,511,19672,23432,797184,852283,2882,12.405,2482,10.684,88836,28135,60701,3.301,10.423,201988,29987,172001,3.518,23.700,-113152,-13.276,20.847,1822,1828,14369
1992,512,11302,15876,226968,241474,2484,15.653,2470,15.565,48523,22434,26089,9.290,20.095,76865,45600,31265,18.884,31.832,-28342,-11.737,40.189,1402,1520,11029
1992,515,6085,8174,235517,238720,882,10.841,805,9.895,31612,13877,17735,5.813,13.242,37670,13285,24385,5.565,15.780,-6058,-2.538,26.485,527,530,5494
1992,517,6305,29910,1078272,1090654,3727,12.544,3328,11.201,158868,63680,95188,5.839,14.566,182434,76019,106415,6.970,16.727,-23566,-2.161,29.133,773,793,13689
1992,518,5059,7325,268089,274863,1057,14.330,1159,15.713,55806,20528,35278,7.468,20.303,68368,29776,38592,10.833,24.873,-12562,-4.570,40.606,530,540,17425
1992,519,2412,2829,38290,37422,242,8.548,246,8.690,6330,1260,5070,3.367,16.915,4579,1530,3049,4.089,12.236,1751,4.679,24.473,180,181,1079
1992,521,14,44,24095,24187,D,D,10,20.619,624,D,623,D,2.580,803,290,513,1.199,3.320,-179,-0.740,5.160,3,3,10
1992,522,42562,145064,2561868,2596495,12703,8.827,10403,7.229,427221,133873,293348,5.156,16.454,499108,131491,367617,5.064,19.222,-71887,-2.769,32.908,3137,3424,35422
1992,523,23781,38010,511882,500640,6792,18.512,4153,11.319,101414,36308,65106,7.252,20.257,78368,33077,45291,6.607,15.654,23046,4.603,31.307,2521,2551,13223
1992,524,108591,153184,2241178,2256021,15271,9.956,15675,10.219,341969,120540,221429,5.343,15.158,370861,149164,221697,6.612,16.439,-28892,-1.281,30.316,8368,8484,62162
1992,525,680,711,18012,17405,117,16.318,129,17.992,3003,605,2398,3.476,17.254,1738,817,921,4.694,9.986,1265,7.268,19.972,81,81,409
1992,531,155708,172662,1071881,1072278,22805,13.265,21310,12.396,235199,98945,136254,9.228,21.935,235509,92423,143086,8.619,21.963,-310,-0.029,43.869,15543,15732,60658
1992,532,36370,54953,476767,493120,7705,14.018,7728,14.060,101221,44371,56850,8.998,20.527,131814,55493,76321,11.253,26.731,-30593,-6.204,41.053,4879,5321,33510
1992,533,1322,1467,21607,20664,265,18.512,194,13.552,5501,1477,4024,7.148,26.621,3759,1336,2423,6.465,18.191,1742,8.430,36.382,124,124,1001
1992,541,432139,469711,4665589,4652460,62903,13.538,52788,11.361,860879,304047,556832,6.535,18.504,829925,338609,491316,7.278,17.838,30954,0.665,35.677,37120,37446,227254
1992,551,28396,53457,3213472,3231654,4880,9.028,6076,11.240,572092,154983,417109,4.796,17.703,609150,173008,436142,5.354,18.849,-37058,-1.147,35.406,887,922,14297
1992,561,200007,230010,4494763,4408123,38329,16.795,34736,15.221,1158912,422765,736147,9.591,26.290,982669,356039,626630,8.077,22.292,176243,3.998,44.584,25536,25777,215155
1992,562,12322,14128,219460,219122,1808,12.817,1765,12.512,43421,15119,28302,6.900,19.816,42684,15624,27060,7.130,19.480,737,0.336,38.959,1265,1274,8719
1992,611,41577,46887,1975609,1945372,5551,11.992,4356,9.410,200344,36314,164030,1.867,10.298,139040,33652,105388,1.730,7.147,61304,3.151,14.294,3143,3203,24002
1992,621,371419,404693,3396070,3286175,33041,8.235,26111,6.508,640465,194530,445935,5.920,19.490,420140,137570,282570,4.186,12.785,220325,6.705,25.570,18819,19135,85800
1992,622,3794,5960,4573669,4496042,255,4.274,268,4.492,434316,133315,301001,2.965,9.660,280938,65732,215206,1.462,6.249,153378,3.411,12.497,142,145,40982
1992,623,26636,45077,2058225,2009424,4947,11.237,2844,6.460,281316,111024,170292,5.525,14.000,184318,70168,114150,3.492,9.173,96998,4.827,18.345,1803,1875,44150
1992,624,68535,90610,1254152,1224337,10519,11.853,6793,7.654,222392,64825,157567,5.295,18.164,162836,43274,119562,3.534,13.300,59556,4.864,26.600,4519,4622,26333
1992,711,19511,20010,269172,269759,3716,18.685,3471,17.453,72241,24586,47655,9.114,26.780,72975,32757,40218,12.143,27.052,-734,-0.272,53.560,2471,2474,14278
1992,712,3023,3319,66879,65789,253,7.710,178,5.424,8754,1466,7288,2.228,13.306,6478,1287,5191,1.956,9.847,2276,3.460,19.693,109,109,621
1992,713,41172,45392,806379,784810,5716,12.718,4822,10.729,157000,55848,101152,7.116,20.005,113583,39714,73869,5.060,14.473,43417,5.532,28.945,3539,3592,28680
1992,721,37035,44289,1470411,1477940,4827,10.898,4834,10.914,217991,97247,120744,6.580,14.750,233088,104569,128519,7.075,15.771,-15097,-1.021,29.499,2988,3044,60460
1992,722,292427,392662,6657097,6579455,57836,14.821,52964,13.573,1386432,698171,688261,10.611,21.072,1235630,541207,694423,8.226,18.780,150802,2.292,37.560,36112,37098,326088
1992,811,181849,198851,1140012,1146115,25717,12.982,24197,12.215,218707,94371,124336,8.234,19.082,230732,88041,142691,7.682,20.132,-12025,-1.049,38.165,17657,17777,60207
1992,812,140367,172109,1121514,1128544,21180,12.261,22434,12.987,210938,90267,120671,7.999,18.691,224752,94806,129946,8.401,19.915,-13814,-1.224,37.382,15373,15753,63918
1992,813,252491,260870,2316323,2287117,16174,6.259,11227,4.345,329173,61140,268033,2.673,14.392,270610,56822,213788,2.484,11.832,58563,2.561,23.664,7093,7126,39287
1993,113,11803,11931,87059,87056,1809,15.316,1569,13.284,19910,7049,12861,8.097,22.870,20080,6030,14050,6.927,23.066,-170,-0.195,45.741,1149,1149,4329
1993,114,1350,1367,11562,11544,192,14.066,188,13.773,3273,1322,1951,11.452,28.352,3227,1633,1594,14.146,27.954,46,0.398,55.908,136,137,1297
1993,115,7583,7930,87172,87375,1040,13.116,1039,13.103,21679,6645,15034,7.605,24.811,21858,7493,14365,8.576,25.016,-179,-0.205,49.623,722,723,4996
1993,211,6892,8089,100146,109360,768,9.429,880,10.804,16069,6435,9634,5.884,14.694,34629,5644,28985,5.161,31.665,-18560,-16.972,29.387,563,564,1928
1993,212,5111,7465,246351,253158,635,8.337,939,12.328,29567,9798,19769,3.870,11.679,43446,16683,26763,6.590,17.162,-13879,-5.482,23.359,581,597,7096
1993,213,7423,8391,134358,136160,1192,14.062,1364,16.091,35322,13292,22030,9.762,25.942,38768,15006,23762,11.021,28.472,-3446,-2.531,51.883,918,920,6355
1993,221,6039,14072,759131,765841,894,6.425,578,4.154,59421,17240,42181,2.251,7.759,73117,10426,62691,1.361,9.547,-13696,-1.788,15.518,217,221,1339
1993,236,148514,149645,1153765,1142838,27142,18.281,24795,16.700,311234,101289,209945,8.863,27.233,289149,96548,192601,8.448,25.301,22085,1.932,50.602,17685,17689,70881
1993,237,34861,35933,648229,656832,4490,12.512,4396,12.250,133105,26506,106599,4.035,20.265,151170,32789,118381,4.992,23.015,-18065,-2.750,40.529,3339,3344,20248
1993,238,320408,323778,2748940,2723282,47416,14.787,41166,12.838,684799,186516,498283,6.849,25.146,633602,189992,443610,6.977,23.266,51197,1.880,46.532,30765,30786,149692
1993,311,20705,25547,1394493,1386209,2244,8.787,2225,8.713,142626,32975,109651,2.379,10.289,125342,37389,87953,2.697,9.042,17284,1.247,18.084,1586,1635,17346
1993,312,1738,2207,166694,168075,153,6.934,152,6.889,13774,1819,11955,1.082,8.195,16362,2832,13530,1.685,9.735,-2588,-1.540,16.390,104,104,1087
1993,313,7166,8617,472241,475849,813,9.467,755,8.791,41950,10731,31219,2.255,8.816,48785,15836,32949,3.328,10.252,-6835,-1.436,17.632,569,577,4526
1993,314,6899,7320,232511,232520,814,11.095,847,11.545,31046,8805,22241,3.787,13.352,31073,11423,19650,4.913,13.364,-27,-0.012,26.704,679,680,6884
1993,315,13896,15340,851861,861460,2597,16.876,2695,17.513,125833,45763,80070,5.312,14.607,144545,62800,81745,7.290,16.779,-18712,-2.172,29.214,2258,2277,45364
1993,316,1674,1858,112662,111611,185,9.992,172,9.290,15758,5122,10636,4.589,14.119,13994,4141,9853,3.710,12.538,1764,1.580,25.076,129,129,1412
1993,321,14596,16247,494096,484087,1674,10.342,1554,9.600,71520,17538,53982,3.623,14.774,51490,16756,34734,3.461,10.637,20030,4.138,21.273,1200,1209,10626
1993,322,3648,5670,584535,584095,283,5.001,261,4.612,36851,7995,28856,1.369,6.309,35977,10664,25313,1.826,6.159,874,0.150,12.319,169,173,2729
1993,323,41641,43650,814434,813935,3573,8.150,3951,9.013,93033,23191,69842,2.849,11.430,92295,28254,64041,3.471,11.339,738,0.091,22.679,3280,3290,18856
1993,324,1116,2059,112897,112938,153,7.515,107,5.255,8637,2296,6341,2.033,7.648,8774,2005,6769,1.775,7.769,-137,-0.121,15.295,57,58,623
1993,325,8692,12526,908138,909423,907,7.292,733,5.893,72264,15086,57178,1.659,7.946,74369,15387,58982,1.692,8.178,-2105,-0.231,15.892,444,451,4310
1993,326,12373,15055,882800,866914,1075,7.165,973,6.485,104093,20542,83551,2.370,12.007,72395,19799,52596,2.284,8.351,31698,3.656,16.702,699,705,8167
1993,327,11179,15011,455438,454622,1065,7.081,1122,7.460,48496,10820,37676,2.380,10.667,46855,12392,34463,2.726,10.306,1641,0.361,20.613,732,741,5355
1993,331,4154,5115,573655,578117,287,5.594,318,6.198,37683,7179,30504,1.242,6.518,46866,7401,39465,1.280,8.107,-9183,-1.588,13.036,218,218,3068
1993,332,51283,54899,1524173,1520859,4243,7.754,3882,7.094,173907,34868,139039,2.293,11.435,167830,45833,121997,3.014,11.035,6077,0.400,22.070,2920,2943,22729
1993,333,25775,28228,1246498,1250355,1912,6.786,1808,6.417,122157,22937,99220,1.834,9.770,129877,36821,93056,2.945,10.387,-7720,-0.617,19.540,1306,1315,11382
1993,334,13799,15685,1495770,1515713,1466,9.388,1329,8.510,133323,28044,105279,1.850,8.796,172239,35366,136873,2.333,11.364,-38916,-2.568,17.592,952,959,11683
1993,335,5370,6453,554138,554460,400,6.163,474,7.304,50025,8942,41083,1.613,9.022,50223,12265,37958,2.212,9.058,-198,-0.036,18.045,325,328,4157
1993,336,9575,11288,1774000,1792308,972,8.639,899,7.990,161931,39965,121966,2.230,9.035,199508,44816,154692,2.500,11.131,-37577,-2.097,18.070,634,640,9584
1993,337,17597,18587,545246,538646,2195,11.850,2067,11.159,75196,17235,57961,3.200,13.960,62027,22510,39517,4.179,11.515,13169,2.445,23.031,1549,1567,13783
1993,339,26179,27290,679944,667199,2895,10.712,2366,8.755,96753,27145,69608,4.069,14.501,70742,17478,53264,2.620,10.603,26011,3.899,21.206,1852,1858,10253
1993,423,168971,216732,2639448,2617421,22424,10.391,20576,9.534,418422,119653,298769,4.571,15.986,374332,130150,244182,4.972,14.302,44090,1.684,28.603,13784,14158,71191
1993,424,98222,124947,1963560,1948019,13144,10.551,12402,9.955,301002,92936,208066,4.771,15.452,269377,91896,177481,4.717,13.828,31625,1.623,27.657,8562,8723,52118
1993,425,31990,34238,290362,289031,3662,10.805,2967,8.755,46600,14536,32064,5.029,16.123,44027,13929,30098,4.819,15.233,2573,0.890,30.465,2050,2057,8765
1993,441,87588,109477,1468998,1449428,9455,8.651,9099,8.325,204418,64512,139906,4.451,14.103,165602,61350,104252,4.233,11.425,38816,2.678,22.851,6482,6736,45645
1993,442,45026,58947,441732,432457,5865,9.947,5893,9.995,86448,28408,58040,6.569,19.990,67963,25131,42832,5.811,15.716,18485,4.274,31.431,3923,4155,16384
1993,443,29569,45394,341352,337057,5108,11.275,4931,10.884,67990,29286,38704,8.689,20.172,59550,23581,35969,6.996,17.668,8440,2.504,35.335,3116,3316,14964
1993,444,70521,93007,987672,978158,6337,6.797,6780,7.272,144082,46174,97908,4.721,14.730,125674,37779,87895,3.862,12.848,18408,1.882,25.696,4797,4946,21715
1993,445,103384,140994,2716856,2700459,15392,10.905,15700,11.123,355457,161914,193543,5.996,13.163,323926,114279,209647,4.232,11.995,31531,1.168,23.990,10499,10781,56412
1993,446,46405,77224,758821,757017,6558,8.485,6696,8.663,107457,44623,62834,5.895,14.195,105262,40374,64888,5.333,13.905,2195,0.290,27.810,4036,4243,20947
1993,447,74092,125190,890766,893882,9958,7.885,12146,9.618,158318,56472,101846,6.318,17.711,164910,69230,95680,7.745,18.449,-6592,-0.737,35.423,6825,7181,36092
1993,448,74028,160572,1349576,1337767,15963,9.835,19441,11.978,272451,99856,172595,7.464,20.366,248322,97599,150723,7.296,18.562,24129,1.804,37.125,9067,9980,37605
1993,451,40678,57519,445470,439200,6774,11.801,6535,11.385,92105,38493,53612,8.764,20.971,79281,31276,48005,7.121,18.051,12824,2.920,36.102,4275,4479,16429
1993,452,10407,34522,2188113,2127656,3064,8.949,2498,7.296,291155,130804,160351,6.148,13.684,173827,46998,126829,2.209,8.170,117328,5.514,16.340,1144,1240,7020
1993,453,90360,107831,627320,613212,14910,13.937,13206,12.344,143440,63929,79511,10.425,23.392,115252,45588,69664,7.434,18.795,28188,4.597,37.590,9810,10123,32820
1993,454,28131,36118,417158,416873,3861,10.703,3773,10.459,71804,21552,50252,5.170,17.224,70977,26379,44598,6.328,17.026,827,0.198,34.052,2460,2495,12792
1993,481,1736,4216,459026,458444,481,11.432,464,11.028,42475,7327,35148,1.598,9.265,40588,8074,32514,1.761,8.853,1887,0.412,17.707,183,186,2073
1993,483,680,1040,48523,50099,137,13.359,108,10.531,7114,1895,5219,3.783,14.200,9948,2611,7337,5.212,19.857,-2834,-5.657,28.400,68,68,1066
1993,484,69045,80229,1131728,1120150,12866,16.265,10613,13.417,205909,65919,139990,5.885,18.382,183099,71055,112044,6.343,16.346,22810,2.036,32.692,7991,8093,47273
1993,485,11791,13590,287125,283523,1839,13.719,1469,10.959,48984,17850,31134,6.296,17.277,41479,15664,25815,5.525,14.630,7505,2.647,29.260,1167,1186,10893
1993,486,231,2057,54389,56287,171,8.285,185,8.963,5198,2345,2853,4.166,9.235,9018,2269,6749,4.031,16.022,-3820,-6.787,18.470,26,31,341
1993,487,1625,1694,19922,19579,254,15.214,205,12.279,4386,1049,3337,5.358,22.402,3749,1200,2549,6.129,19.149,637,3.254,38.297,145,146,838
1993,488,18816,23424,335622,331558,3287,14.258,2548,11.052,66631,22022,44609,6.642,20.096,58397,19794,38603,5.970,17.613,8234,2.483,35.226,1729,1769,9306
1993,492,5148,8417,441943,429206,1177,14.349,748,9.119,54138,8136,46002,1.896,12.614,27188,7467,19721,1.740,6.334,26950,6.279,12.669,548,551,4687
1993,493,6197,10294,426003,436575,818,7.913,905,8.755,63620,14812,48808,3.393,14.573,85384,23229,62155,5.321,19.558,-21764,-4.985,29.145,272,279,3082
1993,511,20254,24184,812435,804167,2993,12.572,2240,9.409,98673,34803,63870,4.328,12.270,82609,29596,53013,3.680,10.273,16064,1.998,20.545,1640,1645,12978
1993,512,11644,16212,245953,245783,2404,14.975,2087,13.000,51325,15517,35808,6.313,20.882,51321,19626,31695,7.985,20.881,4,0.002,41.761,1332,1361,14442
1993,515,6268,8317,238849,237446,864,10.467,739,8.953,32509,12102,20407,5.097,13.691,29911,11307,18604,4.762,12.597,2598,1.094,25.194,494,520,5555
1993,517,6919,30026,1059897,1070177,3719,12.410,3604,12.026,159956,58334,101622,5.451,14.947,179048,58935,120113,5.507,16.731,-19092,-1.784,29.893,665,690,5998
1993,518,5073,7191,276954,272828,856,11.790,995,13.704,51641,13768,37873,5.046,18.928,43136,13584,29552,4.979,15.811,8505,3.117,31.621,507,513,5347
1993,519,2516,2911,37914,38108,304,10.532,255,8.834,7594,4989,2605,13.092,19.928,7979,5156,2823,13.530,20.938,-385,-1.010,39.855,135,204,4467
1993,521,17,48,23944,24021,5,10.753,D,D,443,23,420,0.096,1.844,613,D,545,D,2.552,-170,-0.708,3.689,D,D,D
1993,522,43185,141732,2471194,2511558,11574,8.074,14817,10.336,423004,124605,298399,4.961,16.842,508468,235588,272880,9.380,20.245,-85464,-3.403,33.685,2854,3446,28008
1993,523,25587,39779,499109,494898,6795,17.306,5765,14.683,102926,41444,61482,8.374,20.797,95889,43882,52007,8.867,19.376,7037,1.422,38.751,2722,2754,13830
1993,524,111688,154826,2252291,2253320,16087,10.436,14740,9.562,342009,108247,233762,4.804,15.178,343309,116561,226748,5.173,15.236,-1300,-0.058,30.356,7419,7599,32328
1993,525,633,670,18279,17879,51,7.375,94,13.594,3386,719,2667,4.021,18.938,2538,1286,1252,7.193,14.195,848,4.743,28.391,69,69,364
1993,531,160464,177553,1097007,1085427,23864,13.614,19328,11.027,235785,96919,138866,8.929,21.723,212725,79247,133478,7.301,19.598,23060,2.125,39.197,14148,14379,53648
1993,532,36368,54978,496839,487600,6503,11.811,6664,12.103,112929,35226,77703,7.224,23.160,94422,38881,55541,7.974,19.365,18507,3.796,38.729,4411,4587,21716
1993,533,1419,1562,18169,19340,277,18.248,189,12.451,4385,1441,2944,7.451,22.673,6649,3861,2788,19.964,34.380,-2264,-11.706,45.346,132,132,1352
1993,541,447763,484706,4854331,4786710,65387,13.700,50495,10.580,901161,313128,588033,6.542,18.826,767037,241687,525350,5.049,16.024,134124,2.802,32.049,35539,37338,147298
1993,551,28308,51481,3161463,3191561,4487,8.557,6401,12.207,529770,131911,397859,4.133,16.599,590957,158958,431999,4.981,18.516,-61187,-1.917,33.198,853,895,11920
1993,561,208322,238220,4886203,4686978,39897,17.043,31655,13.522,1338876,417021,921855,8.897,28.566,939156,329219,609937,7.024,20.038,399720,8.528,40.075,23104,23553,211798
1993,562,12698,14571,247107,238183,1867,13.006,1435,9.997,51717,15165,36552,6.367,21.713,33944,11967,21977,5.024,14.251,17773,7.462,28.502,1077,1085,7050
1993,611,43203,48516,2018956,1980406,5827,12.221,4153,8.710,222053,51923,170130,2.622,11.213,144547,32149,112398,1.623,7.299,77506,3.914,14.598,2913,2993,22286
1993,621,374928,410034,3608416,3505745,31899,7.831,26507,6.507,679063,219524,459539,6.262,19.370,475579,154964,320615,4.420,13.566,203484,5.804,27.131,20143,20567,95960
1993,622,3741,5946,4620340,4599994,186,3.121,215,3.607,270956,34624,236332,0.753,5.890,232106,75471,156635,1.641,5.046,38850,0.845,10.092,83,84,23911
1993,623,27516,46550,2133612,2094724,4420,9.651,2919,6.373,269643,85644,183999,4.089,12.872,192237,72598,119639,3.466,9.177,77406,3.695,18.354,1568,1628,35523
1993,624,71964,94815,1334374,1293220,11442,12.343,7219,7.787,256418,75025,181393,5.801,19.828,173913,45224,128689,3.497,13.448,82505,6.380,26.896,4747,4858,27800
1993,711,19909,20413,280462,275039,3521,17.416,3130,15.482,71414,21191,50223,7.705,25.965,60191,17591,42600,6.396,21.885,11223,4.081,43.769,2219,2224,11475
1993,712,3214,3520,72138,69510,356,10.406,158,4.619,11065,1722,9343,2.477,15.919,5706,724,4982,1.042,8.209,5359,7.710,16.418,101,101,413
1993,713,42762,47067,850634,828167,5965,12.891,4374,9.453,159143,62688,96455,7.569,19.216,113849,33809,80040,4.082,13.747,45294,5.469,27.494,3308,3365,24492
1993,721,37717,44795,1468426,1466229,4628,10.394,4087,9.179,206001,84755,121246,5.780,14.050,200864,85484,115380,5.830,13.699,5137,0.350,27.399,2722,2796,45623
1993,722,300549,398630,6763873,6709383,54865,13.867,48928,12.366,1340956,653977,686979,9.747,19.986,1231455,490260,741195,7.307,18.354,109501,1.632,36.708,33647,34768,300306
1993,811,185134,201748,1160936,1151367,24871,12.406,22327,11.137,221176,85660,135516,7.440,19.210,201785,75104,126681,6.523,17.526,19391,1.684,35.051,16554,16740,54199
1993,812,141766,173042,1142158,1132241,20080,11.639,19055,11.044,217716,80836,136880,7.139,19.229,199094,78747,120347,6.955,17.584,18622,1.645,35.168,13494,13991,51536
1993,813,254893,263129,2361584,2330690,15170,5.794,12578,4.804,316445,53515,262930,2.296,13.577,254799,47789,207010,2.050,10.932,61646,2.645,21.865,8586,8629,32449
1994,113,12289,12435,89000,88018,2052,16.829,1568,12.860,20660,8257,12403,9.381,23.472,18488,6116,12372,6.949,21.005,2172,2.468,42.010,1194,1194,4545
1994,114,1341,1356,11804,11457,217,16.194,185,13.806,4263,790,3473,6.895,37.209,3505,860,2645,7.506,30.593,758,6.616,61.185,138,138,751
1994,115,7759,8112,88128,87958,1118,13.953,919,11.470,19787,6248,13539,7.103,22.496,19360,6533,12827,7.427,22.011,427,0.485,44.021,654,654,4084
1994,211,6732,8013,100470,100611,797,9.877,909,11.265,18144,7439,10705,7.394,18.034,18668,6964,11704,6.922,18.555,-524,-0.521,36.068,603,611,2465
1994,212,4988,7352,241662,244809,645,8.682,800,10.768,32139,11541,20598,4.714,13.128,38570,13741,24829,5.613,15.755,-6431,-2.627,26.256,505,512,5819
1994,213,7418,8429,146501,141851,1088,12.873,1133,13.406,37393,10479,26914,7.387,26.361,27819,8894,18925,6.270,19.611,9574,6.749,39.223,779,782,5122
1994,221,6014,14170,740969,750641,840,5.975,619,4.403,44132,16639,27493,2.217,5.879,63311,8160,55151,1.087,8.434,-19179,-2.555,11.758,266,281,1450
1994,236,153180,154407,1199112,1175159,28950,19.096,23335,15.393,327437,106566,220871,9.068,27.863,279667,91424,188243,7.780,23.798,47770,4.065,47.596,16765,16772,68122
1994,237,35763,36836,662728,655955,4994,13.725,4093,11.249,145206,31324,113882,4.775,22.137,132189,30427,101762,4.639,20.152,13017,1.984,40.304,3066,3081,21239
1994,238,331616,334933,2892816,2825474,49751,15.087,39418,11.953,738154,198080,540074,7.011,26.125,603488,186987,416501,6.618,21.359,134666,4.766,42.718,29572,29590,144958
1994,311,20833,25614,1411963,1409149,2342,9.134,2395,9.341,140016,35112,104904,2.492,9.936,134141,39673,94468,2.815,9.519,5875,0.417,19.039,1696,1729,17912
1994,312,1764,2222,160516,163375,186,8.424,158,7.156,12553,2961,9592,1.812,7.684,18208,3236,14972,1.981,11.145,-5655,-3.461,15.367,110,110,1220
1994,313,7261,8695,480104,480036,786,9.038,789,9.073,44124,9946,34178,2.072,9.192,43989,12833,31156,2.673,9.164,135,0.028,18.327,581,591,6935
1994,314,6984,7414,242192,237915,890,12.065,815,11.049,36252,9766,26486,4.105,15.237,27703,9519,18184,4.001,11.644,8549,3.593,23.288,653,657,6376
1994,315,13952,15344,810928,834631,2683,17.448,2749,17.877,116613,48025,68588,5.754,13.972,164202,66835,97367,8.008,19.674,-47589,-5.702,27.944,2321,2336,47612
1994,316,1632,1804,108758,110600,159,8.674,217,11.839,10972,1784,9188,1.613,9.920,14863,5540,9323,5.009,13.439,-3891,-3.518,19.841,163,163,3355
1994,321,14811,16516,525943,512445,1661,10.122,1448,8.824,75803,18899,56904,3.688,14.792,48545,16062,32483,3.134,9.473,27258,5.319,18.946,1145,1156,10860
1994,322,3704,5748,586131,587227,312,5.446,275,4.800,36666,8920,27746,1.519,6.244,38970,10431,28539,1.776,6.636,-2304,-0.392,12.488,174,179,3462
1994,323,41034,43020,819962,819569,3309,7.633,3976,9.171,96092,25904,70188,3.161,11.725,94712,32604,62108,3.978,11.556,1380,0.168,23.113,3285,3295,21236
1994,324,1090,2008,111437,111890,108,5.345,133,6.583,7436,1917,5519,1.713,6.646,8544,2869,5675,2.564,7.636,-1108,-0.990,13.292,59,60,912
1994,325,8714,12589,900523,904303,882,7.037,771,6.152,79056,29060,49996,3.214,8.742,86707,29282,57425,3.238,9.588,-7651,-0.846,17.484,489,492,5397
1994,326,12595,15379,925480,907555,1181,7.738,949,6.218,110727,22516,88211,2.481,12.201,75064,22838,52226,2.516,8.271,35663,3.930,16.542,687,692,10822
1994,327,11176,15120,467936,463306,1105,7.322,1047,6.938,55633,13533,42100,2.921,12.008,46012,14103,31909,3.044,9.931,9621,2.077,19.862,670,684,6271
1994,331,4193,5162,579731,578294,319,6.184,312,6.048,41516,8412,33104,1.455,7.179,39255,8816,30439,1.524,6.788,2261,0.391,13.576,207,207,2649
1994,332,51757,55436,1571619,1551397,4090,7.400,3757,6.798,192228,39327,152901,2.535,12.391,152087,43294,108793,2.791,9.803,40141,2.587,19.606,2857,2873,23117
1994,333,26034,28526,1284741,1271283,2001,7.031,1868,6.564,141505,26523,114982,2.086,11.131,114259,29858,84401,2.349,8.988,27246,2.143,17.975,1379,1386,13416
1994,334,13995,15864,1470876,1486015,1527,9.676,1360,8.618,150039,35629,114410,2.398,10.097,179658,51785,127873,3.485,12.090,-29619,-1.993,20.193,942,949,13741
1994,335,5452,6533,570915,563094,469,7.209,415,6.379,56050,9204,46846,1.635,9.954,40380,11005,29375,1.954,7.171,15670,2.783,14.342,276,278,4617
1994,336,9673,11434,1775929,1785233,1021,8.974,907,7.972,177632,43346,134286,2.428,9.950,197898,50472,147426,2.827,11.085,-20266,-1.135,19.900,671,674,10094
1994,337,17638,18629,574093,561832,2139,11.477,2155,11.563,85114,27547,57567,4.903,15.149,61173,21185,39988,3.771,10.888,23941,4.261,21.776,1650,1663,14436
1994,339,26518,27649,682099,681887,2849,10.372,2489,9.061,81162,20321,60841,2.980,11.903,80562,26013,54549,3.815,11.815,600,0.088,23.629,1930,1935,13961
1994,423,171625,220062,2707638,2684994,23114,10.560,20737,9.474,432149,126668,305481,4.718,16.095,387181,133378,253803,4.968,14.420,44968,1.675,28.840,14027,14519,74455
1994,424,99058,126198,2016285,1999202,13478,10.710,12783,10.157,299984,89409,210575,4.472,15.005,265173,95211,169962,4.762,13.264,34811,1.741,26.528,9007,9191,52751
1994,425,32855,35125,294358,293742,3765,10.841,2976,8.569,46147,14314,31833,4.873,15.710,44961,15769,29192,5.368,15.306,1186,0.404,30.613,2053,2072,10203
1994,441,88616,111452,1569324,1525483,10192,9.206,8720,7.876,231221,72307,158914,4.740,15.157,143165,55132,88033,3.614,9.385,88056,5.772,18.770,6168,6369,37813
1994,442,45320,60070,463375,453950,6655,11.161,5771,9.678,86960,34836,52124,7.674,19.156,68624,24012,44612,5.290,15.117,18336,4.039,30.234,3981,4199,15452
1994,443,30431,46854,370894,356918,5932,12.839,4632,10.025,85535,40036,45499,11.217,23.965,56910,23279,33631,6.522,15.945,28625,8.020,31.890,3183,3319,15333
1994,444,70749,93691,1038323,1016333,6907,7.382,6646,7.103,165588,63135,102453,6.212,16.293,122122,44911,77211,4.419,12.016,43466,4.277,24.032,4700,4835,21732
1994,445,102680,140221,2786215,2754912,14422,10.250,15378,10.930,370876,166588,204288,6.047,13.462,308825,112726,196099,4.092,11.210,62051,2.252,22.420,10809,11030,56963
1994,446,45988,78013,775796,768537,7025,9.037,6464,8.316,118901,47715,71186,6.209,15.471,104074,44716,59358,5.818,13.542,14827,1.929,27.084,3971,4358,23409
1994,447,73176,124064,916801,905395,9623,7.713,11011,8.826,169652,58685,110967,6.482,18.738,145468,59188,86280,6.537,16.067,24184,2.671,32.134,6728,6986,33611
1994,448,72211,158536,1333850,1344963,16093,10.077,18434,11.542,232485,111667,120818,8.303,17.286,254377,85659,168718,6.369,18.913,-21892,-1.628,34.571,9333,10459,37928
1994,451,41002,57649,456339,452503,6852,11.887,6836,11.860,88674,40047,48627,8.850,19.596,81155,31789,49366,7.025,17.935,7519,1.662,35.869,4443,4673,17124
1994,452,10407,34823,2249228,2218951,3141,9.057,2858,8.241,269216,119178,150038,5.371,12.133,212540,57821,154719,2.606,9.578,56676,2.554,19.157,1254,1363,5851
1994,453,91288,110059,663323,648066,14598,13.356,13085,11.971,144632,61912,82720,9.553,22.317,113952,42993,70959,6.634,17.583,30680,4.734,35.167,9980,10221,31718
1994,454,27894,35693,434402,427810,4134,11.519,4524,12.606,78717,24417,54300,5.707,18.400,65032,26209,38823,6.126,15.201,13685,3.199,30.402,3319,3346,16759
1994,481,1831,4472,469728,464542,621,14.246,395,9.062,35088,7532,27556,1.621,7.553,24764,3970,20794,0.855,5.331,10324,2.222,10.662,147,158,1356
1994,483,721,1083,48697,48835,146,13.832,91,8.622,7259,1995,5264,4.085,14.864,7838,1905,5933,3.901,16.050,-579,-1.186,29.729,56,56,360
1994,484,71446,82958,1181755,1157983,13713,16.791,11136,13.635,228137,71622,156515,6.185,19.701,179676,75457,104219,6.516,15.516,48461,4.185,31.033,8468,8623,44189
1994,485,12097,13936,302831,295649,2016,14.631,1702,12.352,53185,19220,33965,6.501,17.989,39376,18084,21292,6.117,13.318,13809,4.671,26.637,1271,1296,10381
1994,486,228,2228,54070,54858,300,13.815,187,8.612,6806,3952,2854,7.204,12.407,8371,2391,5980,4.359,15.259,-1565,-2.853,24.813,24,24,140
1994,487,1663,1737,19776,19858,283,16.497,240,13.990,4583,1426,3157,7.181,23.079,4691,1562,3129,7.866,23.623,-108,-0.544,46.158,188,188,1255
1994,488,19582,24447,348426,342081,3600,15.024,2629,10.972,70359,24352,46007,7.119,20.568,57559,19469,38090,5.691,16.826,12800,3.742,33.652,1876,1950,11605
1994,492,5400,8579,448090,445049,1154,13.566,1009,11.862,40967,8599,32368,1.932,9.205,36507,7654,28853,1.720,8.203,4460,1.002,16.406,657,666,4476
1994,493,6338,10460,436459,432945,1004,9.647,898,8.629,71959,25642,46317,5.923,16.621,64851,21512,43339,4.969,14.979,7108,1.642,29.958,292,303,3471
1994,511,20999,25004,827574,822927,3244,13.176,2477,10.061,95817,27568,68249,3.350,11.643,85465,31737,53728,3.857,10.385,10352,1.258,20.771,1780,1794,12219
1994,512,12289,16702,230517,231927,2529,15.312,2158,13.066,50721,16123,34598,6.952,21.869,53333,22239,31094,9.589,22.996,-2612,-1.126,43.739,1278,1344,14514
1994,515,6423,8503,259617,250940,979,11.631,808,9.599,48018,13569,34449,5.407,19.135,31459,11613,19846,4.628,12.536,16559,6.599,25.073,572,606,6903
1994,517,7655,31303,1061577,1062016,4509,14.702,3243,10.574,176975,67214,109761,6.329,16.664,179453,63757,115696,6.003,16.897,-2478,-0.233,33.328,813,872,7007
1994,518,4984,7105,284971,282982,852,11.905,955,13.345,49503,18594,30909,6.571,17.493,45963,18982,26981,6.708,16.242,3540,1.251,32.485,546,549,4218
1994,519,2544,2984,40141,38950,271,9.197,196,6.652,5390,2109,3281,5.415,13.838,3018,948,2070,2.434,7.748,2372,6.090,15.497,144,144,677
1994,521,15,45,22982,23797,D,D,D,D,339,D,293,D,1.425,1929,D,1925,D,8.106,-1590,-6.682,2.849,D,D,D
1994,522,44716,147273,2566386,2520199,17483,12.096,12013,8.311,522757,252482,270275,10.018,20.743,428236,169332,258904,6.719,16.992,94521,3.751,33.984,2795,3231,25355
1994,523,25384,42358,559855,526226,9950,24.665,5915,14.663,139081,59138,79943,11.238,26.430,70850,36592,34258,6.954,13.464,68231,12.966,26.928,3008,3039,15338
1994,524,109712,153561,2190353,2210979,16067,10.476,15682,10.225,328730,117443,211287,5.312,14.868,367007,153057,213950,6.923,16.599,-38277,-1.731,29.736,9092,9268,53371
1994,525,613,655,19738,19008,60,9.036,78,11.747,3053,256,2797,1.347,16.062,1568,468,1100,2.462,8.249,1485,7.813,16.498,55,56,281
1994,531,164417,182250,1111866,1103003,24360,13.531,19926,11.068,230273,103725,126548,9.404,20.877,213682,86665,127017,7.857,19.373,16591,1.504,38.746,14759,15119,59033
1994,532,36091,55803,512944,507319,7383,13.309,6725,12.123,109683,40367,69316,7.957,21.620,99808,38337,61471,7.557,19.674,9875,1.947,39.347,4401,4664,23232
1994,533,1552,1698,18518,18256,350,21.413,223,13.643,4600,2417,2183,13.240,25.198,4063,2083,1980,11.410,22.256,537,2.942,44.513,145,149,671
1994,541,463649,502252,4971500,4907208,67689,13.709,50723,10.273,890119,307425,582694,6.265,18.139,760185,254539,505646,5.187,15.491,129934,2.648,30.982,36725,37128,153755
1994,551,28436,51403,3152945,3168244,4773,9.270,4947,9.608,474538,144592,329946,4.564,14.978,506228,149745,356483,4.726,15.978,-31690,-1.000,29.956,951,1004,12657
1994,561,217183,248726,5312556,5109961,41939,17.214,31756,13.034,1421789,448409,973380,8.775,27.824,1016551,370669,645882,7.254,19.894,405238,7.930,39.787,23946,24307,238545
1994,562,12935,14925,268739,260799,1882,12.763,1523,10.329,52989,13836,39153,5.305,20.318,37206,13469,23737,5.165,14.266,15783,6.052,28.532,1145,1155,8279
1994,611,45169,50596,2080549,2054823,6332,12.768,4325,8.721,198876,36665,162211,1.784,9.679,147690,32226,115464,1.568,7.187,51186,2.491,14.375,3137,3296,24112
1994,621,375285,413849,3775320,3691818,32100,7.787,28845,6.997,655823,223706,432117,6.060,17.764,490022,167515,322507,4.537,13.273,165801,4.491,26.546,22188,22770,111538
1994,622,3683,5942,4596727,4605328,215,3.627,187,3.155,178777,27473,151304,0.597,3.882,194059,47554,146505,1.033,4.214,-15282,-0.332,7.764,92,95,29214
1994,623,28214,48734,2203329,2172217,4987,10.450,2965,6.213,270014,97773,172241,4.501,12.430,207598,78681,128917,3.622,9.557,62416,2.873,19.114,1801,1958,46484
1994,624,75013,99741,1416608,1384816,11705,12.001,7298,7.482,240450,76175,164275,5.501,17.363,176764,51441,125323,3.715,12.764,63686,4.599,25.529,5204,5342,28110
1994,711,20626,21095,284691,283481,3831,18.450,3169,15.262,63979,21399,42580,7.549,22.569,61950,21787,40163,7.686,21.853,2029,0.716,43.707,2212,2234,13024
1994,712,3396,3722,74160,73577,346,9.540,156,4.301,8078,1362,6716,1.851,10.979,7017,924,6093,1.256,9.537,1061,1.442,19.074,99,99,451
1994,713,44166,48736,909588,880974,6261,13.063,4649,9.700,180235,70812,109423,8.038,20.459,122417,39516,82901,4.485,13.896,57818,6.563,27.791,3608,3702,31431
1994,721,38489,45722,1519880,1502831,4964,10.949,4195,9.253,237159,103570,133589,6.892,15.781,200994,89243,111751,5.938,13.374,36165,2.406,26.749,2902,2962,53788
1994,722,305345,406311,7017790,6902824,56526,14.029,49764,12.351,1418497,763669,654828,11.063,20.550,1189049,485773,703276,7.037,17.226,229448,3.324,34.451,36761,38013,328736
1994,811,187917,204259,1194620,1179167,24802,12.223,22121,10.901,232703,85271,147432,7.231,19.735,201498,80120,121378,6.795,17.088,31205,2.646,34.176,16830,17041,56207
1994,812,141900,172945,1140729,1143067,20330,11.740,20774,11.997,211203,93592,117611,8.188,18.477,214231,86499,127732,7.567,18.742,-3028,-0.265,36.954,14330,14881,57725
1994,813,259487,267834,2396796,2381827,16097,6.059,11814,4.446,307462,60226,247236,2.529,12.909,277217,49007,228210,2.058,11.639,30245,1.270,23.278,7953,7983,31687
1995,113,12466,12623,89097,88772,1854,14.807,1651,13.185,19810,7486,12324,8.433,22.316,19152,8070,11082,9.091,21.574,658,0.741,43.149,1219,1219,5622
1995,114,1411,1426,10510,11057,262,18.829,193,13.870,3217,1828,1389,16.533,29.095,4302,1035,3267,9.361,38.907,-1085,-9.813,58.189,140,140,715
1995,115,8037,8412,88633,88216,1251,15.130,964,11.659,17886,5511,12375,6.247,20.275,17123,5361,11762,6.077,19.410,763,0.865,38.821,724,727,4349
1995,211,6495,7694,99688,99522,602,7.667,918,11.691,16576,6745,9831,6.777,16.656,15813,5161,10652,5.186,15.889,763,0.767,31.778,618,627,2192
1995,212,4896,7263,239050,240069,649,8.881,738,10.099,33404,9555,23849,3.980,13.914,35644,12207,23437,5.085,14.847,-2240,-0.933,27.829,466,467,5773
1995,213,7368,8372,145689,145915,1063,12.659,1113,13.255,31643,8431,23212,5.778,21.686,32542,12816,19726,8.783,22.302,-899,-0.616,43.372,747,750,5358
1995,221,6149,14552,721345,731842,983,6.846,598,4.164,41814,14097,27717,1.926,5.714,63200,6028,57172,0.824,8.636,-21386,-2.922,11.427,234,235,1248
1995,236,159519,160877,1280544,1238574,29857,18.935,23458,14.877,344569,115102,229467,9.293,27.820,260661,93723,166938,7.567,21.045,83908,6.775,42.091,17135,17146,71395
1995,237,36824,37886,696264,678299,4983,13.340,3919,10.492,147291,30131,117160,4.442,21.715,111175,27580,83595,4.066,16.390,36116,5.324,32.781,2956,2973,19913
1995,238,345798,349155,3102629,2998475,53531,15.654,39169,11.454,773580,213184,560396,7.110,25.799,565157,177566,387591,5.922,18.848,208423,6.951,37.696,29916,29951,140203
1995,311,20907,25587,1440404,1426791,2331,9.117,2291,8.961,143491,29486,114005,2.067,10.057,115958,33172,82786,2.325,8.127,27533,1.930,16.254,1654,1670,15375
1995,312,1838,2275,159547,159532,216,9.639,148,6.604,15477,2369,13108,1.485,9.702,15495,4294,11201,2.692,9.713,-18,-0.011,19.403,100,100,858
1995,313,7323,8755,477934,478285,765,8.761,719,8.234,43535,10559,32976,2.208,9.102,43884,13713,30171,2.867,9.175,-349,-0.073,18.205,569,578,6002
1995,314,7065,7508,249298,245328,883,11.844,777,10.423,36247,9585,26662,3.907,14.775,28074,10197,17877,4.156,11.443,8173,3.331,22.887,644,644,7463
1995,315,13983,15282,790403,799869,2541,16.594,2603,16.999,119872,43319,76553,5.416,14.986,137707,61518,76189,7.691,17.216,-17835,-2.230,29.973,2192,2200,38577
1995,316,1635,1799,104686,106658,160,8.881,165,9.159,10705,2118,8587,1.986,10.037,14816,4478,10338,4.198,13.891,-4111,-3.854,20.074,118,119,1454
1995,321,14972,16681,553847,539009,1719,10.390,1447,8.746,79113,22281,56832,4.134,14.678,49476,18262,31214,3.388,9.179,29637,5.498,18.358,1132,1139,10253
1995,322,3706,5794,592925,589434,309,5.361,249,4.320,39974,8712,31262,1.478,6.782,33097,6541,26556,1.110,5.615,6877,1.167,11.230,175,176,2556
1995,323,40392,42325,838782,827218,3170,7.440,3736,8.768,102393,27692,74701,3.348,12.378,79536,29499,50037,3.566,9.615,22857,2.763,19.230,3141,3152,19865
1995,324,1078,2005,110681,110988,94,4.694,89,4.444,6683,1053,5630,0.949,6.021,7154,825,6329,0.743,6.446,-471,-0.424,12.043,39,39,253
1995,325,8762,12604,899378,898837,848,6.753,754,6.005,67467,14207,53260,1.581,7.506,66237,12965,53272,1.442,7.369,1230,0.137,14.738,471,471,4030
1995,326,12818,15698,970558,947357,1238,7.964,933,6.002,117899,22941,94958,2.422,12.445,71323,21165,50158,2.234,7.529,46576,4.916,15.057,651,656,11466
1995,327,11111,15175,483025,474979,1140,7.535,1048,6.927,58196,11703,46493,2.464,12.252,41792,12238,29554,2.577,8.799,16404,3.454,17.597,729,735,5500
1995,331,4149,5136,602723,591334,320,6.243,300,5.853,50879,5922,44957,1.001,8.604,28081,9045,19036,1.530,4.749,22798,3.855,9.498,218,221,3268
1995,332,52363,56110,1661870,1613132,4337,7.787,3514,6.309,224027,41633,182394,2.581,13.888,126768,37862,88906,2.347,7.859,97259,6.029,15.717,2756,2765,21817
1995,333,26268,28795,1344129,1310739,2045,7.143,1715,5.990,161018,26479,134539,2.020,12.285,94605,27106,67499,2.068,7.218,66413,5.067,14.435,1288,1290,11744
1995,334,14084,16071,1515037,1489008,1650,10.373,1321,8.305,191104,40034,151070,2.689,12.834,137928,35180,102748,2.363,9.263,53176,3.571,18.526,950,951,11801
1995,335,5475,6560,586477,577238,481,7.361,429,6.566,60882,10700,50182,1.854,10.547,42414,12151,30263,2.105,7.348,18468,3.199,14.696,297,299,2970
1995,336,9732,11528,1786888,1783530,993,8.669,847,7.394,170439,29966,140473,1.680,9.556,163096,44238,118858,2.480,9.145,7343,0.412,18.289,608,610,9532
1995,337,17701,18679,583179,575331,2102,11.271,2043,10.955,74241,17998,56243,3.128,12.904,58414,19214,39200,3.340,10.153,15827,2.751,20.306,1578,1591,14138
1995,339,26783,27920,698943,689492,2836,10.221,2490,8.974,95905,28242,67663,4.096,13.910,76336,26891,49445,3.900,11.071,19569,2.838,22.143,1975,1983,15175
1995,423,174959,224512,2854486,2781271,23709,10.662,19428,8.737,476826,140747,336079,5.061,17.144,331155,118513,212642,4.261,11.907,145671,5.238,23.813,13415,13884,71016
1995,424,100453,127817,2072106,2044477,13902,10.944,12319,9.698,314271,96824,217447,4.736,15.372,258898,92767,166131,4.537,12.663,55373,2.708,25.327,8849,9085,54019
1995,425,33884,36178,303677,297835,4024,11.295,2918,8.191,53692,16603,37089,5.575,18.027,42046,14846,27200,4.985,14.117,11646,3.910,28.234,2044,2054,9823
1995,441,89616,113689,1646706,1608210,10406,9.245,8148,7.239,220762,72772,147990,4.525,13.727,144703,49640,95063,3.087,8.998,76059,4.729,17.996,5951,6155,36264
1995,442,45760,60910,481462,472109,6637,10.978,5737,9.489,89757,35954,53803,7.616,19.012,70790,27686,43104,5.864,14.994,18967,4.018,29.989,3829,4161,17511
1995,443,31476,48449,410327,390350,6153,12.913,4558,9.565,98188,44912,53276,11.506,25.154,58942,24858,34084,6.368,15.100,39246,10.054,30.200,3076,3280,15473
1995,444,70892,94765,1100523,1069341,7385,7.838,6306,6.692,179070,73956,105114,6.916,16.746,117121,41216,75905,3.854,10.953,61949,5.793,21.905,4469,4624,20802
1995,445,102561,139509,2845252,2815577,14365,10.274,14993,10.723,388149,162842,225307,5.784,13.786,325178,125135,200043,4.444,11.549,62971,2.237,23.099,10399,10618,50031
1995,446,45214,78642,804116,789032,7585,9.683,6974,8.903,140164,58164,82000,7.372,17.764,109599,48795,60804,6.184,13.890,30565,3.874,27.781,4145,4412,22223
1995,447,72105,123117,923495,919629,8982,7.272,9772,7.912,157008,56219,100789,6.113,17.073,149822,57715,92107,6.276,16.292,7186,0.781,32.583,6341,6680,34504
1995,448,70296,154186,1307511,1322910,16658,10.656,20922,13.384,239796,115024,124772,8.695,18.126,268282,134375,133907,10.158,20.280,-28486,-2.153,36.253,8977,10162,38738
1995,451,41203,57845,488545,472464,6988,12.097,6834,11.830,105970,47193,58777,9.989,22.429,72805,31377,41428,6.641,15.410,33165,7.020,30.819,4501,4693,16884
1995,452,10424,34593,2382031,2315707,3234,9.314,3493,10.060,294124,141649,152475,6.117,12.701,162567,56805,105762,2.453,7.020,131557,5.681,14.040,1204,1373,6181
1995,453,92882,112666,700229,682685,15366,13.793,12840,11.526,150521,67441,83080,9.879,22.048,115831,45477,70354,6.661,16.967,34690,5.081,33.934,9862,10180,33837
1995,454,28997,36906,456186,444645,4496,12.388,3270,9.010,79740,28697,51043,6.454,17.933,56734,21151,35583,4.757,12.759,23006,5.174,25.519,2327,2354,12600
1995,481,1918,4602,471207,469752,589,12.962,473,10.409,41818,8421,33397,1.793,8.902,39278,5544,33734,1.180,8.361,2540,0.541,16.723,189,201,2072
1995,483,748,1118,50212,49468,133,12.085,98,8.905,7678,2392,5286,4.835,15.521,5942,1113,4829,2.250,12.012,1736,3.509,24.024,60,63,625
1995,484,75417,87273,1259988,1220842,15214,17.863,11007,12.924,249972,83679,166293,6.854,20.475,172420,65458,106962,5.362,14.123,77552,6.352,28.246,8462,8567,41476
1995,485,12263,14098,314356,308310,1916,13.670,1752,12.500,55556,17526,38030,5.685,18.020,43289,19937,23352,6.467,14.041,12267,3.979,28.082,1404,1428,12227
1995,486,228,2377,51434,52603,276,11.990,126,5.474,4619,2241,2378,4.260,8.781,6988,1053,5935,2.002,13.285,-2369,-4.504,17.562,18,20,169
1995,487,1685,1762,21127,20350,260,14.857,236,13.486,4490,1362,3128,6.693,22.064,2974,1041,1933,5.116,14.615,1516,7.450,29.229,174,174,663
1995,488,20283,25444,370846,359536,3560,14.262,2595,10.396,74281,26998,47283,7.509,20.660,51632,19521,32111,5.430,14.361,22649,6.300,28.722,1859,1922,11410
1995,492,5651,9054,492054,470422,1522,17.261,1049,11.897,72647,13541,59106,2.878,15.443,29587,12883,16704,2.739,6.289,43060,9.153,12.579,769,776,6642
1995,493,6429,10695,461708,448712,1021,9.651,790,7.467,80773,24452,56321,5.449,18.001,54723,14873,39850,3.315,12.196,26050,5.806,24.391,311,315,3704
1995,511,21819,26080,855615,840464,3671,14.394,2520,9.881,117070,44050,73020,5.241,13.929,85904,30020,55884,3.572,10.221,31166,3.708,20.442,1803,1823,13888
1995,512,12911,17267,254987,242678,2593,15.255,2054,12.084,65812,33416,32396,13.770,27.119,42532,14472,28060,5.963,17.526,23280,9.593,35.052,1363,1402,9070
1995,515,6530,8667,260634,260158,1019,11.874,849,9.893,40199,14623,25576,5.621,15.452,38642,12836,25806,4.934,14.853,1557,0.598,29.707,612,659,8574
1995,517,8693,32420,1087640,1074772,4459,13.987,3380,10.602,187545,65446,122099,6.089,17.450,162651,46943,115708,4.368,15.134,24894,2.316,30.267,934,990,10120
1995,518,5007,7797,322927,306838,1524,20.480,813,10.925,65961,26725,39236,8.710,21.497,34529,9943,24586,3.240,11.253,31432,10.244,22.506,455,458,4830
1995,519,2613,3079,36975,38345,292,9.631,198,6.530,5197,2154,3043,5.617,13.553,8145,4821,3324,12.573,21.242,-2948,-7.688,27.107,156,157,936
1995,521,14,46,22574,22805,D,D,3,6.452,459,D,454,D,2.013,948,81,867,0.355,4.157,-489,-2.144,4.026,3,3,81
1995,522,43747,149836,2524422,2544768,15317,10.313,12689,8.544,361510,147371,214139,5.791,14.206,400236,133720,266516,5.255,15.728,-38726,-1.522,28.412,4149,5131,47898
1995,523,26404,44655,565766,561030,7540,17.343,5180,11.915,105757,44837,60920,7.992,18.851,95596,30510,65086,5.438,17.039,10161,1.811,34.079,2728,2791,13019
1995,524,111155,156191,2166677,2178328,15603,10.073,13028,8.410,270893,93737,177156,4.303,12.436,293278,83095,210183,3.815,13.463,-22385,-1.028,24.872,7508,7670,31034
1995,525,583,632,20382,19241,63,9.737,93,14.374,3430,1053,2377,5.473,17.827,1131,621,510,3.227,5.878,2299,11.948,11.756,59,59,215
1995,531,166600,186527,1129055,1119794,25211,13.672,20961,11.367,233693,112380,121313,10.036,20.869,214107,83592,130515,7.465,19.120,19586,1.749,38.240,15726,16007,60037
1995,532,36080,56827,545289,528068,7202,12.790,6167,10.952,115970,37400,78570,7.082,21.961,82388,32723,49665,6.197,15.602,33582,6.359,31.204,4186,4545,21327
1995,533,1670,1828,19796,18861,337,19.131,204,11.581,5589,2604,2985,13.806,29.633,3616,1540,2076,8.165,19.172,1973,10.461,38.344,145,145,783
1995,541,483045,523649,5183301,5076753,72428,14.119,51083,9.958,950195,330304,619891,6.506,18.717,738317,243899,494418,4.804,14.543,211878,4.173,29.086,37243,37681,151548
1995,551,28612,51852,3215254,3182490,4916,9.525,4437,8.597,525160,169780,355380,5.335,16.502,460457,129231,331226,4.061,14.468,64703,2.033,28.937,998,1034,14647
1995,561,228725,262513,5821817,5569718,45431,17.772,31656,12.384,1546943,564333,982610,10.132,27.774,1039007,349137,689870,6.268,18.655,507936,9.120,37.309,24128,24611,229495
1995,562,13265,15394,282023,275507,1984,13.095,1498,9.887,51019,14715,36304,5.341,18.518,37840,12278,25562,4.457,13.735,13179,4.784,27.469,1143,1158,6985
1995,611,47168,52851,2133078,2105131,6543,12.648,4307,8.325,198972,40901,158071,1.943,9.452,143095,28356,114739,1.347,6.797,55877,2.654,13.595,3219,3325,21559
1995,621,374395,417045,3970761,3871531,34105,8.210,30838,7.423,737341,270297,467044,6.982,19.045,538910,200624,338286,5.182,13.920,198431,5.125,27.840,23716,24403,133932
1995,622,3600,5934,4551385,4564852,224,3.778,214,3.609,206894,49277,157617,1.079,4.532,232721,58477,174244,1.281,5.098,-25827,-0.566,9.065,100,106,37789
1995,623,29178,51148,2290476,2245337,5248,10.507,2846,5.698,284222,103546,180676,4.612,12.658,195050,78826,116224,3.511,8.687,89172,3.971,17.374,1807,1957,49070
1995,624,78181,104257,1496788,1456770,11939,11.706,7399,7.255,247425,78633,168792,5.398,16.984,167518,41153,126365,2.825,11.499,79907,5.485,22.999,5467,5590,29284
1995,711,21550,22018,285500,285252,3986,18.491,3064,14.213,62451,23097,39354,8.097,21.893,61892,17534,44358,6.147,21.697,559,0.196,43.395,2157,2176,13076
1995,712,3585,3918,77358,75938,367,9.607,171,4.476,8563,1688,6875,2.223,11.276,5737,814,4923,1.072,7.555,2826,3.721,15.110,113,113,544
1995,713,45479,50357,973588,937604,6307,12.731,4673,9.433,194798,79092,115706,8.436,20.776,122389,41111,81278,4.385,13.053,72409,7.723,26.107,3636,3706,29024
1995,721,39181,46575,1536248,1523016,5098,11.051,4211,9.128,226667,102598,124069,6.737,14.883,200123,87084,113039,5.718,13.140,26544,1.743,26.280,2893,2962,49988
1995,722,311173,416687,7296601,7154950,60144,14.615,49802,12.102,1538166,813423,724743,11.369,21.498,1258360,521249,737111,7.285,17.587,279806,3.911,35.175,36625,37925,339937
1995,811,192150,208724,1254932,1224915,26313,12.741,21895,10.602,251236,99455,151781,8.119,20.510,190078,75840,114238,6.191,15.518,61158,4.993,31.035,16664,16946,57251
1995,812,143076,174651,1171871,1156562,20504,11.797,18820,10.828,216674,90950,125724,7.864,18.734,184978,74297,110681,6.424,15.994,31696,2.741,31.988,13975,14584,55188
1995,813,263071,271518,2460416,2430707,16304,6.045,12714,4.714,314489,62853,251636,2.586,12.938,254897,49910,204987,2.053,10.487,59592,2.452,20.973,8712,8746,34387
1996,113,12377,12559,89096,89165,1734,13.776,1791,14.228,18331,7004,11327,7.855,20.559,18592,6415,12177,7.195,20.851,-261,-0.293,41.117,1357,1358,4929
1996,114,1462,1479,11299,10991,260,17.900,207,14.251,2992,787,2205,7.161,27.224,2432,975,1457,8.871,22.128,560,5.095,44.256,132,132,453
1996,115,8213,8601,88329,88497,1183,13.891,1014,11.906,17019,5739,11280,6.485,19.231,17248,5013,12235,5.665,19.490,-229,-0.259,38.462,773,777,3531
1996,211,6310,7492,92288,95289,646,8.491,878,11.540,12649,4451,8198,4.671,13.274,19019,7604,11415,7.980,19.959,-6370,-6.685,26.549,585,591,2308
1996,212,4737,7072,225490,230747,580,8.098,760,10.612,26615,6522,20093,2.826,11.534,36641,14400,22241,6.241,15.879,-10026,-4.345,23.069,495,498,7191
1996,213,6984,8063,149045,146527,942,11.611,1042,12.844,34014,7410,26604,5.057,23.213,29074,11785,17289,8.043,19.842,4940,3.371,39.684,745,765,7403
1996,221,6210,14981,692160,706612,1183,8.007,769,5.205,49801,24616,25185,3.484,7.048,78569,8865,69704,1.255,11.119,-28768,-4.071,14.096,262,270,1677
1996,236,162148,163560,1291613,1278972,27659,17.058,24842,15.320,316607,101984,214623,7.974,24.755,291107,95855,195252,7.495,22.761,25500,1.994,45.522,18103,18111,73505
1996,237,37538,38603,701753,694480,4835,12.651,4068,10.644,139955,35810,104145,5.156,20.152,126726,27889,98837,4.016,18.248,13229,1.905,36.495,3040,3052,19525
1996,238,353762,357148,3214045,3152392,49378,13.971,41943,11.867,729606,198871,530735,6.309,23.145,606274,183436,422838,5.819,19.232,123332,3.912,38.464,31942,31968,146738
1996,311,20576,25094,1435803,1433333,2153,8.526,2468,9.774,149630,30680,118950,2.140,10.439,144532,42981,101551,2.999,10.084,5098,0.356,20.167,1752,1774,20055
1996,312,1905,2360,161758,160661,237,10.233,149,6.434,16186,2935,13251,1.827,10.075,13844,4844,9000,3.015,8.617,2342,1.458,17.234,103,104,1702
1996,313,7059,8456,443158,461307,626,7.273,929,10.793,28367,8299,20068,1.799,6.149,64609,17243,47366,3.738,14.006,-36242,-7.856,12.299,726,728,6911
1996,314,7004,7414,228403,235407,831,11.163,892,11.982,25935,8044,17891,3.417,11.017,40234,14564,25670,6.187,17.091,-14299,-6.074,22.034,720,748,9919
1996,315,13609,14821,718372,752768,2377,15.784,2855,18.958,96139,41761,54378,5.548,12.771,164114,65970,98144,8.764,21.801,-67975,-9.030,25.543,2404,2429,41850
1996,316,1586,1729,90767,96547,149,8.502,196,11.184,6156,1321,4835,1.368,6.376,17868,5506,12362,5.703,18.507,-11712,-12.131,12.752,147,147,1871
1996,321,14744,16490,542301,544639,1424,8.593,1589,9.588,61912,16442,45470,3.019,11.368,66425,18400,48025,3.378,12.196,-4513,-0.829,22.735,1268,1272,11784
1996,322,3688,5769,574969,581431,280,4.864,256,4.447,31479,7919,23560,1.362,5.414,44235,11371,32864,1.956,7.608,-12756,-2.194,10.828,160,162,3556
1996,323,39723,41658,824665,830003,2909,6.919,3681,8.755,81758,20129,61629,2.425,9.850,92468,29631,62837,3.570,11.141,-10710,-1.290,19.701,3039,3044,18660
1996,324,1081,2027,106786,108535,110,5.448,94,4.656,6493,1412,5081,1.301,5.982,10040,1255,8785,1.156,9.250,-3547,-3.268,11.965,54,55,440
1996,325,8745,12607,890984,894278,860,6.838,801,6.369,68326,15033,53293,1.681,7.640,74880,18344,56536,2.051,8.373,-6554,-0.733,15.281,495,498,6440
1996,326,12707,15662,963781,966952,1176,7.555,983,6.315,96773,25264,71509,2.613,10.008,103282,23425,79857,2.423,10.681,-6509,-0.673,20.016,716,730,12554
1996,327,11114,15338,483560,483243,1209,7.923,1050,6.881,52186,15863,36323,3.283,10.799,51539,13752,37787,2.846,10.665,647,0.134,21.330,677,707,6199
1996,331,4089,5088,596928,598110,280,5.510,267,5.254,41800,13993,27807,2.340,6.989,43997,13911,30086,2.326,7.356,-2197,-0.367,13.977,194,195,5719
1996,332,53137,56917,1652450,1643777,4285,7.589,3384,5.993,179154,40192,138962,2.445,10.899,162451,42150,120301,2.564,9.883,16703,1.016,19.766,2641,2657,24662
1996,333,26349,28911,1358341,1343264,1967,6.833,1722,5.982,139392,31398,107994,2.337,10.377,109563,27291,82272,2.032,8.156,29829,2.221,16.313,1305,1314,14457
1996,334,13892,15797,1541439,1528715,1383,8.771,1326,8.409,176201,33234,142967,2.174,11.526,150111,48254,101857,3.157,9.819,26090,1.707,19.639,971,976,13770
1996,335,5402,6492,571905,577955,429,6.605,435,6.697,44079,8727,35352,1.510,7.627,55299,13011,42288,2.251,9.568,-11220,-1.941,15.253,299,305,4533
1996,336,9742,11676,1714646,1741621,1081,9.338,882,7.619,139011,45819,93192,2.631,7.982,194129,48175,145954,2.766,11.146,-55118,-3.165,15.963,638,639,12390
1996,337,17804,18737,569210,576360,1966,10.447,2128,11.308,58500,16905,41595,2.933,10.150,73293,23594,49699,4.094,12.717,-14793,-2.567,20.300,1611,1635,15318
1996,339,27061,28218,688154,686764,2761,9.832,2487,8.857,81894,22866,59028,3.330,11.925,79190,21772,57418,3.170,11.531,2704,0.394,23.062,1982,1987,14607
1996,423,177706,229185,2894017,2861279,25130,11.068,20845,9.181,456804,151027,305777,5.278,15.965,391311,138122,253189,4.827,13.676,65493,2.289,27.352,14213,14693,83025
1996,424,100070,127273,2051837,2049865,13888,10.925,13574,10.678,307038,89694,217344,4.376,14.978,302500,109910,192590,5.362,14.757,4538,0.221,29.514,9491,9713,62315
1996,425,34389,36783,297452,297723,4108,11.329,3061,8.442,48433,16299,32134,5.475,16.268,49309,18431,30878,6.191,16.562,-876,-0.294,32.536,2094,2103,11544
1996,441,89407,115580,1691827,1656927,11777,10.313,9000,7.881,248317,108317,140000,6.537,14.987,181754,61562,120192,3.715,10.969,66563,4.017,21.939,6288,6435,43023
1996,442,45728,61382,485788,481746,6529,10.689,5931,9.710,84212,37152,47060,7.712,17.481,76384,27191,49193,5.644,15.856,7828,1.625,31.711,4065,4380,18062
1996,443,31743,48751,430426,418825,6085,12.562,5462,11.276,96678,45509,51169,10.866,23.083,73145,28988,44157,6.921,17.464,23533,5.619,34.929,3526,3718,17315
1996,444,65439,90095,1094010,1078072,7037,7.815,6927,7.693,171150,62429,108721,5.791,15.876,141134,48672,92462,4.515,13.091,30016,2.784,26.183,4587,4718,23434
1996,445,101451,138091,2882977,2855204,14462,10.446,15161,10.951,372923,158587,214336,5.554,13.061,314844,125610,189234,4.399,11.027,58079,2.034,22.054,10778,10996,60261
1996,446,43956,78277,788376,791509,6940,8.876,6759,8.645,123322,53521,69801,6.762,15.581,130374,47355,83019,5.983,16.472,-7052,-0.891,31.161,4193,4389,23002
1996,447,70484,122077,923083,921263,9613,7.855,10219,8.350,161801,60882,100919,6.609,17.563,158223,59881,98342,6.500,17.175,3578,0.388,34.349,6434,6779,35316
1996,448,67266,150547,1237231,1269959,14504,9.553,17074,11.245,215069,98175,116894,7.731,16.935,281058,87839,193219,6.917,22.131,-65989,-5.196,33.870,8796,9945,38562
1996,451,40772,58224,505956,494940,7041,12.161,6385,11.028,101923,47464,54459,9.590,20.593,79380,29703,49677,6.001,16.038,22543,4.555,32.077,4514,4716,17566
1996,452,10290,35009,2423601,2401929,3162,9.091,2709,7.788,283829,111785,172044,4.654,11.817,245945,63216,182729,2.632,10.239,37884,1.577,20.479,1277,1355,7430
1996,453,93224,113309,710284,697853,15542,13.849,13378,11.920,150256,70405,79851,10.089,21.531,126616,51133,75483,7.327,18.144,23640,3.388,36.287,10189,10421,33640
1996,454,30539,38306,465150,460896,4722,12.500,3661,9.691,74826,26466,48360,5.742,16.235,66002,22275,43727,4.833,14.320,8824,1.915,28.641,2547,2578,12936
1996,481,2015,4658,491108,480815,546,11.800,484,10.460,57949,18944,39005,3.940,12.052,37695,19185,18510,3.990,7.840,20254,4.212,15.680,194,219,2718
1996,483,791,1174,53529,52129,143,12.392,103,8.925,10629,3567,7062,6.843,20.390,8073,1712,6361,3.284,15.487,2556,4.903,30.973,54,59,992
1996,484,76997,88804,1280370,1271401,14318,16.290,12502,14.224,211891,72979,138912,5.740,16.666,194472,70008,124464,5.506,15.296,17419,1.370,30.592,9421,9542,47784
1996,485,12345,14201,318915,314900,1980,14.012,1839,13.014,50356,20589,29767,6.538,15.991,42428,19499,22929,6.192,13.473,7928,2.518,26.947,1463,1482,12355
1996,486,223,2253,49006,50662,167,7.200,300,12.934,5076,1806,3270,3.565,10.019,8292,2402,5890,4.741,16.367,-3216,-6.348,20.039,26,26,170
1996,487,1683,1767,21116,20806,275,15.723,239,13.665,3897,1154,2743,5.547,18.731,3240,992,2248,4.768,15.573,657,3.158,31.146,183,183,685
1996,488,21232,26615,380762,374923,3738,14.324,2700,10.346,70374,24417,45957,6.513,18.770,58523,18884,39639,5.037,15.609,11851,3.161,31.219,1927,2019,12110
1996,492,5924,9457,532400,512655,1428,15.376,1088,11.715,93999,15969,78030,3.115,18.336,53613,34419,19194,6.714,10.458,40386,7.878,20.916,818,838,6144
1996,493,6575,11149,474265,467853,1236,11.307,801,7.327,81191,29036,52155,6.206,17.354,67759,21126,46633,4.516,14.483,13432,2.871,28.966,290,293,3350
1996,511,22570,27141,852077,845051,3669,13.798,2569,9.661,103820,32260,71560,3.818,12.286,90662,26048,64614,3.082,10.729,13158,1.557,21.457,1894,1932,15329
1996,512,13518,17883,260170,251176,2820,16.074,2141,12.204,59597,19202,40395,7.645,23.727,41455,13971,27484,5.562,16.504,18142,7.223,33.009,1390,1415,8002
1996,515,6476,8692,254177,256537,1010,11.665,943,10.891,36997,16419,20578,6.400,14.422,41415,13874,27541,5.408,16.144,-4418,-1.722,28.843,694,742,9209
1996,517,10118,33982,1141189,1117079,6335,19.056,4859,14.616,262372,119458,142914,10.694,23.487,215345,86635,128710,7.755,19.278,47027,4.210,38.555,1305,1431,14520
1996,518,4953,8308,337616,329540,1572,19.652,954,11.926,59688,25095,34593,7.615,18.113,43137,10308,32829,3.128,13.090,16551,5.022,26.180,456,465,3138
1996,519,2740,3293,40673,39363,318,9.857,184,5.704,6415,1801,4614,4.575,16.297,3908,1438,2470,3.653,9.928,2507,6.369,19.856,150,150,866
1996,521,16,46,22705,22679,0,0.000,D,D,551,0,551,0.000,2.430,529,D,469,D,2.333,22,0.097,4.665,0,0,0
1996,522,44355,154349,2541752,2529176,16105,10.604,11157,7.346,413564,169162,244402,6.688,16.352,388386,126624,261762,5.007,15.356,25178,0.996,30.712,3096,3901,32215
1996,523,28180,46851,604734,583197,7064,15.440,4865,10.634,118522,38551,79971,6.610,20.323,75798,31006,44792,5.317,12.997,42724,7.326,25.994,2617,2635,12531
1996,524,112293,157588,2223857,2190163,15978,10.192,14332,9.142,328348,123000,205348,5.616,14.992,259294,75989,183305,3.470,11.839,69054,3.153,23.678,7835,8087,29279
1996,525,538,570,20885,20280,34,5.709,85,14.274,4101,336,3765,1.657,20.222,2734,685,2049,3.378,13.481,1367,6.741,26.963,54,54,266
1996,531,168690,189443,1128170,1123925,23871,12.695,21057,11.198,215828,94579,121249,8.415,19.203,207173,82015,125158,7.297,18.433,8655,0.770,36.866,15524,15876,59934
1996,532,34996,56346,522614,532063,6764,11.977,7018,12.427,105455,36926,68529,6.940,19.820,121410,40241,81169,7.563,22.819,-15955,-2.999,39.640,4551,5055,26244
1996,533,1421,1529,15848,15585,281,18.259,301,19.558,4822,1404,3418,9.009,30.941,4285,2955,1330,18.961,27.495,537,3.446,54.991,191,209,1204
1996,541,501280,544012,5452056,5342244,74705,13.998,54050,10.128,1008349,352899,655450,6.606,18.875,790060,263526,526534,4.933,14.789,218289,4.086,29.578,39828,40272,164510
1996,551,28294,51981,3219004,3209020,4818,9.306,4404,8.506,511865,149824,362041,4.669,15.951,491716,124143,367573,3.869,15.323,20149,0.628,30.646,1004,1056,15918
1996,561,229894,265910,6033737,5839554,45190,17.338,34639,13.290,1602137,563587,1038550,9.651,27.436,1216917,401812,815105,6.881,20.839,385220,6.597,41.678,25891,26255,250760
1996,562,13316,15563,283382,282005,1815,11.748,1587,10.273,52027,18222,33805,6.462,18.449,49716,19425,30291,6.888,17.629,2311,0.819,35.259,1180,1192,7957
1996,611,48955,54816,2110975,2097917,6835,12.704,4811,8.942,186762,42762,144000,2.038,8.902,161292,40550,120742,1.933,7.688,25470,1.214,15.376,3649,3727,29935
1996,621,370293,416299,4078066,4015824,34188,8.218,33628,8.083,734278,273187,461091,6.803,18.285,609356,245986,363370,6.125,15.174,124922,3.111,30.348,24881,25677,154036
1996,622,3336,5704,4461058,4468665,167,2.913,223,3.890,239852,75133,164719,1.681,5.367,252266,52294,199972,1.170,5.645,-12414,-0.278,10.735,100,104,22721
1996,623,29775,53172,2336320,2308504,5376,10.313,3288,6.308,274601,104305,170296,4.518,11.895,218380,74803,143577,3.240,9.460,56221,2.435,18.920,2077,2224,46895
1996,624,80642,108098,1515977,1499524,12162,11.459,8235,7.759,226156,78823,147333,5.257,15.082,193460,49926,143534,3.329,12.901,32696,2.180,25.803,6019,6205,34446
1996,711,22288,22763,292547,284118,4150,18.655,3116,14.007,75638,25290,50348,8.901,26.622,58855,18361,40494,6.462,20.715,16783,5.907,41.430,2200,2214,13293
1996,712,3729,4071,77430,76985,339,8.485,188,4.705,7641,1322,6319,1.717,9.925,6893,679,6214,0.882,8.954,748,0.972,17.907,126,126,566
1996,713,46138,51162,1008388,989948,6069,11.982,5051,9.972,180736,73877,106859,7.463,18.257,143539,43157,100382,4.360,14.500,37197,3.757,28.999,3935,3981,33737
1996,721,39835,47667,1564373,1551255,5293,11.225,4270,9.055,250987,141754,109233,9.138,16.180,224394,104269,120125,6.722,14.465,26593,1.714,28.931,3004,3071,64342
1996,722,315214,424828,7452418,7360894,59917,14.251,51118,12.159,1471203,800920,670283,10.881,19.987,1288020,521664,766356,7.087,17.498,183183,2.489,34.996,37949,39114,341148
1996,811,195637,213632,1298289,1274943,26696,12.637,21931,10.382,252066,100629,151437,7.893,19.771,204597,80170,124427,6.288,16.048,47469,3.723,32.095,16858,17118,60875
1996,812,142230,173816,1177592,1168215,20292,11.682,20078,11.558,217756,95165,122591,8.146,18.640,198214,81161,117053,6.947,16.967,19542,1.673,33.935,14847,15337,59472
1996,813,267321,275829,2510543,2482252,16160,5.901,12177,4.447,307284,56052,251232,2.258,12.379,249850,42859,206991,1.727,10.065,57434,2.314,20.131,8304,8361,28442
1997,113,12115,12286,85528,86514,1527,12.316,1753,14.138,16664,5489,11175,6.345,19.262,18634,6597,12037,7.625,21.539,-1970,-2.277,38.523,1352,1354,4742
1997,114,1480,1493,11743,11439,261,17.707,223,15.129,2730,1066,1664,9.319,23.867,2187,1114,1073,9.739,19.120,543,4.747,38.239,141,142,751
1997,115,8487,8908,98398,95244,1182,13.379,1035,11.715,24176,9042,15134,9.494,25.383,17717,6880,10837,7.224,18.602,6459,6.782,37.203,757,765,4707
1997,211,6193,7320,99323,95556,716,9.691,852,11.532,28396,8885,19511,9.298,29.717,20641,6990,13651,7.315,21.601,7755,8.116,43.202,524,529,2258
1997,212,4543,6840,224518,224864,611,8.879,694,10.085,31404,10036,21368,4.463,13.966,31950,10800,21150,4.803,14.209,-546,-0.243,27.932,399,412,5084
1997,213,7011,8128,154960,152877,1103,13.607,1059,13.064,41028,16315,24713,10.672,26.837,36280,20858,15422,13.644,23.732,4748,3.106,47.463,673,677,5981
1997,221,6149,14875,686368,694446,893,5.999,915,6.147,54292,18003,36289,2.592,7.818,69974,12696,57278,1.828,10.076,-15682,-2.258,15.636,311,315,2800
1997,236,165976,167361,1335747,1308408,28593,17.310,24242,14.676,332645,104657,227988,7.999,25.424,277464,101889,175575,7.787,21.206,55181,4.217,42.412,17650,17659,74717
1997,237,39385,40321,739032,721946,4857,12.138,4243,10.604,166643,33311,133332,4.614,23.082,133003,37959,95044,5.258,18.423,33640,4.660,36.846,3130,3133,18965
1997,238,365045,368334,3438401,3332053,50736,13.947,41597,11.435,812656,211563,601093,6.349,24.389,600711,197876,402835,5.939,18.028,211945,6.361,36.057,31875,31926,154517
1997,311,20604,24908,1431787,1439063,2336,9.329,2602,10.391,140971,28821,112150,2.003,9.796,155247,51379,103868,3.570,10.788,-14276,-0.992,19.592,1829,1866,22266
1997,312,1989,2452,168162,166563,284,11.819,186,7.740,15788,3520,12268,2.113,9.479,12838,3026,9812,1.817,7.708,2950,1.771,15.415,134,137,1918
1997,313,5123,6166,410795,414939,502,7.849,962,15.041,39693,9770,29923,2.355,9.566,48078,18901,29177,4.555,11.587,-8385,-2.021,19.132,729,736,7248
1997,314,7175,7565,237135,236105,791,10.413,854,11.242,31621,8923,22698,3.779,13.393,29368,10761,18607,4.558,12.439,2253,0.954,24.877,659,661,6013
1997,315,13460,14554,683160,704293,2332,15.777,2786,18.849,104269,39387,64882,5.592,14.805,146624,70986,75638,10.079,20.819,-42355,-6.014,29.610,2369,2389,45793
1997,316,1579,1713,89789,90410,146,8.454,174,10.075,10155,2909,7246,3.218,11.232,11213,4288,6925,4.743,12.402,-1058,-1.170,22.464,141,141,1503
1997,321,14341,16042,557439,549441,1410,8.775,1463,9.105,71771,14331,57440,2.608,13.063,55518,17519,37999,3.189,10.104,16253,2.958,20.209,1136,1139,9865
1997,322,3603,5662,570623,572651,274,4.807,351,6.157,44249,16059,28190,2.804,7.727,48575,22919,25656,4.002,8.482,-4326,-0.755,15.454,191,193,3585
1997,323,38412,40273,821727,827724,2657,6.509,3757,9.203,90476,21471,69005,2.594,10.931,102608,41267,61341,4.986,12.396,-12132,-1.466,21.861,3067,3076,20973
1997,324,1091,2049,106290,107477,111,5.382,138,6.691,9004,3967,5037,3.691,8.378,11388,4006,7382,3.727,10.596,-2384,-2.218,16.755,62,65,743
1997,325,8844,12598,889827,890676,905,7.171,949,7.520,81824,15274,66550,1.715,9.187,81978,24848,57130,2.790,9.204,-154,-0.017,18.373,530,546,6645
1997,326,12657,15630,985632,977567,1070,6.843,1082,6.920,111799,23664,88135,2.421,11.436,95679,31342,64337,3.206,9.787,16120,1.649,19.575,743,760,16196
1997,327,10985,15307,490338,486416,1098,7.181,1064,6.959,58804,12915,45889,2.655,12.089,50782,14449,36333,2.971,10.440,8022,1.649,20.880,699,706,6559
1997,331,3939,4954,594249,595255,266,5.359,286,5.761,39566,8241,31325,1.384,6.647,41467,8699,32768,1.461,6.966,-1901,-0.319,13.294,199,202,4088
1997,332,54108,57914,1690216,1668329,4345,7.541,3755,6.517,196471,38022,158449,2.279,11.777,152826,45751,107075,2.742,9.160,43645,2.616,18.321,2817,2827,25250
1997,333,26270,28847,1387453,1379955,1961,6.813,1837,6.382,143634,32158,111476,2.330,10.409,127799,35716,92083,2.588,9.261,15835,1.148,18.522,1369,1375,15959
1997,334,13993,15903,1573824,1561059,1402,8.840,1317,8.304,183695,41681,142014,2.670,11.767,158927,51430,107497,3.295,10.181,24768,1.587,20.361,917,919,12015
1997,335,5404,6465,570872,570781,412,6.349,461,7.104,48062,8536,39526,1.495,8.420,47889,17426,30463,3.053,8.390,173,0.030,16.780,291,292,4311
1997,336,10152,12027,1774392,1740427,1029,8.561,1015,8.444,196833,39216,157617,2.253,11.309,126827,44325,82502,2.547,7.287,70006,4.022,14.574,609,615,10193
1997,337,18050,18942,592675,587117,1972,10.383,2072,10.910,72264,16307,55957,2.777,12.308,61035,22960,38075,3.911,10.396,11229,1.913,20.791,1560,1581,13188
1997,339,27554,28682,695389,696928,2718,9.477,2713,9.460,87991,23480,64511,3.369,12.626,91161,36686,54475,5.264,13.080,-3170,-0.455,25.251,2142,2163,18297
1997,423,179305,229954,2965603,2920331,23441,10.194,23425,10.187,522777,150866,371911,5.166,17.901,432191,166738,265453,5.710,14.799,90586,3.102,29.599,14679,15218,85800
1997,424,102583,129255,2110281,2096392,14160,10.927,14823,11.439,351110,98528,252582,4.700,16.748,324060,129810,194250,6.192,15.458,27050,1.290,30.916,9735,9955,64050
1997,425,33524,35842,284087,280185,4055,11.415,3418,9.622,53242,18290,34952,6.528,19.002,45761,20121,25640,7.181,16.332,7481,2.670,32.665,2199,2224,11417
1997,441,90658,117743,1744979,1726102,10855,9.246,10179,8.670,239470,82278,157192,4.767,13.873,201457,75343,126114,4.365,11.671,38013,2.202,23.342,6889,7130,47261
1997,442,43705,59875,484105,481333,6797,11.382,6485,10.859,90928,36308,54620,7.543,18.891,85886,31585,54301,6.562,17.843,5042,1.048,35.687,4047,4365,17400
1997,443,31784,48629,423202,423678,6325,13.046,6028,12.434,88668,39170,49498,9.245,20.928,90197,37139,53058,8.766,21.289,-1529,-0.361,41.856,3563,3771,17394
1997,444,66073,91582,1156555,1130862,6784,7.404,6860,7.487,182981,75790,107191,6.702,16.181,133244,52986,80258,4.685,11.783,49737,4.398,23.565,4377,4590,24889
1997,445,98764,134487,2858625,2864469,14641,10.801,16783,12.381,404237,195753,208484,6.834,14.112,416115,138118,277997,4.822,14.527,-11878,-0.415,28.224,11167,11473,58808
1997,446,41264,78283,893010,836750,8365,10.765,7203,9.270,223353,68487,154866,8.185,26.693,112435,47317,65118,5.655,13.437,110918,13.256,26.874,4357,4750,26562
1997,447,65676,118056,905626,910438,10055,8.479,11124,9.380,163883,64673,99210,7.104,18.000,171963,67811,104152,7.448,18.888,-8080,-0.887,36.001,6993,7384,39014
1997,448,65278,144280,1229753,1237169,15282,10.354,21904,14.841,244606,103105,141501,8.334,19.771,255642,113860,141782,9.203,20.663,-11036,-0.892,39.543,8261,9801,37053
1997,451,38809,55554,488301,494931,6082,10.800,7608,13.509,91369,36367,55002,7.348,18.461,103577,41054,62523,8.295,20.928,-12208,-2.467,36.922,4669,5114,21885
1997,452,9090,33850,2509061,2460911,3258,9.591,3498,10.297,356132,92185,263947,3.746,14.472,264620,70687,193933,2.872,10.753,91512,3.719,21.506,1441,1818,12202
1997,453,94118,116338,750420,734110,16177,14.001,14578,12.617,169568,74067,95501,10.089,23.098,137349,54222,83127,7.386,18.710,32219,4.389,37.419,10667,10996,37706
1997,454,32128,39683,486157,482450,4911,12.456,4400,11.160,89559,33077,56482,6.856,18.563,81728,37152,44576,7.701,16.940,7831,1.623,33.880,2906,3010,15771
1997,481,2051,4590,515285,506814,489,10.652,490,10.674,50787,7813,42974,1.542,10.021,34078,4022,30056,0.794,6.724,16709,3.297,13.448,207,217,2498
1997,483,1229,1674,70713,68670,182,11.081,119,7.245,12567,4272,8295,6.221,18.301,8371,2312,6059,3.367,12.190,4196,6.110,24.381,53,53,1014
1997,484,78977,90595,1325751,1309423,14741,16.387,13457,14.960,248436,85586,162850,6.536,18.973,216116,85156,130960,6.503,16.505,32320,2.468,33.009,10090,10230,49443
1997,485,12641,14388,327156,324290,2001,13.925,1964,13.668,65190,24258,40932,7.480,20.102,60109,28925,31184,8.919,18.536,5081,1.567,37.071,1349,1376,13350
1997,486,190,2243,46886,48555,216,9.587,236,10.475,5811,2505,3306,5.159,11.968,9162,2909,6253,5.991,18.869,-3351,-6.901,23.936,26,26,345
1997,487,1587,1666,22629,22124,247,14.564,307,18.101,5790,2398,3392,10.839,26.171,4901,2418,2483,10.929,22.152,889,4.018,44.305,213,213,1120
1997,488,21987,27606,402061,388244,4059,14.921,3252,11.955,92100,39132,52968,10.079,23.722,65487,28934,36553,7.453,16.868,26613,6.855,33.735,2125,2177,14935
1997,492,6118,9884,531401,530711,1453,14.900,1189,12.192,58854,15145,43709,2.854,11.090,56503,13616,42887,2.566,10.647,2351,0.443,21.293,892,916,10001
1997,493,6407,11598,502505,490418,1542,13.620,989,8.736,105668,40258,65410,8.209,21.547,81362,25498,55864,5.199,16.590,24306,4.956,33.181,361,378,5189
1997,511,24423,29562,939934,922084,3757,12.901,2878,9.882,150620,41858,108762,4.540,16.335,114580,38822,75758,4.210,12.426,36040,3.909,24.852,2071,2101,18841
1997,512,13803,18204,269753,262535,2730,15.118,2437,13.496,69498,39161,30337,14.917,26.472,55943,20914,35029,7.966,21.309,13555,5.163,42.618,1521,1585,8725
1997,515,6116,8433,267822,262949,1046,12.191,1340,15.618,55103,20850,34253,7.929,20.956,45115,22099,23016,8.404,17.157,9988,3.798,34.315,888,930,12180
1997,517,11099,35073,1178437,1155485,5923,17.238,4499,13.093,249917,88911,161006,7.695,21.629,202701,75557,127144,6.539,17.543,47216,4.086,35.085,1556,1631,16499
1997,518,4160,7385,307090,306515,1411,19.016,1481,19.960,64996,29336,35660,9.571,21.205,63591,24097,39494,7.862,20.746,1405,0.458,41.493,549,557,6392
1997,519,2697,3314,47395,47362,250,7.561,235,7.107,8122,2814,5308,5.942,17.149,7765,1698,6067,3.585,16.395,357,0.754,32.790,175,179,869
1997,521,12,42,22130,22387,0,0.000,D,D,171,0,171,0.000,0.764,699,D,694,D,3.122,-528,-2.359,1.528,0,0,0
1997,522,45327,160135,2600221,2577866,22403,14.252,16526,10.513,572292,265862,306430,10.313,22.200,525297,258626,266671,10.033,20.377,46995,1.823,40.754,3309,4015,33643
1997,523,31336,50910,725065,684894,9244,18.725,6159,12.476,198672,59285,139387,8.656,29.008,114667,44825,69842,6.545,16.742,84005,12.265,33.485,2779,2815,15838
1997,524,115209,158392,2279343,2270177,17605,11.111,17723,11.185,353257,131593,221664,5.797,15.561,334324,135024,199300,5.948,14.727,18933,0.834,29.454,7767,7935,31454
1997,525,152,160,1512,2055,29,15.065,94,48.831,240,111,129,5.401,11.679,1354,1230,124,59.854,65.888,-1114,-54.209,23.358,62,62,730
1997,531,172095,194826,1168804,1155125,25381,13.124,22527,11.648,257349,106064,151285,9.182,22.279,230304,105810,124494,9.160,19.938,27045,2.341,39.875,16152,16447,68744
1997,532,33089,57380,551121,530867,8624,15.249,6973,12.330,134534,55168,79366,10.392,25.342,94586,39410,55176,7.424,17.817,39948,7.525,35.635,4594,5015,25787
1997,533,1630,1752,17876,18062,287,16.710,218,12.693,4813,2136,2677,11.826,26.647,5222,2644,2578,14.638,28.912,-409,-2.264,53.294,157,157,2126
1997,541,518151,561597,5630279,5494531,80050,14.505,60619,10.984,1181231,401070,780161,7.299,21.498,909137,349964,559173,6.369,16.546,272094,4.952,33.092,43426,44035,204866
1997,551,27882,50512,3211444,3221755,5037,9.833,6459,12.610,603019,171083,431936,5.310,18.717,620099,230628,389471,7.158,19.247,-17080,-0.530,37.434,1295,1397,23488
1997,561,239808,279861,6716696,6454927,48340,17.595,38080,13.861,1927953,704317,1223636,10.911,29.868,1402964,500692,902272,7.757,21.735,524989,8.133,43.470,27534,27905,284966
1997,562,12721,15095,279634,278819,1933,12.795,1959,12.967,60930,23392,37538,8.390,21.853,59266,21418,37848,7.682,21.256,1664,0.597,42.512,1371,1407,11782
1997,611,50212,56364,2198775,2158241,6774,12.197,5123,9.224,226430,43417,183013,2.012,10.491,144901,34174,110727,1.583,6.714,81529,3.778,13.428,3782,3833,24416
1997,621,368287,421823,4308986,4215437,41643,9.935,36302,8.661,919203,366525,552678,8.695,21.806,728925,294697,434228,6.991,17.292,190278,4.514,34.584,25484,26358,172224
1997,622,3166,5553,4453268,4469534,288,5.163,338,6.060,368999,113303,255696,2.535,8.256,400801,119455,281346,2.673,8.967,-31802,-0.712,16.512,135,151,55682
1997,623,28990,53907,2382284,2356259,5922,11.197,3885,7.346,322506,125144,197362,5.311,13.687,271892,98266,173626,4.170,11.539,50614,2.148,23.078,2358,2455,57405
1997,624,85312,114421,1651596,1618532,12183,10.762,9756,8.618,286235,79227,207008,4.895,17.685,220875,61381,159494,3.792,13.647,65360,4.038,27.293,6551,6729,38428
1997,711,23273,23691,304602,298853,4190,17.950,3493,14.964,75356,25241,50115,8.446,25.215,64268,25041,39227,8.379,21.505,11088,3.710,43.010,2432,2447,16822
1997,712,4685,5052,89923,86638,356,7.141,223,4.473,12119,1477,10642,1.705,13.988,5439,878,4561,1.013,6.278,6680,7.710,12.556,139,139,552
1997,713,46948,52188,1115607,1095326,5890,11.336,5435,10.460,198535,74679,123856,6.818,18.126,158623,58527,100096,5.343,14.482,39912,3.644,28.964,4053,4095,41165
1997,721,40745,49523,1602688,1592484,6359,13.015,5028,10.291,261687,116124,145563,7.292,16.433,240823,99028,141795,6.218,15.122,20864,1.310,30.245,3321,3387,60065
1997,722,317137,431753,7626628,7551781,62646,14.612,56620,13.206,1612237,880098,732139,11.654,21.349,1457497,597610,859887,7.913,19.300,154740,2.049,38.600,40755,42206,377959
1997,811,196338,214247,1296708,1286065,26075,12.230,24008,11.260,252734,98305,154429,7.644,19.652,231723,100653,131070,7.826,18.018,21011,1.634,36.036,17691,17972,64333
1997,812,140425,172299,1197815,1187647,20931,12.117,21825,12.634,235866,96029,139837,8.086,19.860,216486,92571,123915,7.794,18.228,19380,1.632,36.456,15263,15834,58836
1997,813,262627,269682,2423591,2394094,15020,5.587,13364,4.971,311045,51677,259368,2.159,12.992,251727,57378,194349,2.397,10.515,59318,2.478,21.029,8843,8884,36219
1998,113,12071,12276,84656,85708,1593,12.931,1680,13.637,16900,6571,10329,7.667,19.718,19044,6599,12445,7.699,22.220,-2144,-2.502,39.436,1263,1263,4765
1998,114,1532,1544,9444,10454,278,18.087,264,17.176,2614,1079,1535,10.321,25.005,4681,2180,2501,20.853,44.777,-2067,-19.772,50.010,197,197,691
1998,115,8558,8974,98191,97964,1246,14.013,1082,12.168,21224,7706,13518,7.866,21.665,20865,6335,14530,6.467,21.299,359,0.366,42.597,796,796,4112
1998,211,6071,7244,94819,98079,629,8.622,732,10.034,16061,5192,10869,5.294,16.376,22636,4968,17668,5.065,23.079,-6575,-6.704,32.751,460,466,1607
1998,212,4444,6784,222218,223581,517,7.567,613,8.972,29184,7230,21954,3.234,13.053,31765,9663,22102,4.322,14.207,-2581,-1.154,26.106,372,385,4946
1998,213,7054,8129,171352,163477,1049,12.889,1069,13.134,47156,14284,32872,8.738,28.846,31778,15426,16352,9.436,19.439,15378,9.407,38.878,672,708,7366
1998,221,6178,15421,685626,686524,1395,9.210,847,5.592,67201,31707,35494,4.618,9.789,69264,10402,58862,1.515,10.089,-2063,-0.300,19.577,279,286,2041
1998,236,168577,170093,1401147,1374313,26696,15.808,24254,14.362,337985,106795,231190,7.771,24.593,284428,93980,190448,6.838,20.696,53557,3.897,41.392,17248,17256,66017
1998,237,39972,41017,766780,758995,4705,11.550,4141,10.166,155670,35263,120407,4.646,20.510,139833,32085,107748,4.227,18.423,15837,2.087,36.847,3017,3023,19335
1998,238,370993,374674,3603894,3528703,48938,13.177,42371,11.409,798103,216678,581425,6.140,22.617,646586,193865,452721,5.494,18.324,151517,4.294,36.647,31654,31679,146970
1998,311,20955,25335,1441975,1442539,2317,9.175,2156,8.537,137109,36958,100151,2.562,9.505,136989,31550,105439,2.187,9.496,120,0.008,18.993,1575,1599,14350
1998,312,2000,2483,169538,169743,247,9.968,237,9.564,13502,2430,11072,1.432,7.954,13879,2763,11116,1.628,8.177,-377,-0.222,15.909,181,189,1681
1998,313,4805,5817,400422,405567,370,6.201,669,11.213,31691,8418,23273,2.076,7.814,41849,14319,27530,3.531,10.319,-10158,-2.505,15.628,495,518,6648
1998,314,7101,7488,230753,234650,711,9.455,775,10.306,26044,6935,19109,2.955,11.099,33951,12441,21510,5.302,14.469,-7907,-3.370,22.198,599,605,6824
1998,315,13176,14160,635616,661567,1867,12.989,2295,15.966,83717,27849,55868,4.210,12.654,135511,50764,84747,7.673,20.483,-51794,-7.829,25.309,1808,1826,33331
1998,316,1577,1699,80967,85295,154,9.014,173,10.126,5979,1468,4511,1.721,7.010,14857,6307,8550,7.394,17.418,-8878,-10.409,14.020,121,121,1065
1998,321,14524,16265,577313,570318,1469,9.073,1322,8.165,72317,18660,53657,3.272,12.680,58236,17301,40935,3.034,10.211,14081,2.469,20.422,999,1003,9360
1998,322,3654,5757,573200,574165,304,5.297,269,4.687,45035,17096,27939,2.978,7.844,46303,17510,28793,3.050,8.064,-1268,-0.221,15.687,147,149,2838
1998,323,37695,39530,834778,832975,2451,6.138,3249,8.137,92503,19412,73091,2.330,11.105,88662,28630,60032,3.437,10.644,3841,0.461,21.288,2580,2589,18309
1998,324,1107,2122,106779,107483,179,8.544,125,5.967,11495,2846,8649,2.648,10.695,12532,5245,7287,4.880,11.660,-1037,-0.965,21.390,52,54,521
1998,325,8982,12851,899777,895883,987,7.731,817,6.400,79905,21377,58528,2.386,8.919,72505,17426,55079,1.945,8.093,7400,0.826,16.186,508,514,6464
1998,326,12681,15738,1011330,1001498,1052,6.695,1002,6.377,115037,28293,86744,2.825,11.486,95523,31400,64123,3.135,9.538,19514,1.948,19.076,678,692,15522
1998,327,11034,15483,499508,495707,1101,7.135,998,6.467,56414,15156,41258,3.057,11.381,48666,11827,36839,2.386,9.818,7748,1.563,19.635,624,633,5642
1998,331,4044,5100,609709,604182,304,6.002,234,4.620,44430,9231,35199,1.528,7.354,33083,5342,27741,0.884,5.476,11347,1.878,10.951,157,157,1929
1998,332,55477,59458,1781583,1744751,4623,7.858,3378,5.741,217452,49524,167928,2.838,12.463,144051,38221,105830,2.191,8.256,73401,4.207,16.512,2530,2542,21700
1998,333,26452,29119,1431593,1415952,1774,6.093,1762,6.052,147053,31722,115331,2.240,10.385,116311,30651,85660,2.165,8.214,30742,2.171,16.429,1286,1296,14780
1998,334,14184,16204,1639106,1609387,1426,8.851,1242,7.709,204936,42579,162357,2.646,12.734,146051,38566,107485,2.396,9.075,58885,3.659,18.150,849,858,11332
1998,335,5502,6611,583413,579711,478,7.277,394,5.998,56921,10962,45959,1.891,9.819,48818,13580,35238,2.343,8.421,8103,1.398,16.842,233,234,2356
1998,336,10257,12250,1840605,1814494,997,8.186,855,7.020,170861,41282,129579,2.275,9.416,119345,23392,95953,1.289,6.577,51516,2.839,13.155,605,612,11522
1998,337,18174,19067,614128,605037,1942,10.205,1869,9.821,80636,17751,62885,2.934,13.327,62547,22640,39907,3.742,10.338,18089,2.990,20.675,1422,1435,13196
1998,339,27816,28993,722265,714061,2835,9.813,2628,9.097,96863,26153,70710,3.663,13.565,80511,27607,52904,3.866,11.275,16352,2.290,22.550,2031,2037,13179
1998,423,179698,231250,3106035,3055555,22701,9.821,22495,9.732,533479,161003,372476,5.269,17.459,429790,161611,268179,5.289,14.066,103689,3.393,28.132,14753,15243,86292
1998,424,102761,129859,2166901,2151282,13579,10.456,13600,10.472,334470,100813,233657,4.686,15.547,302032,107569,194463,5.000,14.040,32438,1.508,28.079,9227,9558,55996
1998,425,33771,36133,291814,289458,3419,9.493,3185,8.843,49422,16458,32964,5.686,17.074,44652,16203,28449,5.598,15.426,4770,1.648,30.852,2119,2137,9238
1998,441,91254,118824,1782044,1775337,9974,8.404,9691,8.165,236317,90007,146310,5.070,13.311,221369,71453,149916,4.025,12.469,14948,0.842,24.938,6328,6648,45479
1998,442,44365,59836,512797,500916,5772,9.605,6282,10.454,98508,36810,61698,7.349,19.666,74779,29248,45531,5.839,14.928,23729,4.737,29.857,3560,3784,15196
1998,443,32635,49490,436005,431638,5660,11.483,5260,10.672,82098,32094,50004,7.435,19.020,73268,28844,44424,6.682,16.974,8830,2.046,33.949,3247,3395,14474
1998,444,66083,91745,1175662,1168332,5502,5.991,5681,6.186,156537,44259,112278,3.788,13.398,141551,45183,96368,3.867,12.116,14986,1.283,24.231,3670,3826,18951
1998,445,98773,134409,2921794,2898281,14006,10.393,14709,10.915,402903,165916,236987,5.725,13.901,351716,129740,221976,4.476,12.135,51187,1.766,24.271,9830,10077,54864
1998,446,41215,79432,940922,919179,6811,8.618,6007,7.601,171822,64270,107552,6.992,18.693,128840,42925,85915,4.670,14.017,42982,4.676,28.034,3402,3714,20978
1998,447,65416,117717,938852,925651,9269,7.851,9948,8.426,178913,60938,117975,6.583,19.328,152356,55038,97318,5.946,16.459,26557,2.869,32.919,5715,6339,32395
1998,448,64913,144135,1280930,1259266,13202,9.134,14013,9.695,242973,85376,157597,6.780,19.295,200357,73588,126769,5.844,15.911,42616,3.384,31.821,6648,7324,26742
1998,451,38641,55403,519772,506318,5853,10.523,6294,11.315,100682,44763,55919,8.841,19.885,74190,30427,43763,6.009,14.653,26492,5.232,29.306,3979,4290,15574
1998,452,9108,34374,2520728,2514389,3346,9.798,2901,8.495,235942,93221,142721,3.708,9.384,222906,44828,178078,1.783,8.865,13036,0.518,17.730,1054,1197,5594
1998,453,95551,118249,800700,779424,14381,12.225,13152,11.180,170555,67300,103255,8.635,21.882,127647,48487,79160,6.221,16.377,42908,5.505,32.754,9567,9788,32664
1998,454,32708,40176,502672,496395,4737,11.848,4349,10.877,86324,28341,57983,5.709,17.390,74122,27801,46321,5.601,14.932,12202,2.458,29.864,3094,3147,14541
1998,481,2109,4755,532042,524091,577,12.333,424,9.063,50348,8321,42027,1.588,9.607,34951,5126,29825,0.978,6.669,15397,2.938,13.338,215,228,2857
1998,483,1247,1718,72753,71936,240,14.168,192,11.334,13839,5663,8176,7.872,19.238,12252,5766,6486,8.015,17.032,1587,2.206,34.064,103,120,2576
1998,484,81339,93120,1386277,1359995,14847,16.146,12512,13.607,243343,73926,169417,5.436,17.893,191136,71059,120077,5.225,14.054,52207,3.839,28.108,9415,9596,44202
1998,485,12794,14599,338815,335775,1838,12.652,1694,11.661,56682,18899,37783,5.628,16.881,50859,16689,34170,4.970,15.147,5823,1.734,30.294,1319,1348,10868
1998,486,196,2460,45890,46174,374,15.791,191,8.064,7671,3124,4547,6.766,16.613,8072,2318,5754,5.020,17.482,-401,-0.868,33.226,10,14,162
1998,487,1643,1717,22902,22955,243,14.269,215,12.625,4935,1955,2980,8.517,21.499,5028,2047,2981,8.918,21.904,-93,-0.405,42.998,160,161,1248
1998,488,22659,29075,456606,430922,4217,14.849,2865,10.088,113313,62812,50501,14.576,26.296,64840,21600,43240,5.013,15.047,48473,11.249,30.094,1958,2024,11966
1998,492,6395,10406,536187,534318,1667,16.414,1167,11.491,62957,24859,38098,4.652,11.783,55923,11918,44005,2.231,10.466,7034,1.316,20.932,795,802,5992
1998,493,6490,11911,512203,508373,1273,10.804,1017,8.631,89370,33308,56062,6.552,17.580,82734,29578,53156,5.818,16.274,6636,1.305,32.549,334,353,3849
1998,511,24344,29789,987134,963871,3333,11.253,2992,10.102,158641,43151,115490,4.477,16.459,110733,33307,77426,3.456,11.488,47908,4.970,22.977,2118,2149,15630
1998,512,14254,18586,278404,274767,2714,14.728,2396,13.003,65456,29948,35508,10.899,23.822,57931,25005,32926,9.100,21.084,7525,2.739,42.167,1444,1524,9469
1998,515,5894,8368,269838,270425,976,11.541,1154,13.646,42598,16625,25973,6.148,15.752,43739,22675,21064,8.385,16.174,-1141,-0.422,31.504,756,823,12007
1998,517,11782,39486,1276123,1230806,8935,23.927,4650,12.452,320531,146359,174172,11.891,26.042,227766,99967,127799,8.122,18.505,92765,7.537,37.011,1601,1691,16172
1998,518,4517,8079,327622,318065,1452,18.745,786,10.147,69278,22822,46456,7.175,21.781,49694,13835,35859,4.350,15.624,19584,6.157,31.248,380,387,3636
1998,519,2820,3445,51789,49643,372,11.066,205,6.098,9117,3078,6039,6.200,18.365,4934,1368,3566,2.756,9.939,4183,8.426,19.878,138,144,604
1998,521,15,44,21936,22033,3,6.977,D,D,488,42,446,0.191,2.215,683,D,664,D,3.100,-195,-0.885,4.430,0,0,0
1998,522,47597,165924,2728083,2672337,19201,11.761,13866,8.493,518557,190938,327619,7.145,19.405,410135,151483,258652,5.669,15.347,108422,4.057,30.695,2901,3417,29244
1998,523,33363,55052,740820,744004,9883,18.558,6291,11.813,155432,57303,98129,7.702,20.891,164275,51015,113260,6.857,22.080,-8843,-1.189,41.783,2910,2971,16106
1998,524,116971,162131,2340026,2320690,18610,11.596,15310,9.540,399864,133470,266394,5.751,17.230,364375,114842,249533,4.949,15.701,35489,1.529,31.402,7457,7620,29396
1998,525,224,249,2318,2167,111,52.235,38,17.882,1468,1280,188,59.081,67.759,1190,276,914,12.739,54.927,278,12.832,109.855,25,29,120
1998,531,175366,198600,1205935,1198323,24632,12.497,21649,10.983,257613,105897,151716,8.837,21.498,241080,102248,138832,8.533,20.118,16533,1.380,40.236,14773,15182,63758
1998,532,32456,57487,592084,573836,6867,11.943,6891,11.985,127771,43693,84078,7.614,22.266,91618,38578,53040,6.723,15.966,36153,6.300,31.932,3946,4792,24472
1998,533,1672,1790,19147,18933,229,12.844,215,12.058,4171,1453,2718,7.674,22.030,3753,984,2769,5.197,19.823,418,2.208,39.645,143,143,716
1998,541,542596,589022,6206808,5957042,84510,14.659,59462,10.314,1352106,497474,854632,8.351,22.698,848700,291113,557587,4.887,14.247,503406,8.451,28.494,41214,41611,166943
1998,551,28093,51041,3294237,3259961,5406,10.604,5287,10.370,616732,172761,443971,5.299,18.918,548318,173533,374785,5.323,16.820,68414,2.099,33.640,1115,1186,16463
1998,561,245014,289297,7415704,7112660,45502,15.979,36426,12.792,1968596,661380,1307216,9.299,27.677,1357390,483905,873485,6.803,19.084,611206,8.593,38.168,26282,26760,237730
1998,562,12908,15643,291498,288578,2031,13.155,1624,10.518,53476,22020,31456,7.631,18.531,47858,18145,29713,6.288,16.584,5618,1.947,33.168,1181,1198,10237
1998,611,51763,57988,2334976,2291154,6540,11.425,5045,8.814,244245,49988,194257,2.182,10.660,156061,35858,120203,1.565,6.811,88184,3.849,13.623,3582,3625,21727
1998,621,369905,425459,4443755,4401873,35200,8.293,33214,7.825,777680,267138,510542,6.069,17.667,692399,238212,454187,5.412,15.730,85281,1.937,31.459,23232,23947,141747
1998,622,4174,6671,4930303,4897690,255,3.846,175,2.639,301575,74846,226729,1.528,6.157,238187,63965,174222,1.306,4.863,63388,1.294,9.727,54,54,23940
1998,623,29723,56457,2490551,2442445,6068,10.980,3684,6.666,338855,127127,211728,5.205,13.874,240705,81697,159008,3.345,9.855,98150,4.019,19.710,2070,2234,45872
1998,624,87377,116830,1740561,1704871,11572,9.993,9510,8.213,302646,85406,217240,5.010,17.752,231418,62230,169188,3.650,13.574,71228,4.178,27.148,6276,6445,35924
1998,711,24261,24721,311004,309838,4220,17.372,3361,13.836,71896,26696,45200,8.616,23.204,68675,23321,45354,7.527,22.165,3221,1.040,44.330,2239,2248,12097
1998,712,4821,5189,95069,93056,335,6.519,235,4.573,11581,1534,10047,1.648,12.445,7510,920,6590,0.989,8.070,4071,4.375,16.141,142,142,635
1998,713,47536,52897,1163527,1138967,5853,11.129,5239,9.962,202357,69947,132410,6.141,17.767,153025,52990,100035,4.652,13.435,49332,4.331,26.871,3725,3818,36670
1998,721,41874,51170,1677049,1651367,6015,11.923,4576,9.070,285834,140567,145267,8.512,17.309,232362,94284,138078,5.709,14.071,53472,3.238,28.142,2950,3037,48478
1998,722,319224,432911,7776898,7718884,52050,12.025,51896,11.990,1497911,681633,816278,8.831,19.406,1378521,561520,817001,7.275,17.859,119390,1.547,35.718,34809,35834,311751
1998,811,197877,215672,1320379,1313649,23746,11.032,22900,10.639,237317,89697,147620,6.828,18.065,223252,85104,138148,6.478,16.995,14065,1.071,33.990,16721,16954,58037
1998,812,142233,175895,1248401,1229447,22684,13.001,19841,11.372,250395,109600,140795,8.915,20.366,210421,88695,121726,7.214,17.115,39974,3.251,34.230,13851,14528,56513
1998,813,265460,272817,2472155,2453595,14871,5.479,12101,4.458,300100,53615,246485,2.185,12.231,262203,41732,220471,1.701,10.686,37897,1.545,21.373,7853,7883,25798
1999,113,11857,12052,83414,83564,1434,11.821,1591,13.116,16032,5263,10769,6.298,19.185,16340,5729,10611,6.856,19.554,-308,-0.369,38.371,1204,1204,4096
1999,114,1624,1631,9919,9874,265,16.439,227,14.082,2559,923,1636,9.348,25.918,2393,1140,1253,11.546,24.237,166,1.681,48.473,143,143,540
1999,115,8555,8969,97013,95833,1204,13.543,1047,11.777,20692,5783,14909,6.034,21.592,18472,6288,12184,6.561,19.275,2220,2.317,38.550,765,767,4647
1999,211,5670,6845,85822,90497,543,7.708,943,13.385,11926,5342,6584,5.903,13.178,21260,6136,15124,6.780,23.492,-9334,-10.314,26.357,563,574,2827
1999,212,4332,6731,214282,218752,597,8.835,649,9.605,23466,7499,15967,3.428,10.727,32661,10191,22470,4.659,14.931,-9195,-4.203,21.454,369,382,4056
1999,213,6618,7692,145114,157793,731,9.240,1169,14.777,24165,7575,16590,4.801,15.314,48695,16232,32463,10.287,30.860,-24530,-15.546,30.629,785,800,7463
1999,221,6162,15934,660435,667346,1546,9.859,1039,6.626,66018,29167,36851,4.371,9.893,79201,19721,59480,2.955,11.868,-13183,-1.975,19.785,281,303,2284
1999,236,173244,174750,1497397,1450665,27346,15.855,22787,13.212,365463,108288,257175,7.465,25.193,272156,91903,180253,6.335,18.761,93307,6.432,37.522,16356,16364,67085
1999,237,40514,41624,812623,787769,4932,11.972,4076,9.894,175867,37664,138203,4.781,22.325,125770,36659,89111,4.654,15.965,50097,6.359,31.931,3040,3046,25102
1999,238,378782,382633,3853347,3723455,49218,13.008,40684,10.753,874928,213660,661268,5.738,23.498,614923,200417,414506,5.383,16.515,260005,6.983,33.030,30349,30381,149468
1999,311,20491,24826,1453411,1449749,2005,8.014,2388,9.545,144476,30633,113843,2.113,9.966,137834,43842,93992,3.024,9.507,6642,0.458,19.015,1748,1776,19804
1999,312,2012,2507,168376,168686,205,8.182,202,8.062,13373,1588,11785,0.941,7.928,13997,2705,11292,1.604,8.298,-624,-0.370,15.855,150,151,1350
1999,313,4515,5486,378018,388815,344,6.105,642,11.393,29877,10333,19544,2.658,7.684,50908,12264,38644,3.154,13.093,-21031,-5.409,15.368,503,508,5198
1999,314,6996,7386,226664,228778,644,8.665,737,9.916,28659,9767,18892,4.269,12.527,32787,10798,21989,4.720,14.331,-4128,-1.804,25.054,563,574,6865
1999,315,12411,13248,550190,589888,1656,12.095,2544,18.580,69790,24579,45211,4.167,11.831,149594,65888,83706,11.170,25.360,-79804,-13.529,23.662,1954,1973,32411
1999,316,1498,1606,73875,77303,113,6.830,210,12.693,6624,1582,5042,2.046,8.569,13490,4392,9098,5.682,17.451,-6866,-8.882,17.138,149,149,1896
1999,321,14513,16315,592937,585063,1378,8.438,1410,8.634,72418,16898,55520,2.888,12.378,57016,18374,38642,3.141,9.745,15402,2.633,19.491,1075,1083,12142
1999,322,3608,5727,561218,566290,261,4.544,294,5.119,43130,14176,28954,2.503,7.616,53686,21081,32605,3.723,9.480,-10556,-1.864,15.232,163,164,3701
1999,323,36631,38430,825703,830585,2236,5.741,3270,8.396,80822,18624,62198,2.242,9.731,90467,35093,55374,4.225,10.892,-9645,-1.161,19.461,2555,2571,21447
1999,324,1091,2146,104703,104390,134,6.266,119,5.565,8690,1846,6844,1.768,8.325,7929,2828,5101,2.709,7.596,761,0.729,15.191,55,58,901
1999,325,8937,12824,887024,893929,795,6.183,862,6.704,68726,13239,55487,1.481,7.688,82120,21316,60804,2.385,9.186,-13394,-1.498,15.376,523,529,8220
1999,326,12498,15673,1021521,1017052,979,6.234,1043,6.641,109235,25515,83720,2.509,10.740,99578,28362,71216,2.789,9.791,9657,0.950,19.582,688,695,12342
1999,327,10954,15607,505527,502709,1062,6.829,949,6.103,57976,12389,45587,2.464,11.533,51969,12955,39014,2.577,10.338,6007,1.195,20.676,621,628,6424
1999,331,4093,5183,589918,599442,332,6.427,297,5.750,37418,9356,28062,1.561,6.242,56695,12933,43762,2.158,9.458,-19277,-3.216,12.484,183,190,3582
1999,332,55076,59239,1759781,1772161,3727,6.280,3941,6.641,170508,37825,132683,2.134,9.621,195030,49246,145784,2.779,11.005,-24522,-1.384,19.243,2935,2947,28346
1999,333,26074,28774,1382985,1410424,1562,5.396,1909,6.595,106320,21298,85022,1.510,7.538,161481,36801,124680,2.609,11.449,-55161,-3.911,15.076,1374,1382,15769
1999,334,13878,15923,1570248,1604268,1237,7.710,1481,9.230,163105,45803,117302,2.855,10.167,229618,62265,167353,3.881,14.313,-66513,-4.146,20.334,1007,1018,19103
1999,335,5471,6568,567902,576604,410,6.214,469,7.109,43356,9292,34064,1.612,7.519,60484,17575,42909,3.048,10.490,-17128,-2.970,15.038,297,303,4745
1999,336,10142,12199,1844349,1846196,918,7.498,1007,8.225,144232,24696,119536,1.338,7.812,147391,35454,111937,1.920,7.983,-3159,-0.171,15.625,694,698,14251
1999,337,18130,19028,625906,619932,1705,8.961,1702,8.945,72251,13317,58934,2.148,11.655,59736,19563,40173,3.156,9.636,12515,2.019,19.272,1303,1312,10710
1999,339,27719,28947,715546,719440,2641,9.113,2708,9.344,88489,23414,65075,3.254,12.300,95552,25527,70025,3.548,13.281,-7063,-0.982,24.599,2086,2094,14372
1999,423,177747,231088,3160108,3134492,21389,9.241,22108,9.552,496390,153579,342811,4.900,15.836,444756,167469,277287,5.343,14.189,51634,1.647,28.378,14882,15639,95550
1999,424,101539,128532,2190192,2182376,11822,9.144,13320,10.303,306720,84550,222170,3.874,14.054,291084,109053,182031,4.997,13.338,15636,0.716,26.676,9198,9488,56230
1999,425,33568,35878,286813,289431,2925,8.132,3108,8.641,39100,11838,27262,4.090,13.509,44162,16295,27867,5.630,15.258,-5062,-1.749,27.019,2145,2165,9748
1999,441,90438,118653,1824510,1800684,9769,8.229,9906,8.344,243557,77607,165950,4.310,13.526,196514,75629,120885,4.200,10.913,47043,2.613,21.827,6651,7049,51346
1999,442,44300,60050,529483,521941,5498,9.171,5304,8.847,90171,32201,57970,6.169,17.276,75614,27800,47814,5.326,14.487,14557,2.789,28.974,3380,3668,14471
1999,443,32792,49856,459842,447430,5485,11.039,5147,10.359,91309,34152,57157,7.633,20.407,66509,30988,35521,6.926,14.865,24800,5.543,29.729,3410,3578,17313
1999,444,65426,91199,1226973,1198564,5500,6.021,5799,6.348,175778,63723,112055,5.317,14.666,120832,40155,80677,3.350,10.081,54946,4.584,20.163,3987,4187,23013
1999,445,99093,136312,3054697,2989345,15932,11.753,14430,10.645,469033,251788,217245,8.423,15.690,334145,119866,214279,4.010,11.178,134888,4.512,22.356,9451,9641,51610
1999,446,40346,78334,943573,942491,6034,7.654,7033,8.921,155644,51172,104472,5.429,16.514,153889,57151,96738,6.064,16.328,1755,0.186,32.656,3560,3974,23562
1999,447,63347,115334,927186,932011,8616,7.400,10799,9.275,159298,58487,100811,6.275,17.092,169663,61199,108464,6.566,18.204,-10365,-1.112,34.184,6109,6522,32981
1999,448,63113,142439,1290458,1288124,12182,8.502,13863,9.675,223542,79808,143734,6.196,17.354,215470,72281,143189,5.611,16.727,8072,0.627,33.455,6648,7387,28842
1999,451,37752,54351,527116,523591,5126,9.346,6114,11.148,82046,36303,45743,6.933,15.670,74678,30402,44276,5.806,14.263,7368,1.407,28.525,3964,4285,16119
1999,452,9202,35659,2484621,2502514,3320,9.479,2053,5.861,224438,64396,160042,2.573,8.969,262021,34136,227885,1.364,10.470,-37583,-1.502,17.937,1041,1127,5003
1999,453,95516,118797,828894,816948,14073,11.865,13707,11.556,160555,68346,92209,8.366,19.653,136659,53799,82860,6.585,16.728,23896,2.925,33.456,9656,10039,35417
1999,454,32690,40401,526357,515692,4654,11.564,4341,10.787,96476,33043,63433,6.408,18.708,74788,26989,47799,5.234,14.502,21688,4.206,29.005,3168,3230,18095
1999,481,2224,4825,552667,542659,572,11.834,589,12.186,49759,8764,40995,1.615,9.169,29975,10657,19318,1.964,5.524,19784,3.646,11.047,208,212,1843
1999,483,1247,1702,68832,70857,191,11.183,203,11.885,10797,2910,7887,4.107,15.238,14239,8548,5691,12.064,20.095,-3442,-4.858,30.475,106,110,1700
1999,484,83806,96084,1450158,1420282,15728,16.616,12877,13.604,287798,117041,170757,8.241,20.263,225302,82867,142435,5.835,15.863,62496,4.400,31.726,9702,9881,49660
1999,485,12800,14783,360419,351133,1841,12.503,1725,11.715,62239,21246,40993,6.051,17.725,43275,18702,24573,5.326,12.324,18964,5.401,24.649,1340,1355,11466
1999,486,194,2421,43366,44652,237,9.717,273,11.193,5676,2303,3373,5.158,12.712,8240,2395,5845,5.364,18.454,-2564,-5.742,25.424,14,16,94
1999,487,1672,1748,23237,23206,243,14.010,216,12.453,4000,1160,2840,4.999,17.237,3974,1419,2555,6.115,17.125,26,0.112,34.251,161,161,1270
1999,488,23019,28938,439108,432723,3533,12.303,3090,10.760,81391,31159,50232,7.201,18.809,67877,26139,41738,6.041,15.686,13514,3.123,31.372,2088,2187,15244
1999,492,6617,10734,574508,555321,1439,13.604,1127,10.654,71988,16022,55966,2.885,12.963,35382,13961,21421,2.514,6.371,36606,6.592,12.743,844,861,6648
1999,493,6612,12234,535462,524086,1253,10.352,992,8.196,102900,42800,60100,8.167,19.634,80712,28885,51827,5.512,15.401,22188,4.234,30.801,315,342,4849
1999,511,23584,29243,978181,975931,2992,10.163,3389,11.511,132160,35729,96431,3.661,13.542,127848,47416,80432,4.859,13.100,4312,0.442,26.200,2358,2412,22848
1999,512,14398,18829,273689,276133,2802,14.972,2574,13.754,65119,29736,35383,10.769,23.582,68608,18889,49719,6.841,24.846,-3489,-1.264,47.165,1498,1574,8250
1999,515,5687,8325,278969,275016,1040,12.426,1129,13.489,51535,27471,24064,9.989,18.739,44633,24278,20355,8.828,16.229,6902,2.510,32.458,728,789,11701
1999,517,13000,42336,1329311,1305599,9515,23.187,6916,16.853,344312,157401,186911,12.056,26.372,301981,144426,157555,11.062,23.130,42331,3.242,46.259,1741,1857,20941
1999,518,4956,8987,343242,335509,1577,18.468,681,7.975,68643,26722,41921,7.965,20.459,54035,19937,34098,5.942,16.105,14608,4.354,32.211,419,425,3263
1999,519,3007,3671,57765,54583,429,12.051,207,5.815,11982,5027,6955,9.210,21.952,5619,1800,3819,3.298,10.295,6363,11.658,20.589,125,125,730
1999,521,14,43,22876,22385,D,D,0,0.000,1109,D,1007,D,4.954,113,0,113,0.000,0.505,996,4.449,1.010,0,0,0
1999,522,49425,166092,2758874,2747983,21105,12.700,21271,12.800,537234,213032,324202,7.752,19.550,524494,278347,246147,10.129,19.087,12740,0.464,38.173,3732,4866,49881
1999,523,34578,58066,763858,742712,9685,17.128,6640,11.743,159589,49061,110528,6.606,21.487,118961,54810,64151,7.380,16.017,40628,5.470,32.034,3139,3265,17762
1999,524,117489,165260,2373899,2380004,19400,11.850,16313,9.964,409513,167911,241602,7.055,17.206,424833,164628,260205,6.917,17.850,-15320,-0.644,34.413,7945,8217,35388
1999,525,395,420,4458,3685,180,50.633,51,14.346,2016,908,1108,24.640,54.708,499,204,295,5.536,13.541,1517,41.167,27.083,26,26,79
1999,531,179111,204719,1244800,1227713,27245,13.479,22062,10.915,265074,119285,145789,9.716,21.591,232210,101303,130907,8.251,18.914,32864,2.677,37.828,15746,16315,64973
1999,532,31026,58955,616029,608155,7832,13.429,6564,11.255,122064,56402,65662,9.274,20.071,105058,41990,63068,6.904,17.275,17006,2.796,34.550,3870,4347,23973
1999,533,1684,1800,21617,20491,227,12.639,219,12.194,5104,2598,2506,12.679,24.908,2888,1100,1788,5.368,14.094,2216,10.815,28.188,148,148,697
1999,541,559970,610845,6579921,6410545,84385,14.054,63604,10.593,1340547,462522,878025,7.215,20.912,1000306,359194,641112,5.603,15.604,340241,5.308,31.208,44429,44991,195161
1999,551,28058,51653,3261450,3285743,6645,12.943,6017,11.720,564429,202058,362371,6.150,17.178,610265,214781,395484,6.537,18.573,-45836,-1.395,34.356,1264,1335,25114
1999,561,245843,292404,7919598,7678060,41662,14.336,38062,13.098,2061770,645333,1416437,8.405,26.853,1570134,513485,1056649,6.688,20.450,491636,6.403,40.899,27034,27468,282152
1999,562,12715,15422,290627,291943,1907,12.272,2141,13.778,55700,19222,36478,6.584,19.079,57406,30791,26615,10.547,19.663,-1706,-0.584,38.158,1453,1492,13159
1999,611,52943,59473,2426544,2382495,6647,11.337,4960,8.460,241654,54849,186805,2.302,10.143,154923,33156,121767,1.392,6.503,86731,3.640,13.005,3568,3641,20780
1999,621,368484,423898,4436087,4444239,34983,8.240,36242,8.537,764266,258421,505845,5.815,17.197,778922,324127,454795,7.293,17.527,-14656,-0.330,34.394,24172,25218,171412
1999,622,4061,6627,4929013,4932411,200,3.008,246,3.699,277463,63369,214094,1.285,5.625,285920,99098,186822,2.009,5.797,-8457,-0.171,11.251,81,83,18974
1999,623,29874,58528,2536899,2519878,6119,10.646,4012,6.980,321911,122964,198947,4.880,12.775,289516,104485,185031,4.146,11.489,32395,1.286,22.979,2361,2581,62055
1999,624,88287,119176,1813498,1782340,11622,9.840,9479,8.026,279476,84893,194583,4.763,15.680,217276,59735,157541,3.351,12.190,62200,3.490,24.381,6426,6609,37664
1999,711,25013,25492,326942,318737,4179,16.624,3473,13.815,72353,24409,47944,7.658,22.700,55671,18209,37462,5.713,17.466,16682,5.234,34.932,2335,2346,12197
1999,712,4984,5372,100299,97672,358,6.762,202,3.816,11075,1263,9812,1.293,11.339,5730,824,4906,0.844,5.867,5345,5.472,11.733,123,123,676
1999,713,47799,53429,1189890,1173702,5575,10.483,5081,9.554,192174,57018,135156,4.858,16.373,157883,49848,108035,4.247,13.452,34291,2.922,26.903,3777,3838,34745
1999,721,42042,51949,1717792,1703038,5487,10.643,4699,9.115,243386,112140,131246,6.585,14.291,214595,87379,127216,5.131,12.601,28791,1.691,25.201,3228,3308,47650
1999,722,319031,432471,7893985,7835167,50964,11.777,51470,11.894,1471145,735728,735417,9.390,18.776,1357441,559797,797644,7.145,17.325,113704,1.451,34.650,33715,35571,321643
1999,811,197229,215174,1334921,1327508,22391,10.395,22856,10.611,237786,87632,150154,6.601,17.912,223564,91174,132390,6.868,16.841,14222,1.071,33.682,16562,16924,60701
1999,812,141861,175388,1259262,1256598,19835,11.309,19839,11.311,218735,92285,126450,7.344,17.407,213789,87956,125833,7.000,17.013,4946,0.394,34.027,13723,14191,55427
1999,813,267372,274945,2540133,2508079,14768,5.392,12620,4.608,302614,52258,250356,2.084,12.066,238403,49126,189277,1.959,9.505,64211,2.560,19.011,8016,8046,27897
2000,113,11455,11647,82614,83109,1198,10.106,1612,13.599,15447,4139,11308,4.980,18.587,16535,6424,10111,7.730,19.896,-1088,-1.309,37.173,1220,1220,4406
2000,114,1673,1686,10457,10147,269,16.200,218,13.129,2607,1444,1163,14.232,25.694,2047,768,1279,7.569,20.174,560,5.519,40.349,145,145,510
2000,115,8288,8669,96918,94951,1157,13.418,1064,12.340,20852,7081,13771,7.458,21.961,16981,5524,11457,5.818,17.884,3871,4.077,35.768,738,739,3888
2000,211,5623,6855,79406,82060,677,9.878,674,9.834,13809,5390,8419,6.568,16.828,19532,6284,13248,7.658,23.802,-5723,-6.974,33.656,408,410,1471
2000,212,4309,6735,205267,210868,582,8.637,589,8.741,24274,8847,15427,4.196,11.511,35693,10867,24826,5.153,16.927,-11419,-5.415,23.023,366,380,4620
2000,213,6485,7685,165363,157845,865,11.227,904,11.733,42690,10893,31797,6.901,27.046,27912,7417,20495,4.699,17.683,14778,9.362,35.366,591,606,3256
2000,221,6390,16548,653715,656795,1575,9.703,944,5.815,70541,31533,39008,4.801,10.740,77460,13813,63647,2.103,11.794,-6919,-1.053,21.480,312,328,2144
2000,236,174148,175726,1567208,1530791,24091,13.759,22828,13.038,362018,90842,271176,5.934,23.649,288283,93946,194337,6.137,18.832,73735,4.817,37.665,16337,16368,66407
2000,237,41406,42735,895782,853086,5258,12.462,4175,9.895,208337,51278,157059,6.011,24.422,122715,28619,94096,3.355,14.385,85622,10.037,28.770,3082,3088,20678
2000,238,385049,389558,4119293,3990432,48960,12.680,42104,10.904,924932,231037,693895,5.790,23.179,667634,209728,457906,5.256,16.731,257298,6.448,33.462,31028,31057,156309
2000,311,20173,24474,1466426,1461248,1893,7.695,2148,8.731,146343,30174,116169,2.065,10.015,135686,40985,94701,2.805,9.286,10657,0.729,18.571,1541,1559,16293
2000,312,2067,2570,165695,167148,253,9.924,212,8.315,16368,4639,11729,2.775,9.793,19220,4758,14462,2.847,11.499,-2852,-1.706,19.585,157,157,1884
2000,313,4232,5136,353105,364770,292,5.525,591,11.182,27514,6822,20692,1.870,7.543,50918,17250,33668,4.729,13.959,-23404,-6.416,15.086,429,442,6491
2000,314,6887,7290,222587,224885,671,9.147,762,10.388,28883,8656,20227,3.849,12.843,33151,8743,24408,3.888,14.741,-4268,-1.898,25.687,607,610,5812
2000,315,12108,12809,485034,514908,1824,13.967,2324,17.796,67992,25980,42012,5.046,13.205,127068,56043,71025,10.884,24.678,-59076,-11.473,26.409,1797,1829,29834
2000,316,1473,1564,66643,70223,123,7.729,178,11.184,5074,1067,4007,1.519,7.226,12167,3876,8291,5.520,17.326,-7093,-10.101,14.451,124,126,1451
2000,321,14476,16300,598817,596671,1325,8.121,1356,8.311,68533,16260,52273,2.725,11.486,64151,17502,46649,2.933,10.751,4382,0.734,21.503,1030,1038,9772
2000,322,3554,5685,561356,561606,250,4.386,281,4.929,40162,13170,26992,2.345,7.151,40873,13668,27205,2.434,7.278,-711,-0.127,14.303,169,172,2684
2000,323,35169,36978,811309,816967,2035,5.410,3317,8.817,77444,17336,60108,2.122,9.479,89112,31468,57644,3.852,10.908,-11668,-1.428,18.959,2641,2658,20236
2000,324,1055,2106,105663,105110,122,5.755,150,7.075,9551,1792,7759,1.705,9.087,8429,2259,6170,2.149,8.019,1122,1.067,16.039,58,58,758
2000,325,8954,12818,890355,889214,772,6.022,776,6.053,73155,15247,57908,1.715,8.227,71282,15593,55689,1.754,8.016,1873,0.211,16.033,474,488,7192
2000,326,12212,15485,1041813,1033004,855,5.491,1025,6.583,113608,23808,89800,2.305,10.998,95728,26621,69107,2.577,9.267,17880,1.731,18.534,676,681,10242
2000,327,10810,15717,518719,511802,1084,6.919,982,6.268,61014,13226,47788,2.584,11.921,46598,12656,33942,2.473,9.105,14416,2.817,18.209,649,664,6866
2000,331,4232,5349,590880,590876,382,7.203,290,5.469,43689,8756,34933,1.482,7.394,44181,7871,36310,1.332,7.477,-492,-0.083,14.788,199,200,2745
2000,332,54414,58726,1780488,1770973,3572,6.057,4065,6.893,192690,40395,152295,2.281,10.880,174023,45546,128477,2.572,9.826,18667,1.054,19.653,3057,3073,26796
2000,333,25448,28230,1380814,1384738,1458,5.124,1906,6.699,128325,30847,97478,2.228,9.267,136630,35157,101473,2.539,9.867,-8305,-0.600,18.534,1384,1390,15870
2000,334,13571,15690,1543590,1553853,1220,7.736,1381,8.757,182006,37354,144652,2.404,11.713,197975,62400,135575,4.016,12.741,-15969,-1.028,23.426,917,926,13890
2000,335,5438,6542,578726,574451,417,6.352,463,7.053,58140,12309,45831,2.143,10.121,49405,13928,35477,2.425,8.600,8735,1.521,17.201,309,310,3448
2000,336,9976,12074,1832115,1836917,899,7.427,960,7.931,173999,38401,135598,2.091,9.472,185523,41521,144002,2.260,10.100,-11524,-0.627,18.945,674,676,10800
2000,337,18068,18991,647830,636310,1695,8.925,1695,8.925,78838,14856,63982,2.335,12.390,55778,17050,38728,2.680,8.766,23060,3.624,17.532,1283,1293,11768
2000,339,27706,28923,721644,717326,2622,9.079,2535,8.778,92283,23649,68634,3.297,12.865,83488,26656,56832,3.716,11.639,8795,1.226,23.278,1948,1953,12613
2000,423,177221,232664,3282372,3232830,22726,9.787,21830,9.401,553071,188211,364860,5.822,17.108,454386,168226,286160,5.204,14.055,98685,3.053,28.111,14404,15139,87568
2000,424,100817,127843,2256716,2232356,11969,9.329,12893,10.049,341725,97041,244684,4.347,15.308,294060,112972,181088,5.061,13.173,47665,2.135,26.345,8668,8906,55093
2000,425,33392,35680,288933,288231,2932,8.206,3036,8.497,43103,11287,31816,3.916,14.954,41691,15889,25802,5.513,14.464,1412,0.490,28.929,2050,2075,9706
2000,441,90437,119160,1888207,1857272,10213,8.583,9868,8.293,250088,80567,169521,4.338,13.465,187745,77479,110266,4.172,10.109,62343,3.357,20.217,6408,6917,49092
2000,442,44459,60655,557375,544216,5823,9.644,5272,8.731,101325,40934,60391,7.522,18.619,75003,28017,46986,5.148,13.782,26322,4.837,27.564,3417,3836,17804
2000,443,32455,50208,486542,473455,5368,10.722,5086,10.158,92591,34136,58455,7.210,19.556,66056,25148,40908,5.312,13.952,26535,5.605,27.904,3601,3756,16651
2000,444,64697,90310,1282507,1253401,5362,5.913,6094,6.721,187149,56169,130980,4.481,14.931,129017,64173,64844,5.120,10.293,58132,4.638,20.587,4024,4227,23561
2000,445,100353,136025,2984457,3023158,14093,10.319,15200,11.129,381790,162981,218809,5.391,12.629,462394,226501,235893,7.492,15.295,-80604,-2.666,25.258,9302,9601,55883
2000,446,40059,77546,905164,926280,6202,7.956,7018,9.003,131908,51154,80754,5.523,14.241,172889,66252,106637,7.152,18.665,-40981,-4.424,28.481,3216,3495,19186
2000,447,61609,113764,936179,931295,8184,7.152,9520,8.319,159096,55829,103267,5.995,17.083,148833,53916,94917,5.789,15.981,10263,1.102,31.963,5628,6050,32956
2000,448,62141,141595,1370781,1332093,13274,9.343,14233,10.018,275724,101827,173897,7.644,20.699,197089,78472,118617,5.891,14.795,78635,5.903,29.591,6027,6596,24638
2000,451,36738,53210,542592,535751,4865,9.055,5896,10.974,97846,40885,56961,7.631,18.263,83922,32716,51206,6.107,15.664,13924,2.599,31.329,3726,4090,16871
2000,452,9141,37447,2561669,2523345,3892,10.650,2090,5.719,267332,100963,166369,4.001,10.594,186904,56100,130804,2.223,7.407,80428,3.187,14.814,1001,1119,13729
2000,453,94281,118884,848836,839505,13182,11.095,13039,10.974,154606,63979,90627,7.621,18.416,135480,51010,84470,6.076,16.138,19126,2.278,32.276,9674,9970,35342
2000,454,34399,42000,562625,544771,5860,14.230,4220,10.248,110290,40854,69436,7.499,20.245,74922,26039,48883,4.780,13.753,35368,6.492,27.506,2939,2999,16092
2000,481,2296,4950,557271,541874,578,11.842,440,9.015,54280,6737,47543,1.243,10.017,23023,8289,14734,1.530,4.249,31257,5.768,8.498,218,236,2786
2000,483,1257,1705,70013,69606,206,12.075,208,12.192,11401,2744,8657,3.942,16.379,10788,2217,8571,3.185,15.499,613,0.881,30.998,114,122,1284
2000,484,84355,96942,1492251,1472732,14812,15.338,14075,14.574,282471,92453,190018,6.278,19.180,247096,92617,154479,6.289,16.778,35375,2.402,33.556,10588,10772,49361
2000,485,12908,14892,376779,369167,1831,12.325,1759,11.840,57232,16532,40700,4.478,15.503,41985,19199,22786,5.201,11.373,15247,4.130,22.746,1295,1314,10568
2000,486,191,2829,49681,48178,728,27.430,378,14.243,14457,9431,5026,19.576,30.008,11661,5008,6653,10.395,24.204,2796,5.804,48.408,17,17,208
2000,487,1674,1755,24192,23588,209,11.922,205,11.694,4397,802,3595,3.400,18.641,3230,775,2455,3.286,13.694,1167,4.948,27.387,156,156,621
2000,488,23080,29078,474892,457723,3246,11.185,3133,10.795,96835,28732,68103,6.277,21.156,63035,25753,37282,5.626,13.771,33800,7.384,27.543,2069,2186,12834
2000,492,6707,11152,620231,598122,1803,16.463,1402,12.802,103411,26726,76685,4.468,17.289,57333,27575,29758,4.610,9.586,46078,7.704,19.171,897,949,6138
2000,493,6693,12598,558627,546944,1280,10.290,962,7.734,103364,40894,62470,7.477,18.898,80332,27021,53311,4.940,14.687,23032,4.211,29.375,350,367,4523
2000,511,22981,29380,1024951,1049746,3487,11.889,3386,11.545,166081,56123,109958,5.346,15.821,214427,45729,168698,4.356,20.427,-48346,-4.605,31.642,2326,2394,21918
2000,512,14473,18800,294252,288469,2515,13.366,2547,13.536,66960,23219,43741,8.049,23.212,54776,24658,30118,8.548,18.989,12184,4.224,37.977,1560,1603,7923
2000,515,5507,8197,280759,279269,904,10.943,1032,12.492,40008,16635,23373,5.957,14.326,36964,17357,19607,6.215,13.236,3044,1.090,26.472,639,754,11405
2000,517,14967,48359,1519975,1426551,10751,23.661,4907,10.800,374343,187483,186860,13.142,26.241,187529,67217,120312,4.712,13.146,186814,13.096,26.291,2098,2540,27668
2000,518,5512,9551,373188,358844,2134,23.025,1568,16.918,89081,38613,50468,10.760,24.824,59631,16600,43031,4.626,16.618,29450,8.207,33.235,427,429,4231
2000,519,3683,4387,82293,72670,797,19.404,238,5.794,25217,12865,12352,17.703,34.701,5577,1971,3606,2.712,7.674,19640,27.026,15.349,126,129,1036
2000,521,15,44,22286,22578,D,D,0,0.000,341,D,328,D,1.510,918,0,918,0.000,4.066,-577,-2.556,3.021,0,0,0
2000,522,49417,172755,2814876,2789858,21016,12.403,14384,8.489,524660,242041,282619,8.676,18.806,479064,144309,334755,5.173,17.172,45596,1.634,34.343,4445,5252,39872
2000,523,36543,65345,859685,813632,13154,21.305,5947,9.632,186880,78198,108682,9.611,22.969,95212,37027,58185,4.551,11.702,91668,11.267,23.404,3157,3229,13879
2000,524,116868,159888,2312121,2336640,16569,10.194,21880,13.461,378630,116969,261661,5.006,16.204,427945,172354,255591,7.376,18.315,-49315,-2.111,32.408,8226,8560,40182
2000,525,589,629,5562,5389,245,44.995,76,13.958,3045,2384,661,44.238,56.504,2769,739,2030,13.713,51.382,276,5.122,102.765,50,50,239
2000,531,180982,208018,1293852,1273660,24969,12.084,22196,10.742,256523,103190,153333,8.102,20.141,214629,86838,127791,6.818,16.851,41894,3.289,33.703,15352,15700,53390
2000,532,29461,58312,629143,622371,5939,10.141,6447,11.008,114945,43824,71121,7.041,18.469,100780,45300,55480,7.279,16.193,14165,2.276,32.386,3910,4529,23631
2000,533,1688,1828,22120,21571,231,12.710,210,11.554,5249,1871,3378,8.674,24.334,4234,1516,2718,7.028,19.628,1015,4.705,39.256,147,150,1274
2000,541,571520,625857,6996984,6784037,82400,13.325,67477,10.912,1453976,498065,955911,7.342,21.432,1025333,370304,655029,5.458,15.114,428643,6.318,30.228,47138,47712,205818
2000,551,28262,53041,3341031,3308102,6447,12.312,5089,9.719,624073,211257,412816,6.386,18.865,564064,152131,411933,4.599,17.051,60009,1.814,34.102,1237,1396,20698
2000,561,245903,294481,8734732,8370780,40485,13.785,38905,13.247,2251503,629174,1622329,7.516,26.897,1530449,561627,968822,6.709,18.283,721054,8.614,36.566,26708,27145,252879
2000,562,12394,15398,298549,294144,1940,12.614,1903,12.374,64844,24052,40792,8.177,22.045,55850,26223,29627,8.915,18.987,8994,3.058,37.975,1347,1379,13512
2000,611,54408,61432,2544704,2491511,6769,11.171,5098,8.413,263452,58957,204495,2.366,10.574,156838,30493,126345,1.224,6.295,106614,4.279,12.590,3611,3684,20692
2000,621,370577,425152,4547029,4492941,35813,8.433,34820,8.200,798750,261197,537553,5.813,17.778,690968,302941,388027,6.743,15.379,107782,2.399,30.758,21666,22779,132688
2000,622,4042,6660,4942433,4940521,298,4.481,278,4.180,261994,65862,196132,1.333,5.303,257547,76542,181005,1.549,5.213,4447,0.090,10.426,90,105,35835
2000,623,29956,60733,2587081,2563703,6269,10.512,4072,6.828,330018,124772,205246,4.867,12.873,282155,99734,182421,3.890,11.006,47863,1.867,22.012,2184,2369,46872
2000,624,89583,121782,1931568,1880872,11695,9.692,9452,7.834,306483,86478,220005,4.598,16.295,206046,58714,147332,3.122,10.955,100437,5.340,21.910,6320,6468,36490
2000,711,25747,26274,352788,340829,4163,16.048,3498,13.484,82340,23513,58827,6.899,24.159,58230,19368,38862,5.683,17.085,24110,7.074,34.170,2325,2329,12205
2000,712,5096,5494,108232,105741,339,6.214,262,4.802,12433,1924,10509,1.820,11.758,7446,1056,6390,0.999,7.042,4987,4.716,14.083,156,157,610
2000,713,47945,53577,1269486,1226710,5388,10.060,5354,9.996,225099,63687,161412,5.192,18.350,139214,48006,91208,3.913,11.349,85885,7.001,22.697,3805,4023,34571
2000,721,42225,52574,1767002,1749942,5225,9.996,4616,8.831,244086,106117,137969,6.064,13.948,209806,79948,129858,4.569,11.989,34280,1.959,23.979,3045,3103,39919
2000,722,317653,433016,8124747,8009424,48443,11.196,47747,11.035,1475464,674750,800714,8.424,18.422,1243622,480114,763508,5.994,15.527,231842,2.895,31.054,32985,34773,303362
2000,811,194872,211817,1351150,1343218,20286,9.510,23287,10.917,234388,83321,151067,6.203,17.450,218296,91398,126898,6.804,16.252,16092,1.198,32.503,16281,16746,60632
2000,812,141834,176769,1286711,1275434,20583,11.686,19300,10.958,227976,94594,133382,7.417,17.874,205692,81728,123964,6.408,16.127,22284,1.747,32.254,13646,14194,53332
2000,813,269456,277216,2643163,2596480,14503,5.250,12598,4.560,326899,54539,272360,2.100,12.590,233926,47727,186199,1.838,9.009,92973,3.581,18.019,7457,7471,24432
2001,113,11158,11336,77232,80438,1065,9.204,1534,13.258,11813,3266,8547,4.060,14.686,18246,5769,12477,7.172,22.683,-6433,-7.997,29.372,1112,1113,4028
2001,114,1713,1726,9937,10200,275,16.026,255,14.860,1775,692,1083,6.784,17.402,2223,893,1330,8.755,21.794,-448,-4.392,34.804,160,160,341
2001,115,8980,9399,95499,96487,1309,14.096,1084,11.673,19966,6537,13429,6.775,20.693,21716,9563,12153,9.911,22.507,-1750,-1.814,41.386,733,733,5671
2001,211,5688,6906,85116,82528,694,10.091,637,9.262,19141,7878,11263,9.546,23.193,13695,5867,7828,7.109,16.594,5446,6.599,33.189,365,372,2488
2001,212,4285,6768,200673,203502,593,8.739,628,9.255,23868,7506,16362,3.688,11.729,29752,8284,21468,4.071,14.620,-5884,-2.891,23.457,373,379,3727
2001,213,6860,8135,195237,180752,1067,13.383,743,9.319,46783,10064,36719,5.568,25.882,18040,6998,11042,3.872,9.981,28743,15.902,19.961,486,506,3846
2001,221,6524,16741,652941,655476,1493,8.942,1404,8.409,82081,35799,46282,5.462,12.522,87716,23498,64218,3.585,13.382,-5635,-0.860,25.045,299,341,3259
2001,236,176179,177812,1561544,1555399,24193,13.661,22761,12.852,319265,92847,226418,5.969,20.526,306285,96394,209891,6.197,19.692,12980,0.835,39.383,15584,15596,66984
2001,237,43909,45363,932085,927057,5101,11.314,4550,10.091,180252,40365,139887,4.354,19.443,170667,41425,129242,4.468,18.410,9585,1.034,36.819,3296,3297,25397
2001,238,377907,382495,4014193,3997912,45922,12.037,43936,11.517,800602,211608,588994,5.293,20.026,767848,244513,523335,6.116,19.206,32754,0.819,38.412,31400,31430,162252
2001,311,20149,24455,1460808,1465773,1980,8.061,2193,8.929,137337,30265,107072,2.065,9.370,146488,45885,100603,3.130,9.994,-9151,-0.624,18.739,1563,1586,19030
2001,312,2285,2789,166561,167128,276,9.984,227,8.211,18431,4183,14248,2.503,11.028,19693,5654,14039,3.383,11.783,-1262,-0.755,22.056,154,156,2185
2001,313,3961,4803,318290,335227,314,6.313,656,13.189,21756,6269,15487,1.870,6.490,55898,17384,38514,5.186,16.675,-34142,-10.185,12.980,461,482,5341
2001,314,6877,7272,207311,215460,654,8.914,784,10.686,19026,6341,12685,2.943,8.830,35280,12249,23031,5.685,16.374,-16254,-7.544,17.661,616,618,7296
2001,315,11570,12157,420267,452746,1632,13.047,2335,18.667,50281,19974,30307,4.412,11.106,114702,51186,63516,11.306,25.335,-64421,-14.229,22.212,1838,1869,28514
2001,316,1466,1545,57748,61623,144,9.275,159,10.242,5298,1413,3885,2.293,8.597,12884,4245,8639,6.889,20.908,-7586,-12.310,17.195,117,121,2238
2001,321,14476,16310,560118,582190,1288,7.854,1468,8.951,50714,17090,33624,2.935,8.711,94966,28180,66786,4.840,16.312,-44252,-7.601,17.422,1038,1056,14903
2001,322,3528,5599,538153,550253,210,3.716,315,5.574,29668,6810,22858,1.238,5.392,54020,21538,32482,3.914,9.817,-24352,-4.426,10.783,160,173,4764
2001,323,34221,36007,782167,795013,2079,5.697,3048,8.353,66779,16449,50330,2.069,8.400,92582,29539,63043,3.716,11.645,-25803,-3.246,16.799,2423,2432,19428
2001,324,1035,2149,101017,103440,187,8.761,158,7.402,8295,3726,4569,3.602,8.019,13135,3718,9417,3.594,12.698,-4840,-4.679,16.038,58,60,859
2001,325,8979,12764,877835,886439,795,6.190,954,7.428,77291,21188,56103,2.390,8.719,93107,29000,64107,3.272,10.503,-15816,-1.784,17.439,532,537,7061
2001,326,11977,15238,988835,1015375,757,4.922,1040,6.762,79389,21642,57747,2.131,7.819,132419,35518,96901,3.498,13.041,-53030,-5.223,15.637,672,683,14218
2001,327,10965,16009,517670,520076,1178,7.366,1145,7.160,56111,16285,39826,3.131,10.789,60356,18386,41970,3.535,11.605,-4245,-0.816,21.578,680,708,9527
2001,331,4311,5418,565157,580425,382,7.044,392,7.228,35346,9905,25441,1.707,6.090,65980,14425,51555,2.485,11.368,-30634,-5.278,12.179,253,260,5732
2001,332,54922,59271,1757397,1777936,3769,6.350,3933,6.626,177326,45776,131550,2.575,9.974,218741,61581,157160,3.464,12.303,-41415,-2.329,19.947,2879,2905,32413
2001,333,25133,27935,1338191,1361887,1474,5.227,2005,7.110,124589,27741,96848,2.037,9.148,171749,45711,126038,3.356,12.611,-47160,-3.463,18.297,1417,1425,16214
2001,334,13573,15703,1568825,1554855,1388,8.813,1481,9.403,230785,68232,162553,4.388,14.843,202862,90722,112140,5.835,13.047,27923,1.796,26.094,955,961,17764
2001,335,5306,6405,566782,573427,382,5.895,533,8.225,46897,10623,36274,1.853,8.178,59809,13270,46539,2.314,10.430,-12912,-2.252,16.357,370,373,4640
2001,336,9940,12051,1709750,1774129,858,7.077,1003,8.273,103340,22849,80491,1.288,5.825,231734,43088,188646,2.429,13.062,-128394,-7.237,11.650,691,701,12668
2001,337,18835,19744,629905,643669,1768,8.961,1742,8.829,55497,13133,42364,2.040,8.622,82557,25052,57505,3.892,12.826,-27060,-4.204,17.244,1273,1284,14739
2001,339,27570,28806,704105,712620,2453,8.491,2619,9.066,75221,17791,57430,2.497,10.556,91762,28953,62809,4.063,12.877,-16541,-2.321,21.111,1978,1986,15683
2001,423,175112,231850,3327039,3317212,22879,9.843,24048,10.346,561238,208883,352355,6.297,16.919,541975,222317,319658,6.702,16.338,19263,0.581,32.677,14619,15758,105047
2001,424,100068,128050,2292579,2288155,13199,10.297,13460,10.501,340735,112058,228677,4.897,14.891,328860,124792,204068,5.454,14.372,11875,0.519,28.745,8673,8971,58987
2001,425,32962,35102,274573,282167,2740,7.757,3183,9.011,42150,15959,26191,5.656,14.938,56945,19131,37814,6.780,20.181,-14795,-5.243,29.876,2009,2041,9115
2001,441,90348,119326,1866561,1879422,9328,7.804,9730,8.140,207422,71167,136255,3.787,11.036,234054,77207,156847,4.108,12.454,-26632,-1.417,22.073,6645,7023,51119
2001,442,44963,61123,572065,566229,5907,9.659,5967,9.757,100118,35597,64521,6.287,17.682,88471,33920,54551,5.991,15.625,11647,2.057,31.249,3510,3957,17363
2001,443,32214,50533,489601,489737,5394,10.662,5508,10.888,83194,33633,49561,6.868,16.988,83766,29779,53987,6.081,17.104,-572,-0.117,33.975,3851,4017,19740
2001,444,65797,91659,1283119,1291663,5906,6.428,6345,6.906,168023,86079,81944,6.664,13.008,187723,49669,138054,3.845,14.533,-19700,-1.525,26.017,4139,4374,26194
2001,445,99756,134710,2911885,2946220,13648,10.081,14997,11.077,355041,146007,209034,4.956,12.051,425837,169010,256827,5.737,14.454,-70796,-2.403,24.101,9900,10175,60111
2001,446,39719,77436,947237,928524,5529,7.129,5773,7.443,141442,37026,104416,3.988,15.233,104829,37457,67372,4.034,11.290,36613,3.943,22.580,3200,3454,18223
2001,447,60324,112717,930009,934753,8492,7.496,9618,8.490,151832,55240,96592,5.910,16.243,161441,53118,108323,5.683,17.271,-9609,-1.028,32.486,5687,6222,32465
2001,448,61178,140247,1384000,1378626,13663,9.688,15227,10.797,251647,104824,146823,7.604,18.253,242019,92925,149094,6.740,17.555,9628,0.698,35.110,5957,8171,35806
2001,451,35908,52382,555173,549725,4626,8.756,5531,10.469,98169,35194,62975,6.402,17.858,87284,32104,55180,5.840,15.878,10885,1.980,31.756,3688,3878,18244
2001,452,8917,37975,2562281,2562558,2968,7.880,2345,6.226,239628,97088,142540,3.789,9.351,242166,75982,166184,2.965,9.450,-2538,-0.099,18.702,1086,1110,4632
2001,453,92785,117555,832275,842361,12314,10.412,13731,11.611,134588,52647,81941,6.250,15.977,154544,58201,96343,6.909,18.347,-19956,-2.369,31.955,9885,10249,37230
2001,454,34724,42368,563193,565049,5588,13.276,5035,11.962,99734,36274,63460,6.420,17.651,103890,38483,65407,6.811,18.386,-4156,-0.736,35.301,3514,3585,21078
2001,481,2314,4986,558014,558210,607,12.253,543,10.961,55723,8507,47216,1.524,9.982,57953,9425,48528,1.688,10.382,-2230,-0.399,19.965,247,259,1936
2001,483,1224,1695,71706,71718,190,11.190,196,11.543,12332,4392,7940,6.124,17.195,12439,3849,8590,5.367,17.344,-107,-0.149,34.390,115,124,2096
2001,484,84521,97490,1475072,1485244,14566,14.926,14766,15.131,233704,84704,149000,5.703,15.735,253416,104376,149040,7.028,17.062,-19712,-1.327,31.470,10814,11156,64200
2001,485,12996,15128,386947,383000,1945,12.935,1763,11.724,56936,21948,34988,5.731,14.866,48803,17537,31266,4.579,12.742,8133,2.123,25.485,1307,1328,9849
2001,486,198,2774,47402,48509,279,9.961,333,11.889,6347,2411,3936,4.970,13.084,8707,3768,4939,7.768,17.949,-2360,-4.865,26.168,9,9,53
2001,487,1731,1811,23699,23350,255,14.218,220,12.267,3822,1025,2797,4.390,16.368,3143,1172,1971,5.019,13.460,679,2.908,26.921,166,166,768
2001,488,23486,29782,489229,484172,3756,12.719,3252,11.013,91750,32409,59341,6.694,18.950,81488,30413,51075,6.281,16.830,10262,2.119,33.661,2104,2203,12477
2001,492,6864,11466,578141,599023,1817,16.090,1470,13.017,41825,16561,25264,2.765,6.982,83261,14289,68972,2.385,13.899,-41436,-6.917,13.964,917,945,6952
2001,493,6835,12620,576647,569897,1449,11.438,1545,12.196,116842,46853,69989,8.221,20.502,102672,43082,59590,7.560,18.016,14170,2.486,36.032,374,637,7217
2001,511,22536,29558,1056415,1043781,3607,12.222,3514,11.907,178954,65734,113220,6.298,17.145,154379,71176,83203,6.819,14.790,24575,2.354,29.581,2253,2355,28926
2001,512,14730,18619,287439,291839,2493,13.257,2865,15.235,59615,18181,41434,6.230,20.427,67502,25184,42318,8.629,23.130,-7887,-2.703,40.855,1517,1570,8055
2001,515,5122,8944,289892,285501,2151,25.156,1364,15.952,68524,43505,25019,15.238,24.001,57577,37419,20158,13.106,20.167,10947,3.834,40.334,662,712,9388
2001,517,14357,52143,1621073,1576729,12134,24.205,8108,16.174,375191,195853,179338,12.421,23.796,291993,136876,155117,8.681,18.519,83198,5.277,37.038,2935,3350,45023
2001,518,5984,10816,414698,399752,2519,24.674,1305,12.783,99822,40959,58863,10.246,24.971,70519,27146,43373,6.791,17.641,29303,7.330,35.281,464,472,6785
2001,519,3879,4725,89298,84355,805,17.933,333,7.418,21901,9466,12435,11.222,25.963,12087,4182,7905,4.958,14.329,9814,11.634,28.658,226,243,2455
2001,521,15,52,22282,22443,D,D,D,D,346,D,321,D,1.542,656,D,570,D,2.923,-310,-1.381,3.083,0,0,0
2001,522,50065,175459,2903138,2858502,23143,13.283,20678,11.868,657183,285723,371460,9.996,22.990,558135,265140,292995,9.275,19.525,99048,3.465,39.051,4237,5189,42026
2001,523,39025,68063,911957,891489,11147,16.619,9172,13.674,210545,95186,115359,10.677,23.617,165889,75892,89997,8.513,18.608,44656,5.009,37.216,3476,3638,22691
2001,524,117972,154433,2341517,2335823,17684,11.230,23755,15.086,404274,164379,239895,7.037,17.308,388065,173224,214841,7.416,16.614,16209,0.694,33.227,8594,8856,36618
2001,525,626,673,5476,5437,209,33.254,120,19.093,1513,883,630,16.241,27.828,1442,954,488,17.546,26.522,71,1.306,53.044,79,79,555
2001,531,183074,211387,1319458,1312872,26499,12.614,23873,11.364,252358,112303,140055,8.554,19.222,239650,104191,135459,7.936,18.254,12708,0.968,36.508,15481,15931,58027
2001,532,28518,58493,636280,633491,6606,11.296,6586,11.261,117820,46648,71172,7.364,18.599,112023,45706,66317,7.215,17.683,5797,0.915,35.367,3434,3877,22050
2001,533,1739,1858,21881,21684,224,11.979,248,13.262,4638,1799,2839,8.297,21.390,4239,2141,2098,9.874,19.549,399,1.840,39.099,165,169,904
2001,541,584283,640883,7269332,7124130,86333,13.609,73294,11.554,1499602,520854,978748,7.311,21.050,1208122,455271,752851,6.391,16.958,291480,4.091,33.916,49946,50499,235454
2001,551,28145,52364,3278895,3313695,5619,10.661,6308,11.968,582317,191308,391009,5.773,17.573,651561,243105,408456,7.336,19.663,-69244,-2.090,35.146,1308,1378,26704
2001,561,250479,301025,8621963,8733589,41925,14.011,38320,12.807,1988165,651294,1336871,7.457,22.765,2220247,726529,1493718,8.319,25.422,-232082,-2.657,45.529,25662,26169,277199
2001,562,12989,16199,307989,306595,2061,12.916,1578,9.889,56341,21756,34585,7.096,18.376,53632,20628,33004,6.728,17.493,2709,0.884,34.986,1003,1018,8400
2001,611,54336,61440,2466858,2430585,6935,11.435,5344,8.812,241123,51535,189588,2.120,9.920,167524,41154,126370,1.693,6.892,73599,3.028,13.785,3663,3722,25751
2001,621,376855,433201,4674868,4617516,39020,9.088,31368,7.306,771488,254990,516498,5.522,16.708,657091,246811,410280,5.345,14.230,114397,2.477,28.461,20028,20963,121861
2001,622,3972,6516,4997456,4973331,270,4.102,403,6.122,281598,70020,211578,1.408,5.662,232418,93696,138722,1.884,4.673,49180,0.989,9.347,97,127,46097
2001,623,29735,62242,2629365,2599650,6565,10.702,4767,7.771,347456,137225,210231,5.279,13.365,288989,116701,172288,4.489,11.116,58467,2.249,22.233,2141,2371,49767
2001,624,88217,121652,1969790,1929256,12209,10.125,10059,8.342,309275,85469,223806,4.430,16.031,227378,69935,157443,3.625,11.786,81897,4.245,23.572,6394,6601,39123
2001,711,25952,26497,356958,351980,4251,16.211,3703,14.121,75897,29326,46571,8.332,21.563,66177,22027,44150,6.258,18.801,9720,2.762,37.603,2430,2435,11640
2001,712,4852,5265,107408,105851,330,6.312,256,4.897,10657,1830,8827,1.729,10.068,7660,1787,5873,1.688,7.237,2997,2.831,14.473,154,154,1123
2001,713,47965,53749,1279118,1271586,5474,10.202,5290,9.859,180280,56149,124131,4.416,14.178,165589,56170,109419,4.417,13.022,14691,1.155,26.044,3838,3907,36884
2001,721,42977,53387,1753372,1763527,5402,10.171,4856,9.143,223776,92744,131032,5.259,12.689,245207,107385,137822,6.089,13.904,-21431,-1.215,25.378,2988,3083,43026
2001,722,319682,437548,8221289,8182462,51806,11.883,48642,11.157,1424359,697396,726963,8.523,17.407,1349144,517899,831245,6.329,16.488,75215,0.919,32.976,32615,34352,321351
2001,811,193717,211023,1348408,1350857,21101,9.968,22421,10.592,225877,82779,143098,6.128,16.721,230607,92139,138468,6.821,17.071,-4730,-0.350,33.442,16148,16392,59024
2001,812,140089,175088,1301110,1290466,19196,10.947,19715,11.243,222322,87433,134889,6.775,17.228,201943,84575,117368,6.554,15.649,20379,1.579,31.298,13738,14197,54528
2001,813,261232,269343,2597343,2574410,13835,5.146,12897,4.797,290223,50717,239506,1.970,11.273,243518,47160,196358,1.832,9.459,46705,1.814,18.918,7851,7874,28148
2002,113,10646,10850,75936,77389,1092,9.774,1738,15.555,14098,4646,9452,6.003,18.217,16898,6511,10387,8.413,21.835,-2800,-3.618,36.434,1221,1222,4704
2002,114,1565,1580,9323,9455,231,14.224,319,19.643,1829,724,1105,7.657,19.344,2100,850,1250,8.990,22.210,-271,-2.866,38.689,199,199,581
2002,115,9168,9626,95801,97694,1222,12.693,1225,12.724,18730,8026,10704,8.215,19.172,22696,7569,15127,7.748,23.232,-3966,-4.060,38.344,813,813,5093
2002,211,5707,6951,86536,85607,681,9.791,690,9.920,19626,6540,13086,7.640,22.926,18086,8394,9692,9.805,21.127,1540,1.799,42.254,369,373,2850
2002,212,4224,6735,196030,200323,630,9.260,767,11.274,29133,10089,19044,5.036,14.543,37652,11808,25844,5.894,18.796,-8519,-4.253,29.086,352,355,3863
2002,213,6826,8365,192056,197259,1263,15.388,948,11.550,34310,16927,17383,8.581,17.393,45860,14294,31566,7.246,23.249,-11550,-5.855,34.787,544,550,4241
2002,221,6490,17390,667593,668022,1291,7.509,898,5.223,75104,36841,38263,5.515,11.243,76600,18548,58052,2.777,11.467,-1496,-0.224,22.485,338,338,2819
2002,236,175360,177157,1483486,1499712,26489,15.036,24525,13.921,316251,111286,204965,7.420,21.087,348400,109562,238838,7.306,23.231,-32149,-2.144,42.175,15539,15601,69761
2002,237,43204,44820,974241,983048,5128,11.415,5331,11.867,198139,56491,141648,5.747,20.156,217455,52426,165029,5.333,22.120,-19316,-1.965,40.311,3411,3433,28858
2002,238,372133,377264,3924743,3981560,48637,12.873,49769,13.172,780145,244857,535288,6.150,19.594,894203,255017,639186,6.405,22.459,-114058,-2.865,39.188,33022,33052,175265
2002,311,20872,25437,1485024,1492096,2230,8.739,2393,9.378,161680,51426,110254,3.447,10.836,176325,57222,119103,3.835,11.817,-14645,-0.982,21.672,1620,1637,27247
2002,312,2243,2746,161175,163590,285,10.388,280,10.206,17925,3901,14024,2.385,10.957,22734,5894,16840,3.603,13.897,-4809,-2.940,21.915,175,177,2845
2002,313,3069,3725,268821,292582,283,7.097,808,20.263,20673,8358,12315,2.857,7.066,67352,28738,38614,9.822,23.020,-46679,-15.954,14.131,515,557,15235
2002,314,7200,7567,193693,202860,685,8.982,803,10.530,19192,8113,11079,3.999,9.461,37437,11901,25536,5.867,18.455,-18245,-8.994,18.921,603,611,7807
2002,315,10182,10633,324387,364574,1546,13.851,2604,23.329,44653,23316,21337,6.395,12.248,125253,58376,66877,16.012,34.356,-80600,-22.108,24.496,2066,2092,35854
2002,316,1343,1407,46776,51103,144,9.921,233,16.052,3619,1287,2332,2.518,7.082,12125,4201,7924,8.221,23.727,-8506,-16.645,14.164,164,164,1663
2002,321,14423,16268,540547,553870,1358,8.259,1709,10.393,57568,18870,38698,3.407,10.394,83976,26450,57526,4.775,15.162,-26408,-4.768,20.788,1222,1245,14227
2002,322,3431,5438,504698,524732,247,4.469,424,7.672,29523,10692,18831,2.038,5.626,69956,23537,46419,4.486,13.332,-40433,-7.705,11.253,239,244,8993
2002,323,33658,35449,721051,759089,2156,5.972,3465,9.597,57553,21420,36133,2.822,7.582,133606,42445,91161,5.592,17.601,-76053,-10.019,15.164,2679,2700,25971
2002,324,1060,2235,97739,99426,181,8.162,146,6.584,8693,2859,5834,2.876,8.743,12053,4299,7754,4.324,12.123,-3360,-3.379,17.486,52,53,885
2002,325,9121,12965,855690,875584,912,6.989,1082,8.291,77709,22163,55546,2.531,8.875,116411,28354,88057,3.238,13.295,-38702,-4.420,17.750,594,603,10498
2002,326,11765,14998,933329,968236,915,6.033,1253,8.261,83958,32143,51815,3.320,8.671,154119,43795,110324,4.523,15.918,-70161,-7.246,17.342,783,803,20523
2002,327,10767,15954,475744,497129,1212,7.578,1290,8.066,46107,14622,31485,2.941,9.275,89499,21658,67841,4.357,18.003,-43392,-8.729,18.549,740,764,10711
2002,331,3996,5051,496277,531393,322,6.215,582,11.233,26823,10363,16460,1.950,5.048,96553,30862,65691,5.808,18.170,-69730,-13.122,10.095,382,395,10421
2002,332,54928,59168,1584050,1675997,3741,6.257,4988,8.342,144232,52170,92062,3.113,8.606,327520,85549,241971,5.104,19.542,-183288,-10.936,17.211,3425,3460,44923
2002,333,24379,27214,1200730,1283002,1502,5.420,2497,9.011,90712,32775,57937,2.555,7.070,255758,56558,199200,4.408,19.934,-165046,-12.864,14.141,1720,1728,25548
2002,334,13014,15083,1280919,1429912,1138,7.378,1821,11.806,125375,45304,80071,3.168,8.768,426126,101940,324186,7.129,29.801,-300751,-21.033,17.536,1160,1179,32530
2002,335,5248,6264,498913,536090,442,6.953,628,9.879,31117,12850,18267,2.397,5.804,105467,24166,81301,4.508,19.673,-74350,-13.869,11.609,367,372,9769
2002,336,9893,12021,1583091,1662073,899,7.407,1132,9.326,119269,38514,80755,2.317,7.176,275378,51479,223899,3.097,16.568,-156109,-9.392,14.352,761,787,23985
2002,337,19966,20950,599660,622195,1805,8.596,1899,9.044,61314,20743,40571,3.334,9.854,106600,30922,75678,4.970,17.133,-45286,-7.278,19.709,1334,1343,16310
2002,339,28758,30027,717659,737935,2428,8.042,2760,9.141,80069,25103,54966,3.402,10.850,120920,31298,89622,4.241,16.386,-40851,-5.536,21.701,1988,2002,17241
2002,423,177845,238826,3314387,3409558,22517,9.332,27416,11.363,520579,189683,330896,5.563,15.268,707572,252933,454639,7.418,20.753,-186993,-5.484,30.536,15411,16067,121452
2002,424,101218,129279,2243898,2294534,13194,10.122,15341,11.769,346562,126651,219911,5.520,15.104,448570,171264,277306,7.464,19.550,-102008,-4.446,30.208,8926,9274,83590
2002,425,29053,30917,247609,244714,2952,9.430,3728,11.909,53980,17394,36586,7.108,22.058,48788,24709,24079,10.097,19.937,5192,2.122,39.873,2176,2202,13405
2002,441,88459,116939,1874453,1853833,10982,9.388,11068,9.461,292971,114167,178804,6.158,15.804,251150,102503,148647,5.529,13.548,41821,2.256,27.095,7336,7561,68686
2002,442,43731,59510,539007,548978,7072,11.820,7716,12.896,106105,50824,55281,9.258,19.328,125067,61496,63571,11.202,22.782,-18962,-3.454,38.655,4073,5118,44391
2002,443,29605,48392,447437,454996,6062,12.482,6410,13.199,74412,35783,38629,7.864,16.354,89036,38324,50712,8.423,19.569,-14624,-3.214,32.709,4008,4269,21595
2002,444,60076,82475,1187383,1174400,6805,8.185,8140,9.790,200019,100498,99521,8.557,17.032,177531,68253,109278,5.812,15.117,22488,1.915,30.233,4890,5330,46103
2002,445,96898,131802,2815718,2853706,15442,11.724,15261,11.587,338570,159762,178808,5.598,11.864,417818,126826,290992,4.444,14.641,-79248,-2.777,23.728,9983,10226,62628
2002,446,38269,77073,938950,932691,7595,9.911,6712,8.759,182250,83622,98628,8.966,19.540,168195,46902,121293,5.029,18.033,14055,1.507,36.067,3272,3819,21325
2002,447,60486,114024,926647,943112,9951,8.685,11053,9.647,171358,68531,102827,7.266,18.169,205812,65254,140558,6.919,21.823,-34454,-3.653,36.339,5801,6534,36370
2002,448,58863,139207,1383882,1381224,15478,11.144,14842,10.686,297724,143477,154247,10.388,21.555,290966,89851,201115,6.505,21.066,6758,0.489,42.132,6429,7514,38828
2002,451,33988,50234,535296,541579,5163,10.193,6001,11.847,101431,39215,62216,7.241,18.729,113216,34038,79178,6.285,20.905,-11785,-2.176,37.458,3674,4016,19344
2002,452,8164,37967,2582255,2566565,3389,9.005,2723,7.235,228007,84414,143593,3.289,8.884,203032,44108,158924,1.719,7.911,24975,0.973,15.821,1107,1381,7356
2002,453,90794,115954,794357,810408,14515,12.451,15766,13.524,149616,67893,81723,8.378,18.462,181269,73088,108181,9.019,22.368,-31653,-3.906,36.924,10178,10885,43879
2002,454,41070,48953,564279,578961,6415,13.239,5423,11.191,109855,50439,59416,8.712,18.975,139219,61403,77816,10.606,24.046,-29364,-5.072,37.949,3498,3557,30430
2002,481,2342,4962,530352,555380,619,12.428,656,13.171,38862,10436,28426,1.879,6.997,88203,8481,79722,1.527,15.882,-49341,-8.884,13.995,269,298,3413
2002,483,1219,1700,67467,70068,152,8.863,182,10.612,11689,4297,7392,6.133,16.682,16794,4848,11946,6.919,23.968,-5105,-7.286,33.365,101,101,2511
2002,484,83488,96526,1433816,1453622,13963,14.342,15621,16.045,237701,80931,156770,5.568,16.352,276840,93547,183293,6.435,19.045,-39139,-2.693,32.705,11001,11261,61296
2002,485,13210,15498,380072,382334,2048,13.254,1956,12.659,65404,31106,34298,8.136,17.107,70190,27938,42252,7.307,18.358,-4786,-1.252,34.213,1415,1430,16643
2002,486,191,2598,39903,39920,211,7.989,297,11.246,7859,4444,3415,11.132,19.687,7864,5405,2459,13.540,19.699,-5,-0.013,39.374,14,14,178
2002,487,1727,1814,20686,23017,265,14.164,379,20.257,3088,1286,1802,5.587,13.416,7692,2671,5021,11.604,33.419,-4604,-20.003,26.832,226,226,1824
2002,488,24027,30812,465216,471279,3969,12.963,3583,11.702,88206,39176,49030,8.313,18.716,100062,34702,65360,7.363,21.232,-11856,-2.516,37.433,2215,2293,14893
2002,492,6816,11428,555184,567842,1647,14.463,1566,13.752,40656,12713,27943,2.239,7.160,65231,17987,47244,3.168,11.488,-24575,-4.328,14.319,976,987,7804
2002,493,6695,11952,544691,548301,1314,10.877,1572,13.012,100545,47410,53135,8.647,18.338,107212,32687,74525,5.962,19.553,-6667,-1.216,36.675,404,449,5901
2002,511,21486,29637,1075265,1112461,3544,11.934,3661,12.328,144252,65498,78754,5.888,12.967,219191,63169,156022,5.678,19.703,-74939,-6.736,25.934,2174,2207,30079
2002,512,14209,18105,287190,295202,2530,13.826,2918,15.946,57438,21851,35587,7.402,19.457,73606,19498,54108,6.605,24.934,-16168,-5.477,38.914,1671,1716,9407
2002,515,4905,8983,283792,289316,886,9.876,862,9.609,36004,15495,20509,5.356,12.445,46797,16595,30202,5.736,16.175,-10793,-3.731,24.889,533,547,8314
2002,517,11880,50217,1539676,1589118,11755,23.102,13089,25.723,428391,277006,151385,17.431,26.958,524781,213402,311379,13.429,33.023,-96390,-6.066,53.916,3311,3418,56266
2002,518,7268,12786,432945,438398,2439,19.781,1527,12.384,100592,53374,47218,12.175,22.945,111157,31561,79596,7.199,25.355,-10565,-2.410,45.891,502,522,6400
2002,519,4441,5422,102969,106454,667,12.622,392,7.418,16972,6952,10020,6.531,15.943,23746,3846,19900,3.613,22.306,-6774,-6.363,31.886,246,253,2625
2002,521,12,47,22869,22950,D,D,D,D,440,D,377,D,1.917,594,D,569,D,2.588,-154,-0.671,3.835,D,D,D
2002,522,52211,186410,3055762,3011943,24059,13.260,14122,7.783,603854,231696,372158,7.693,20.049,514809,175159,339650,5.815,17.092,89045,2.956,34.185,3820,4264,36788
2002,523,39612,70927,975839,950726,12766,18.369,9906,14.254,273564,139604,133960,14.684,28.774,219826,96354,123472,10.135,23.122,53738,5.652,46.244,4128,4236,26420
2002,524,118299,156445,2378448,2366468,17405,11.195,15445,9.935,388127,159793,228334,6.752,16.401,363687,129632,234055,5.478,15.368,24440,1.033,30.737,8133,8359,46459
2002,525,800,858,5827,6306,202,24.589,129,15.703,1329,619,710,9.816,21.075,2217,990,1227,15.699,35.157,-888,-14.082,42.150,92,92,523
2002,531,190196,221172,1334083,1333729,29139,13.346,23472,10.750,261336,121933,139403,9.142,19.594,261203,101681,159522,7.624,19.584,133,0.010,39.169,15215,15373,62769
2002,532,27790,59136,618537,624767,6833,11.605,6324,10.740,113882,48614,65268,7.781,18.228,126585,43627,82958,6.983,20.261,-12703,-2.033,36.456,3132,3551,18752
2002,533,1918,2044,26113,25678,279,13.730,255,12.549,6572,2779,3793,10.823,25.594,5639,2027,3612,7.894,21.961,933,3.634,43.922,169,169,1080
2002,541,590513,653369,7055899,7181885,91083,14.010,84570,13.009,1423925,615571,808354,8.571,19.827,1679700,689148,990552,9.596,23.388,-255775,-3.561,39.653,54360,54886,304379
2002,551,26619,47232,2831498,2903231,5426,11.279,7175,14.915,520091,186734,333357,6.432,17.914,662845,223995,438850,7.715,22.831,-142754,-4.917,35.828,1498,1589,31479
2002,561,237900,286425,8061406,8337699,42147,14.567,47945,16.571,1993936,697333,1296603,8.364,23.915,2555534,859954,1695580,10.314,30.650,-561598,-6.736,47.829,28418,28951,396483
2002,562,13632,17140,321002,320317,2086,12.338,1620,9.582,61143,24482,36661,7.643,19.088,60423,18124,42299,5.658,18.864,720,0.225,37.727,1043,1055,9029
2002,611,58507,66009,2717842,2673629,7855,12.105,5620,8.661,317254,81195,236059,3.037,11.866,228617,56962,171655,2.131,8.551,88637,3.315,17.102,3569,3646,37332
2002,621,387172,448712,4845293,4763363,48198,10.903,34914,7.898,960700,380864,579836,7.996,20.169,798114,311721,486393,6.544,16.755,162586,3.413,33.511,20424,20973,151719
2002,622,3838,6426,5100990,5049099,293,4.548,325,5.045,418271,108119,310152,2.141,8.284,316098,96918,219180,1.920,6.260,102173,2.024,12.521,151,167,49989
2002,623,30895,66078,2797328,2753185,7566,11.674,5032,7.764,410774,170173,240601,6.181,14.920,323252,134988,188264,4.903,11.741,87522,3.179,23.482,2123,2338,60254
2002,624,95036,130123,2104844,2078166,15537,12.189,10222,8.019,380383,137797,242586,6.631,18.304,329285,91226,238059,4.390,15.845,51098,2.459,31.690,6206,6344,56970
2002,711,27585,28232,381497,381216,4611,16.406,4359,15.509,89680,30175,59505,7.915,23.525,88838,28937,59901,7.591,23.304,842,0.221,46.608,2651,2659,17789
2002,712,5547,5984,117779,117300,496,8.426,301,5.113,12131,3105,9026,2.647,10.342,11198,2034,9164,1.734,9.547,933,0.795,19.093,161,161,1545
2002,713,47529,53616,1278238,1266965,6637,12.409,6372,11.914,214539,79558,134981,6.279,16.933,192941,64340,128601,5.078,15.229,21598,1.705,30.457,4100,4204,43394
2002,721,42630,53218,1739798,1779593,5624,10.558,5727,10.751,244396,124647,119749,7.004,13.733,320637,100040,220597,5.622,18.017,-76241,-4.284,27.467,3404,3460,49016
2002,722,325512,447800,8334781,8286851,63082,14.248,52989,11.968,1653495,874573,778922,10.554,19.953,1550104,577956,972148,6.974,18.706,103391,1.248,37.411,33250,34503,323984
2002,811,191924,209339,1287271,1296892,22744,10.868,22621,10.809,236493,103136,133357,7.953,18.235,255323,95073,160250,7.331,19.687,-18830,-1.452,36.471,15866,16068,61366
2002,812,142341,178387,1274031,1291952,23336,13.150,21484,12.106,247584,114249,133335,8.843,19.164,284431,102433,181998,7.929,22.016,-36847,-2.852,38.327,13473,13780,56491
2002,813,273519,282034,2708999,2672810,17184,6.159,11093,3.976,348640,71561,277079,2.677,13.044,275658,49792,225866,1.863,10.313,72982,2.731,20.627,6375,6383,29687
2003,113,10204,10407,75735,75437,1104,10.477,1364,12.945,15514,4327,11187,5.736,20.566,14822,5663,9159,7.507,19.648,692,0.917,39.297,985,985,3316
2003,114,1531,1546,8714,8904,257,16.629,256,16.564,1699,608,1091,6.828,19.081,2048,741,1307,8.322,23.001,-349,-3.920,38.163,146,146,401
2003,115,8991,9482,97952,96497,1213,12.794,1211,12.773,20930,6462,14468,6.697,21.690,17929,5925,12004,6.140,18.580,3001,3.110,37.160,855,855,4144
2003,211,5580,6739,82477,85253,633,9.282,794,11.643,16655,6267,10388,7.351,19.536,22206,11337,10869,13.298,26.047,-5551,-6.511,39.072,375,384,2385
2003,212,4005,6481,186322,190831,452,6.873,642,9.763,22416,6458,15958,3.384,11.747,31220,10386,20834,5.443,16.360,-8804,-4.614,23.493,347,356,3119
2003,213,6768,8248,186305,187773,826,9.974,893,10.783,33105,7558,25547,4.025,17.630,35361,9519,25842,5.069,18.832,-2256,-1.201,35.261,533,547,4891
2003,221,6457,17594,663088,663138,1482,8.504,1148,6.587,77394,27118,50276,4.089,11.671,76996,22841,54155,3.444,11.611,398,0.060,23.222,250,261,2079
2003,236,177940,179888,1503598,1492440,28089,15.725,25565,14.312,341207,117996,223211,7.906,22.862,319543,100045,219498,6.703,21.411,21664,1.452,42.822,17103,17105,69141
2003,237,42865,44607,908667,937966,5165,11.551,5377,12.026,155211,32891,122320,3.507,16.548,212365,42465,169900,4.527,22.641,-57154,-6.093,33.095,3712,3746,23136
2003,238,379214,384385,3952169,3939835,53557,14.050,47140,12.367,818835,240959,577876,6.116,20.783,794125,225422,568703,5.722,20.156,24710,0.627,40.313,32615,32630,157087
2003,311,20952,25318,1487525,1484561,2266,8.960,2209,8.735,153225,31161,122064,2.099,10.321,147936,53446,94490,3.600,9.965,5289,0.356,19.930,1533,1553,18151
2003,312,2350,2879,154775,156783,344,12.259,198,7.056,15543,3671,11872,2.341,9.914,19351,4180,15171,2.666,12.343,-3808,-2.429,19.827,133,133,932
2003,313,2940,3570,255114,262568,227,6.222,384,10.525,19299,5523,13776,2.103,7.350,33809,11966,21843,4.557,12.876,-14510,-5.526,14.700,277,279,4298
2003,314,7007,7360,188766,191411,567,7.601,767,10.282,21544,6444,15100,3.367,11.255,26756,9267,17489,4.841,13.978,-5212,-2.723,22.511,595,600,5469
2003,315,9977,10350,293645,308962,1756,16.703,2082,19.804,51079,20732,30347,6.710,16.532,81676,42102,39574,13.627,26.436,-30597,-9.903,33.065,1763,1773,24227
2003,316,1268,1329,42702,44132,116,8.561,168,12.399,4261,933,3328,2.114,9.655,7132,3250,3882,7.364,16.161,-2871,-6.505,19.310,130,130,1659
2003,321,14207,16034,531710,535791,1277,7.911,1493,9.249,60263,16327,43936,3.047,11.247,68757,22701,46056,4.237,12.833,-8494,-1.585,22.495,1086,1092,10159
2003,322,3337,5344,487220,494672,277,5.143,360,6.685,33212,10833,22379,2.190,6.714,48183,18904,29279,3.822,9.740,-14971,-3.026,13.428,192,207,5769
2003,323,32533,34240,698761,709500,2083,5.983,3239,9.303,69308,19728,49580,2.781,9.769,90752,32272,58480,4.549,12.791,-21444,-3.022,19.537,2587,2626,19640
2003,324,1051,2241,99077,98372,133,5.949,122,5.457,8654,3664,4990,3.725,8.797,7134,2058,5076,2.092,7.252,1520,1.545,14.504,57,57,558
2003,325,8983,12748,848328,851738,796,6.205,957,7.460,71861,16205,55656,1.903,8.437,79134,21696,57438,2.547,9.291,-7273,-0.854,16.874,546,559,6640
2003,326,11398,14560,921862,927074,719,4.879,1072,7.274,92141,20729,71412,2.236,9.939,102629,34132,68497,3.682,11.070,-10488,-1.131,19.878,675,697,11594
2003,327,10511,15750,468195,471674,960,6.074,1071,6.776,52194,11379,40815,2.412,11.066,59005,15626,43379,3.313,12.510,-6811,-1.444,22.131,634,659,6333
2003,331,4070,5088,472752,484667,343,6.694,415,8.099,36035,14873,21162,3.069,7.435,59349,19119,40230,3.945,12.245,-23314,-4.810,14.870,243,252,7769
2003,332,53191,57302,1523285,1551543,3186,5.481,4837,8.321,153774,37416,116358,2.412,9.911,210307,61762,148545,3.981,13.555,-56533,-3.644,19.822,3473,3485,26233
2003,333,23629,26250,1141407,1169416,1334,4.995,2252,8.432,101276,22313,78963,1.908,8.660,157340,49305,108035,4.216,13.455,-56064,-4.794,17.321,1514,1527,17865
2003,334,12531,14493,1132206,1201062,1071,7.263,1578,10.701,108914,31487,77427,2.622,9.068,248224,69920,178304,5.822,20.667,-139310,-11.599,18.136,1036,1042,17062
2003,335,5112,6067,458369,475601,352,5.721,523,8.501,30709,8996,21713,1.892,6.457,64957,16890,48067,3.551,13.658,-34248,-7.201,12.914,333,341,4097
2003,336,9749,11881,1601650,1605874,840,7.039,946,7.927,151550,34189,117361,2.129,9.437,162333,41495,120838,2.584,10.109,-10783,-0.671,18.874,632,639,10749
2003,337,19511,20427,570907,584710,1522,7.370,1972,9.549,56212,12878,43334,2.202,9.614,83570,25754,57816,4.405,14.293,-27358,-4.679,19.227,1446,1451,12697
2003,339,28183,29421,705288,709443,2224,7.507,2635,8.894,80542,17536,63006,2.472,11.353,88918,31088,57830,4.382,12.534,-8376,-1.181,22.706,2049,2052,15353
2003,423,176376,235750,3279024,3287915,21611,9.133,23338,9.863,492012,179068,312944,5.446,14.964,510416,179740,330676,5.467,15.524,-18404,-0.560,29.929,14309,14836,82432
2003,424,100634,126957,2287501,2259247,12339,9.656,14005,10.959,365275,101694,263581,4.501,16.168,307998,116296,191702,5.148,13.633,57277,2.535,27.266,8611,8844,51547
2003,425,30087,31929,259273,255437,3013,9.489,2663,8.386,40276,11710,28566,4.584,15.768,32605,8653,23952,3.388,12.764,7671,3.003,25.529,1802,1814,4928
2003,441,89233,118181,1917931,1897024,10393,8.830,9426,8.009,253577,84152,169425,4.436,13.367,211650,68871,142779,3.630,11.157,41927,2.210,22.314,6515,6781,45703
2003,442,44268,60517,565155,552975,6575,10.957,5560,9.265,110480,44903,65577,8.120,19.979,86527,27391,59136,4.953,15.648,23953,4.332,31.295,3537,3771,16171
2003,443,30202,49771,468031,459750,6421,13.029,5446,11.050,83720,36910,46810,8.028,18.210,67809,24791,43018,5.392,14.749,15911,3.461,29.498,3686,3966,15963
2003,444,60278,83118,1211262,1201402,6010,7.240,5792,6.978,141877,47425,94452,3.947,11.809,121424,34140,87284,2.842,10.107,20453,1.702,20.214,3795,3966,19545
2003,445,99987,134618,2860702,2837723,17332,13.000,14750,11.063,380012,172979,207033,6.096,13.391,335221,124853,210368,4.400,11.813,44791,1.578,23.626,10114,10267,53637
2003,446,39182,78352,955732,948811,6084,7.811,5167,6.633,114162,40019,74143,4.218,12.032,102168,36988,65180,3.898,10.768,11994,1.264,21.536,2778,2981,15687
2003,447,60819,112579,931442,928149,10135,8.946,11566,10.209,171985,62283,109702,6.710,18.530,165644,67642,98002,7.288,17.847,6341,0.683,35.693,5562,6053,32289
2003,448,59495,139380,1455046,1422103,13185,9.465,13039,9.360,273072,78878,194194,5.547,19.202,203743,74577,129166,5.244,14.327,69329,4.875,28.654,6010,6576,25740
2003,451,34200,50249,545551,542130,5070,10.060,5367,10.649,94025,26562,67463,4.900,17.344,87890,30564,57326,5.638,16.212,6135,1.132,32.424,3298,3499,13840
2003,452,8435,39359,2606339,2603646,3976,10.273,2667,6.891,243785,113978,129807,4.378,9.363,238836,72334,166502,2.778,9.173,4949,0.190,18.346,1001,1391,25573
2003,453,90489,115687,818068,807986,12789,11.030,13320,11.487,152950,52722,100228,6.525,18.930,132200,50144,82056,6.206,16.362,20750,2.568,32.723,9601,9853,33269
2003,454,40651,48360,575357,572710,5681,11.782,5393,11.185,92408,31446,60962,5.491,16.135,86805,33735,53070,5.890,15.157,5603,0.978,30.314,3827,3900,17403
2003,481,2386,5027,517142,523984,564,11.277,513,10.257,34473,12372,22101,2.361,6.579,47170,5310,41860,1.013,9.002,-12697,-2.423,13.158,247,278,2585
2003,483,1257,1704,66714,67211,209,12.165,237,13.795,14676,8182,6494,12.174,21.836,15175,7004,8171,10.421,22.578,-499,-0.742,43.672,110,112,1094
2003,484,83211,95770,1411713,1425403,13972,14.529,14767,15.355,225947,67435,158512,4.731,15.851,252986,115824,137162,8.126,17.748,-27039,-1.897,31.703,10670,10789,51543
2003,485,13207,15521,395748,387115,1931,12.447,1916,12.351,67451,24529,42922,6.336,17.424,50368,19910,30458,5.143,13.011,17083,4.413,26.022,1416,1430,11045
2003,486,205,2683,39139,40883,283,10.718,198,7.499,6298,2800,3498,6.849,15.405,9662,2368,7294,5.792,23.633,-3364,-8.228,30.810,9,9,36
2003,487,1677,1764,22033,21423,250,14.041,283,15.894,4392,1117,3275,5.214,20.502,3163,968,2195,4.519,14.765,1229,5.737,29.530,185,185,615
2003,488,24357,31548,490061,482013,4172,13.398,3353,10.768,102015,41047,60968,8.516,21.164,85289,28811,56478,5.977,17.694,16726,3.470,35.389,2188,2233,14572
2003,492,6978,13138,490790,521539,3439,28.015,1714,13.963,195243,187838,7405,36.016,37.436,257119,23764,233355,4.557,49.300,-61876,-11.864,74.872,937,950,5602
2003,493,6684,12012,545870,545408,1175,9.767,1212,10.074,88688,25298,63390,4.638,16.261,88003,28540,59463,5.233,16.135,685,0.126,32.271,388,417,5696
2003,511,21343,29118,1036042,1050062,2927,9.992,3277,11.187,116191,41520,74671,3.954,11.065,144843,47131,97712,4.488,13.794,-28652,-2.729,22.130,1906,1965,16288
2003,512,14240,18096,294572,290237,2586,14.271,2636,14.547,77338,40440,36898,13.933,26.647,66480,20544,45936,7.078,22.905,10858,3.741,45.811,1604,1623,7993
2003,515,4960,10077,297395,297612,1764,18.226,967,9.991,44588,18744,25844,6.298,14.982,45190,14403,30787,4.840,15.184,-602,-0.202,29.964,389,404,4514
2003,517,12400,50279,1481162,1509872,7365,14.647,7372,14.661,244893,91469,153424,6.058,16.219,308002,179981,128021,11.920,20.399,-63109,-4.180,32.439,2156,2251,23803
2003,518,6924,12601,402854,410450,2373,19.011,2135,17.105,69630,30598,39032,7.455,16.964,84742,35279,49463,8.595,20.646,-15112,-3.682,33.929,778,796,9293
2003,519,4330,5225,92515,94679,563,10.717,620,11.802,13130,4485,8645,4.737,13.868,17483,7754,9729,8.190,18.466,-4353,-4.598,27.736,427,439,3417
2003,521,18,53,22256,22686,D,D,0,0.000,375,D,371,D,1.653,1219,0,1219,0.000,5.373,-844,-3.720,3.306,0,0,0
2003,522,54670,192472,3090960,3070302,21961,11.599,15688,8.286,555886,211435,344451,6.886,18.105,517423,182983,334440,5.960,16.853,38463,1.253,33.705,3704,4070,25230
2003,523,40629,75691,884342,928764,15938,21.767,10998,15.020,163693,84256,79437,9.072,17.625,259198,101599,157599,10.939,27.908,-95505,-10.283,35.250,4204,4429,18848
2003,524,119933,157180,2369333,2367237,16420,10.481,15391,9.824,363352,118805,244547,5.019,15.349,359068,136572,222496,5.769,15.168,4284,0.181,30.336,7736,7894,31082
2003,525,905,950,7281,6971,208,22.523,155,16.784,2322,904,1418,12.968,33.309,1713,804,909,11.533,24.573,609,8.736,49.146,104,104,503
2003,531,197835,229401,1411066,1374651,31193,13.848,22899,10.166,295435,120688,174747,8.780,21.492,221900,88000,133900,6.402,16.142,73535,5.349,32.285,15521,15820,56224
2003,532,26979,58408,621331,619773,5569,9.498,6015,10.259,101698,31719,69979,5.118,16.409,99801,38489,61312,6.210,16.103,1897,0.306,32.206,2902,3144,14956
2003,533,1944,2063,28911,27751,278,13.561,252,12.293,6171,3188,2983,11.488,22.237,3861,1674,2187,6.032,13.913,2310,8.324,27.826,169,170,776
2003,541,597829,661475,7150563,7119848,86906,13.215,79178,12.040,1318291,459082,859209,6.448,18.516,1262708,455824,806884,6.402,17.735,55583,0.781,35.470,53425,53948,234077
2003,551,26472,46604,2803468,2829231,4781,10.180,5504,11.719,487717,142779,344938,5.047,17.239,535216,185092,350124,6.542,18.917,-47499,-1.679,34.477,1152,1221,17340
2003,561,240505,285853,7928186,7986029,41658,14.561,42136,14.728,1818054,505408,1312646,6.329,22.765,1922805,678590,1244215,8.497,24.077,-104751,-1.312,45.531,25494,25929,308408
2003,562,13688,17180,331912,326882,1726,10.058,1688,9.836,56679,17397,39282,5.322,17.339,46817,16743,30074,5.122,14.322,9862,3.017,28.645,1103,1115,8609
2003,611,60483,67825,2782168,2745681,7902,11.825,5906,8.838,297258,53519,243739,1.949,10.826,225521,48063,177458,1.750,8.214,71737,2.613,16.427,3995,4099,28523
2003,621,397443,458758,5103508,4974254,42033,9.270,31392,6.923,908852,282835,626017,5.686,18.271,649740,221127,428613,4.445,13.062,259112,5.209,26.124,20221,21338,117839
2003,622,3925,6578,5177628,5141063,288,4.407,201,3.076,297759,58604,239155,1.140,5.792,224871,71992,152879,1.400,4.374,72888,1.418,8.748,60,60,17592
2003,623,31214,66563,2871826,2829383,5270,7.962,4524,6.835,378296,119247,259049,4.215,13.370,292518,112832,179686,3.988,10.339,85778,3.032,20.677,2229,2401,55910
2003,624,97418,132929,2185028,2148703,12850,9.754,10466,7.945,357456,94821,262635,4.413,16.636,284970,73048,211922,3.400,13.262,72486,3.373,26.525,6595,6748,39181
2003,711,28367,29104,398691,391287,4965,17.282,4217,14.678,94225,30504,63721,7.796,24.081,79574,26809,52765,6.852,20.337,14651,3.744,40.673,2789,2793,18325
2003,712,5703,6135,120147,123936,473,7.799,333,5.491,12836,1682,11154,1.357,10.357,20934,1253,19681,1.011,16.891,-8098,-6.534,20.714,191,191,789
2003,713,49244,55363,1316078,1292817,7232,13.271,5498,10.089,224978,70074,154904,5.420,17.402,177346,53964,123382,4.174,13.718,47632,3.684,27.436,3904,3957,35023
2003,721,43084,53646,1796889,1768240,5299,9.908,4968,9.289,252995,90626,162369,5.125,14.308,197330,68618,128712,3.881,11.160,55665,3.148,22.319,3226,3303,37679
2003,722,334059,458113,8635966,8483830,60965,13.457,50835,11.221,1674164,798043,876121,9.407,19.734,1369951,548656,821295,6.467,16.148,304213,3.586,32.296,35168,36094,313891
2003,811,192057,208817,1307884,1299489,21463,10.270,21801,10.432,242997,83802,159195,6.449,18.699,225812,84778,141034,6.524,17.377,17185,1.322,34.754,15811,16055,56695
2003,812,146024,182527,1303075,1288097,23659,13.110,19529,10.822,238338,97558,140780,7.574,18.503,208556,85994,122562,6.676,16.191,29782,2.312,32.382,13588,14110,57928
2003,813,276160,284612,2753403,2728595,16143,5.701,13192,4.659,336646,57304,279342,2.100,12.338,287333,49112,238221,1.800,10.530,49313,1.807,21.061,8728,8754,27068
2004,113,10059,10246,76056,75330,1213,11.820,1245,12.132,14447,4396,10051,5.836,19.178,13064,4900,8164,6.505,17.342,1383,1.836,34.685,919,920,3693
2004,114,1550,1565,8591,8569,263,17.006,226,14.614,1557,551,1006,6.430,18.170,1555,617,938,7.200,18.147,2,0.023,36.294,141,141,454
2004,115,8937,9371,97666,97536,1209,12.907,1201,12.822,17546,5892,11654,6.041,17.989,17287,6764,10523,6.935,17.724,259,0.266,35.447,834,834,3645
2004,211,5585,6666,80401,81020,613,9.171,649,9.710,13707,6511,7196,8.036,16.918,14631,6781,7850,8.370,18.059,-924,-1.140,33.836,325,330,2479
2004,212,4000,6452,189550,187784,555,8.573,598,9.238,27095,8507,18588,4.530,14.429,23741,9104,14637,4.848,12.643,3354,1.786,25.285,304,316,2823
2004,213,7106,8594,197452,192246,986,11.651,723,8.544,33627,8608,25019,4.478,17.492,23081,7030,16051,3.657,12.006,10546,5.486,24.012,461,474,4276
2004,221,6329,17263,630180,646499,1239,7.149,1375,7.934,55450,20662,34788,3.196,8.577,87739,23976,63763,3.709,13.571,-32289,-4.994,17.154,286,289,1431
2004,236,186563,188537,1568569,1535399,32886,17.846,24366,13.222,360114,114462,245652,7.455,23.454,294046,101414,192632,6.605,19.151,66068,4.303,38.302,16564,16572,72408
2004,237,41990,43800,914381,910583,4494,10.202,4994,11.337,179786,34280,145506,3.765,19.744,172034,43034,129000,4.726,18.893,7752,0.851,37.785,3616,3620,26247
2004,238,393753,398812,4147833,4046932,60862,15.548,46148,11.789,923632,247103,676529,6.106,22.823,723398,232694,490704,5.750,17.875,200234,4.948,35.750,32494,32557,165709
2004,311,20881,25252,1480669,1486097,1979,7.828,2034,8.046,137321,37608,99713,2.531,9.240,149139,42639,106500,2.869,10.036,-11818,-0.795,18.481,1460,1469,14158
2004,312,2431,2989,154125,154742,353,12.040,239,8.151,13444,3703,9741,2.393,8.688,14764,3295,11469,2.129,9.541,-1320,-0.853,17.376,149,149,1289
2004,313,2794,3373,223709,239220,211,6.089,395,11.400,14223,3857,10366,1.612,5.946,45720,17455,28265,7.297,19.112,-31497,-13.167,11.891,276,284,4430
2004,314,6875,7210,180121,184082,586,8.047,731,10.038,22112,8235,13877,4.474,12.012,30200,11993,18207,6.515,16.406,-8088,-4.394,24.024,565,567,4968
2004,315,9602,9907,268272,278925,1676,16.584,2074,20.522,46625,18967,27658,6.800,16.716,68222,34142,34080,12.241,24.459,-21597,-7.743,33.432,1792,1799,24485
2004,316,1275,1334,41307,41835,141,10.526,152,11.348,4917,2035,2882,4.864,11.753,5895,1328,4567,3.174,14.091,-978,-2.338,23.507,123,125,1073
2004,321,14177,15993,539943,535527,1306,8.141,1404,8.752,66073,15771,50302,2.945,12.338,57098,22393,34705,4.181,10.662,8975,1.676,21.324,1017,1020,10344
2004,322,3332,5284,466819,476072,232,4.360,307,5.769,28306,6794,21512,1.427,5.946,46277,13998,32279,2.940,9.721,-17971,-3.775,11.891,164,166,3822
2004,323,31682,33352,674125,686191,1966,5.811,2922,8.637,60553,14186,46367,2.067,8.825,84615,26627,57988,3.880,12.331,-24062,-3.507,17.649,2344,2363,17205
2004,324,1046,2340,101898,100351,276,12.024,187,8.146,11478,5179,6299,5.161,11.438,8286,2053,6233,2.046,8.257,3192,3.181,16.514,52,52,538
2004,325,8998,12806,826214,837456,829,6.473,830,6.481,69242,21690,47552,2.590,8.268,92070,21629,70441,2.583,10.994,-22828,-2.726,16.536,493,497,6379
2004,326,11248,14349,896485,907706,685,4.739,898,6.212,77686,15037,62649,1.657,8.559,100393,27898,72495,3.073,11.060,-22707,-2.502,17.117,556,560,9177
2004,327,10545,15843,467849,468012,1017,6.419,1017,6.419,53105,11819,41286,2.525,11.347,52762,15950,36812,3.408,11.274,343,0.073,22.547,614,625,5856
2004,331,4024,5006,444561,458772,377,7.448,489,9.660,33405,12095,21310,2.636,7.281,61474,26487,34987,5.773,13.400,-28069,-6.118,14.563,328,339,9381
2004,332,52450,56515,1513926,1519706,3235,5.678,4147,7.279,162580,34108,128472,2.244,10.698,174398,51604,122794,3.396,11.476,-11818,-0.778,21.396,3016,3041,25661
2004,333,23311,25854,1104608,1121862,1482,5.683,1925,7.382,96300,24251,72049,2.162,8.584,131453,40429,91024,3.604,11.717,-35153,-3.133,17.168,1335,1350,15377
2004,334,12313,14162,1081358,1101634,1025,7.157,1345,9.391,109535,25510,84025,2.316,9.943,150064,55082,94982,5.000,13.622,-40529,-3.679,19.886,900,916,15749
2004,335,5095,5998,438127,447576,396,6.559,475,7.867,34578,8626,25952,1.927,7.726,53196,16441,36755,3.673,11.885,-18618,-4.160,15.451,291,297,3461
2004,336,9871,11986,1606562,1603380,956,7.987,923,7.711,149758,42147,107611,2.629,9.340,142330,33924,108406,2.116,8.877,7428,0.463,17.754,626,645,10721
2004,337,19223,20111,560547,564987,1583,7.796,1970,9.702,62244,15514,46730,2.746,11.017,70382,22997,47385,4.070,12.457,-8138,-1.440,22.034,1508,1518,12181
2004,339,28393,29621,689416,695464,2394,8.091,2331,7.878,75721,17364,58357,2.497,10.888,87859,23885,63974,3.434,12.633,-12138,-1.745,21.776,1809,1813,13181
2004,423,174599,235243,3327496,3306034,20766,8.838,20189,8.593,483403,169883,313520,5.139,14.622,442677,159340,283337,4.820,13.390,40726,1.232,26.780,12686,13215,75344
2004,424,99386,126386,2313494,2301881,11626,9.207,11408,9.034,334878,105062,229816,4.564,14.548,311530,127376,184154,5.534,13.534,23348,1.014,27.067,7997,8147,49033
2004,425,32135,34049,272247,268519,4052,12.065,3123,9.299,43851,15072,28779,5.613,16.331,36180,11495,24685,4.281,13.474,7671,2.857,26.948,2197,2218,7251
2004,441,89524,119106,1950430,1934578,10272,8.662,9237,7.789,234946,79848,155098,4.127,12.145,203546,71039,132507,3.672,10.521,31400,1.623,21.043,6866,7103,51768
2004,442,44462,60908,576408,570185,6040,9.953,5598,9.224,99640,36997,62643,6.489,17.475,86288,32250,54038,5.656,15.133,13352,2.342,30.267,3846,4138,20678
2004,443,30499,49480,499411,484310,5847,11.768,6260,12.599,96567,29020,67547,5.992,19.939,67070,30675,36395,6.334,13.849,29497,6.091,27.697,3823,4084,16444
2004,444,60196,83041,1251856,1231929,5649,6.802,5655,6.810,140695,43954,96741,3.568,11.421,101230,32428,68802,2.632,8.217,39465,3.204,16.434,3917,4195,21371
2004,445,102082,137102,2944934,2901200,17725,13.079,14557,10.742,419421,161052,258369,5.551,14.457,329455,112915,216540,3.892,11.356,89966,3.101,22.712,10858,11016,56978
2004,446,40063,79789,1033192,995010,6961,8.797,5650,7.140,189344,62984,126360,6.330,19.029,115505,43453,72052,4.367,11.608,73839,7.421,23.217,3046,3128,15150
2004,447,61732,111200,930897,932825,8808,7.859,10550,9.414,156284,52447,103837,5.622,16.754,160322,67029,93293,7.186,17.187,-4038,-0.433,33.508,5649,6631,40675
2004,448,59637,140539,1546691,1501517,13357,9.544,12180,8.703,285343,88262,197081,5.878,19.004,193311,66259,127052,4.413,12.874,92032,6.129,25.749,6116,6868,27390
2004,451,34389,50082,557111,551919,4919,9.800,5144,10.248,82792,34825,47967,6.310,15.001,72327,24709,47618,4.477,13.105,10465,1.896,26.209,3468,3553,13652
2004,452,8822,41079,2736736,2670636,4170,10.354,2562,6.361,309867,78095,231772,2.924,11.603,181263,61416,119847,2.300,6.787,128604,4.815,13.575,1166,1215,6476
2004,453,90126,114710,815135,818588,12551,10.877,13909,12.054,134835,53746,81089,6.566,16.472,142418,55487,86931,6.778,17.398,-7583,-0.926,32.943,9990,10803,36934
2004,454,41017,48397,558473,565386,5130,10.650,4678,9.711,87390,30707,56683,5.431,15.457,100931,38041,62890,6.728,17.852,-13541,-2.395,30.913,3207,3236,17945
2004,481,2471,5228,475941,497022,776,15.115,588,11.453,43078,20554,22524,4.135,8.667,85808,23626,62182,4.754,17.264,-42730,-8.597,17.334,247,255,1946
2004,483,1222,1647,65946,66446,153,9.132,210,12.534,8280,2315,5965,3.484,12.461,9258,1996,7262,3.004,13.933,-978,-1.472,24.922,127,138,954
2004,484,84239,97142,1447712,1429330,14952,15.493,13686,14.181,237161,90633,146528,6.341,16.592,199050,73030,126020,5.109,13.926,38111,2.666,27.852,10201,10341,48712
2004,485,13140,15406,398801,397081,1763,11.401,1878,12.145,56953,17463,39490,4.398,14.343,53638,23727,29911,5.975,13.508,3315,0.835,27.016,1419,1428,12703
2004,486,212,2491,37209,38723,510,19.714,702,27.136,9607,6252,3355,16.146,24.810,12724,8247,4477,21.298,32.859,-3117,-8.050,49.620,10,17,402
2004,487,1720,1814,22157,22066,284,15.822,246,13.705,3726,1536,2190,6.961,16.886,3483,1455,2028,6.594,15.784,243,1.101,31.569,168,169,977
2004,488,25268,32771,520618,505678,4130,12.815,3045,9.448,95856,42575,53281,8.419,18.956,65001,23883,41118,4.723,12.854,30855,6.102,25.708,2119,2183,13079
2004,492,6867,13053,578956,549009,1432,10.909,1579,12.029,110481,28523,81958,5.195,20.124,53300,30137,23163,5.489,9.708,57181,10.415,19.417,926,936,4743
2004,493,6789,12883,577005,563657,1724,13.792,958,7.664,99345,42318,57027,7.508,17.625,72669,21685,50984,3.847,12.892,26676,4.733,25.785,392,403,3624
2004,511,21046,29215,1028889,1031392,3100,10.632,2986,10.241,116110,40310,75800,3.908,11.258,120665,41847,78818,4.057,11.699,-4555,-0.442,22.515,1784,1861,16521
2004,512,14509,18178,305977,305050,2615,14.403,2571,14.161,58399,21769,36630,7.136,19.144,55983,24138,31845,7.913,18.352,2416,0.792,36.704,1485,1507,6443
2004,515,4858,9835,287353,291446,1180,11.880,1376,13.853,44184,18775,25409,6.442,15.160,52116,25400,26716,8.715,17.882,-7932,-2.722,30.321,398,414,5008
2004,517,12122,50441,1374368,1428384,8395,16.688,8123,16.148,254154,72417,181737,5.070,17.793,359415,112804,246611,7.897,25.162,-105261,-7.369,35.586,2228,2403,18835
2004,518,7049,13190,378083,389722,2722,21.200,2021,15.740,78503,39879,38624,10.233,20.143,101732,46715,55017,11.987,26.104,-23229,-5.960,40.287,518,530,4560
2004,519,4575,5502,97760,96359,684,12.756,404,7.535,15016,3589,11427,3.725,15.583,11923,2760,9163,2.864,12.374,3093,3.210,24.747,256,267,1509
2004,521,19,57,21505,21882,5,9.009,D,D,650,435,215,1.988,2.971,1428,D,1423,D,6.526,-778,-3.556,5.941,D,D,D
2004,522,57219,198962,3156132,3129710,22661,11.569,16474,8.411,579297,231085,348212,7.384,18.510,529742,191083,338659,6.105,16.926,49555,1.583,33.852,4072,4377,25728
2004,523,43103,73363,858809,875240,13245,17.743,15820,21.192,207965,84183,123782,9.618,23.761,240942,128802,112140,14.716,27.529,-32977,-3.768,47.522,3954,4005,24076
2004,524,121998,160334,2370365,2370703,17005,10.711,13853,8.726,317523,123239,194284,5.198,13.394,319770,119853,199917,5.056,13.488,-2247,-0.095,26.787,7419,7640,31568
2004,525,891,932,6691,6811,215,23.382,190,20.663,2054,656,1398,9.631,30.157,2223,1452,771,21.318,32.638,-169,-2.481,60.314,146,146,837
2004,531,205624,238570,1457122,1430871,33329,14.272,23259,9.960,273919,124318,149601,8.688,19.144,221066,95651,125415,6.685,15.450,52853,3.694,30.900,16029,16431,64476
2004,532,26905,59627,614206,618064,6426,10.886,5228,8.857,95759,35895,59864,5.808,15.493,101595,34741,66854,5.621,16.438,-5836,-0.944,30.987,2610,3097,14854
2004,533,2053,2139,31433,29405,327,15.706,213,10.231,7772,3021,4751,10.274,26.431,3631,1529,2102,5.200,12.348,4141,14.083,24.697,147,148,992
2004,541,611334,678747,7246248,7193786,90487,13.495,73994,11.036,1261231,456104,805127,6.340,17.532,1160305,443372,716933,6.163,16.129,100926,1.403,32.259,50549,51122,238914
2004,551,26130,46664,2776612,2809314,4195,8.989,4206,9.012,426541,145898,280643,5.193,15.183,489311,161932,327379,5.764,17.417,-62770,-2.234,30.366,1146,1201,20610
2004,561,248323,294024,8088405,8042696,44456,15.288,37977,13.060,1805749,534524,1271225,6.646,22.452,1731563,628221,1103342,7.811,21.530,74186,0.922,43.059,24425,24969,289345
2004,562,14032,17639,344665,339132,1811,10.368,1469,8.410,53492,16220,37272,4.783,15.773,42803,12737,30066,3.756,12.621,10689,3.152,25.243,1029,1044,7404
2004,611,62778,70288,2878497,2824143,8027,11.610,5731,8.289,291309,61796,229513,2.188,10.315,182132,46708,135424,1.654,6.449,109177,3.866,12.898,4087,4144,35215
2004,621,406762,470363,5329621,5214944,41594,8.958,29553,6.364,811504,251730,559774,4.827,15.561,583331,183359,399972,3.516,11.186,228173,4.375,22.372,20980,21569,113534
2004,622,4057,6803,5227085,5196285,396,5.903,208,3.100,248439,32799,215640,0.631,4.781,187654,53243,134411,1.025,3.611,60785,1.170,7.223,94,95,17229
2004,623,31541,67854,2899977,2885580,5381,8.006,4104,6.106,311034,122363,188671,4.241,10.779,282835,105068,177767,3.641,9.802,28199,0.977,19.603,2185,2360,55090
2004,624,99639,135294,2225434,2207506,12513,9.316,10548,7.853,318749,102842,215907,4.659,14.439,281757,72712,209045,3.294,12.764,36992,1.676,25.527,7039,7234,44400
2004,711,28996,29782,401370,400429,4921,16.712,4248,14.427,80752,27032,53720,6.751,20.166,79704,26840,52864,6.703,19.905,1048,0.262,39.809,2801,2806,14068
2004,712,5837,6264,118860,119431,443,7.138,328,5.285,9125,1241,7884,1.039,7.640,10261,1922,8339,1.609,8.592,-1136,-0.951,15.281,200,200,1519
2004,713,52023,58302,1365314,1342036,8147,14.310,5404,9.492,206132,71351,134781,5.317,15.360,159978,49101,110877,3.659,11.921,46154,3.439,23.841,3997,4029,34478
2004,721,43455,53955,1829618,1813986,5277,9.798,5081,9.434,230115,94325,135790,5.200,12.686,199406,76998,122408,4.245,10.993,30709,1.693,21.985,3419,3514,43974
2004,722,344058,468053,8904885,8772932,61185,13.207,51641,11.147,1640904,792843,848061,9.037,18.704,1384732,534365,850367,6.091,15.784,256172,2.920,31.568,37132,38156,338012
2004,811,191666,208458,1316098,1311572,20465,9.813,20647,9.900,222132,80275,141857,6.121,16.936,213292,81076,132216,6.182,16.262,8840,0.674,32.525,15864,16006,57891
2004,812,147227,184750,1341019,1323959,23316,12.740,19836,10.839,253700,112075,141625,8.465,19.162,220558,88171,132387,6.660,16.659,33142,2.503,33.318,14753,15096,57940
2004,813,277440,285842,2760937,2756191,14839,5.204,13480,4.727,298577,55606,242971,2.017,10.833,287076,64988,222088,2.358,10.416,11501,0.417,20.831,9019,9065,30731
2005,113,9541,9729,69500,71109,1107,11.314,1217,12.439,11360,3537,7823,4.974,15.975,14630,4811,9819,6.766,20.574,-3270,-4.599,31.951,891,894,3604
2005,114,1424,1438,7223,7418,223,15.369,249,17.161,1169,492,677,6.633,15.759,1536,670,866,9.032,20.706,-367,-4.947,31.518,166,166,470
2005,115,8194,8631,90440,89900,1217,14.252,1033,12.097,16984,5977,11007,6.649,18.892,15890,4687,11203,5.214,17.675,1094,1.217,35.351,720,720,3082
2005,211,5549,6636,83592,82787,634,9.623,539,8.181,15984,4482,11502,5.414,19.307,14466,5735,8731,6.927,17.474,1518,1.834,34.948,313,317,1395
2005,212,4001,6537,196447,192283,553,8.502,487,7.488,29353,11202,18151,5.826,15.266,21135,6897,14238,3.587,10.992,8218,4.274,21.983,283,285,3153
2005,213,7441,8892,213303,204699,1073,12.285,757,8.667,42435,9607,32828,4.693,20.730,24772,6620,18152,3.234,12.102,17663,8.629,24.203,457,482,3340
2005,221,6149,16733,632875,630265,1035,6.130,1335,7.907,62011,19691,42320,3.124,9.839,57465,22225,35240,3.526,9.118,4546,0.721,18.235,224,237,1026
2005,236,195200,197513,1602643,1586146,34823,17.991,26909,13.902,367507,131761,235746,8.307,23.170,334534,114539,219995,7.221,21.091,32973,2.079,42.182,18510,18514,76502
2005,237,41973,43986,911067,911963,4741,10.791,4641,10.563,168745,35569,133176,3.900,18.503,171393,42516,128877,4.662,18.794,-2648,-0.290,37.007,3186,3196,20889
2005,238,409046,414556,4274421,4217635,62056,15.221,48358,11.861,922750,282130,640620,6.689,21.878,807948,227377,580571,5.391,19.156,114802,2.722,38.313,34111,34142,166110
2005,311,20066,24304,1462079,1467048,1855,7.558,2332,9.502,127559,32717,94842,2.230,8.695,137179,43257,93922,2.949,9.351,-9620,-0.656,17.390,1692,1711,17621
2005,312,2558,3138,154408,154252,385,12.528,255,8.298,14357,3888,10469,2.521,9.308,14123,3540,10583,2.295,9.156,234,0.152,18.312,173,175,1549
2005,313,2702,3213,208932,215615,195,5.928,348,10.579,16854,3336,13518,1.547,7.817,30359,13325,17034,6.180,14.080,-13505,-6.263,15.633,241,246,4198
2005,314,6715,7025,171034,174208,513,7.203,708,9.940,18133,3813,14320,2.189,10.409,24207,8373,15834,4.806,13.895,-6074,-3.487,20.818,545,548,4673
2005,315,8650,8916,233115,241901,1295,14.049,1898,20.591,42681,13930,28751,5.759,17.644,59684,27517,32167,11.375,24.673,-17003,-7.029,35.288,1656,1659,20810
2005,316,1226,1280,38932,39771,118,9.119,146,11.283,3325,747,2578,1.878,8.360,4899,1455,3444,3.658,12.318,-1574,-3.958,16.721,115,115,766
2005,321,14026,15898,564859,554012,1283,8.047,1376,8.630,75211,19712,55499,3.558,13.576,53393,17758,35635,3.205,9.638,21818,3.938,19.275,1006,1022,10035
2005,322,3230,5149,457634,463374,204,3.911,338,6.480,28491,6507,21984,1.404,6.149,39849,14449,25400,3.118,8.600,-11358,-2.451,12.297,178,179,2918
2005,323,31114,32704,660966,668593,1979,5.977,2790,8.427,62001,14981,47020,2.241,9.273,77212,27706,49506,4.144,11.548,-15211,-2.275,18.547,2238,2254,15505
2005,324,1026,2248,99964,100023,168,7.493,156,6.958,9300,2054,7246,2.054,9.298,9346,4598,4748,4.597,9.344,-46,-0.046,18.596,40,40,357
2005,325,8961,12613,822542,823544,773,6.101,888,7.008,76157,14055,62102,1.707,9.247,77865,20823,57042,2.528,9.455,-1708,-0.207,18.495,472,479,5062
2005,326,11093,14179,896290,897265,661,4.624,893,6.247,86524,16312,70212,1.818,9.643,88397,25237,63160,2.813,9.852,-1873,-0.209,19.286,595,604,10755
2005,327,10541,16049,467393,466750,1157,7.256,950,5.958,55355,13134,42221,2.814,11.860,54111,13185,40926,2.825,11.593,1244,0.267,23.186,604,623,5735
2005,331,3908,4883,447914,445729,295,6.008,349,7.108,37185,8161,29024,1.831,8.343,33228,9158,24070,2.055,7.455,3957,0.888,14.910,234,238,3868
2005,332,52081,56124,1525795,1517958,3410,6.053,3842,6.819,180846,38344,142502,2.526,11.914,165017,52384,112633,3.451,10.871,15829,1.043,21.742,2780,2791,27859
2005,333,23072,25594,1121927,1112646,1415,5.499,1690,6.568,118253,26264,91989,2.360,10.628,98893,33355,65538,2.998,8.888,19360,1.740,17.776,1194,1201,12938
2005,334,12001,13793,1040663,1048382,894,6.408,1209,8.666,101529,16256,85273,1.551,9.684,115896,41608,74288,3.969,11.055,-14367,-1.370,19.369,817,828,12282
2005,335,5020,5942,428048,432431,402,6.751,427,7.171,37570,9108,28462,2.106,8.688,46011,14841,31170,3.432,10.640,-8441,-1.952,17.376,299,299,4168
2005,336,9882,12005,1639318,1631134,901,7.500,918,7.641,163466,30470,132996,1.868,10.022,148856,29863,118993,1.831,9.126,14610,0.896,18.252,650,656,11917
2005,337,19166,20013,551341,554676,1648,8.191,1863,9.259,64080,17343,46737,3.127,11.553,70749,23391,47358,4.217,12.755,-6669,-1.202,23.105,1419,1424,12009
2005,339,27803,29070,683149,684451,2255,7.723,2510,8.597,77192,19927,57265,2.911,11.278,79573,23563,56010,3.443,11.626,-2381,-0.348,22.556,1916,1925,13535
2005,423,171635,234032,3375751,3360745,19420,8.300,19308,8.252,459687,138317,321370,4.116,13.678,429964,142542,287422,4.241,12.794,29723,0.884,25.587,12689,13213,70983
2005,424,96979,124535,2302909,2311762,10865,8.702,11518,9.225,291168,95411,195757,4.127,12.595,308603,95728,212875,4.141,13.349,-17435,-0.754,25.190,8152,8317,47338
2005,425,37633,39658,297442,293544,5251,13.486,3807,9.778,53439,18800,34639,6.405,18.205,45202,14329,30873,4.881,15.399,8237,2.806,30.797,2756,2791,9849
2005,441,88953,119626,1945011,1947611,10400,8.729,9435,7.919,230709,88388,142321,4.538,11.846,235743,79809,155934,4.098,12.104,-5034,-0.258,23.691,7091,7259,56198
2005,442,44171,61225,570449,573937,6236,10.224,5772,9.463,87071,37213,49858,6.484,15.171,93476,27878,65598,4.857,16.287,-6405,-1.116,30.342,4150,4346,18103
2005,443,30068,50318,508337,503259,6821,13.705,5722,11.497,99745,36565,63180,7.266,19.820,86755,26478,60277,5.261,17.239,12990,2.581,34.477,3730,3943,15003
2005,444,59215,82691,1280426,1260795,5737,6.952,5408,6.553,157900,54571,103329,4.328,12.524,119599,32128,87471,2.548,9.486,38301,3.038,18.972,3782,3947,19610
2005,445,100307,133747,2893503,2907628,15940,11.905,16237,12.127,340562,149346,191216,5.136,11.713,367764,129625,238139,4.458,12.648,-27202,-0.936,23.425,11099,11316,57289
2005,446,40010,80058,1016315,1022565,6320,7.926,5680,7.123,132170,53139,79031,5.197,12.925,147141,30495,116646,2.982,14.389,-14971,-1.464,25.851,3252,3352,16879
2005,447,62988,111901,910518,924488,9473,8.439,10177,9.066,141730,56639,85091,6.127,15.331,168334,58680,109654,6.347,18.208,-26604,-2.878,30.661,6298,6848,37311
2005,448,59372,140796,1536788,1540605,13360,9.511,12695,9.038,242974,86383,156591,5.607,15.771,251832,78018,173814,5.064,16.346,-8858,-0.575,31.543,6100,6669,28919
2005,451,34326,49753,556308,554996,4887,9.783,5289,10.588,79129,32974,46155,5.941,14.258,76738,27462,49276,4.948,13.827,2391,0.431,27.654,3563,3786,15771
2005,452,9059,43033,2751225,2744188,3734,8.863,1926,4.572,220587,82837,137750,3.019,8.038,209704,20080,189624,0.732,7.642,10883,0.397,15.284,1248,1289,5125
2005,453,89635,114632,808159,812270,12640,10.994,13324,11.589,133570,53470,80100,6.583,16.444,141470,48559,92911,5.978,17.417,-7900,-0.973,32.888,10102,10513,34374
2005,454,40368,47471,538430,543579,5656,11.935,5497,11.599,86283,35478,50805,6.527,15.873,96081,39207,56874,7.213,17.676,-9798,-1.802,31.746,3892,3964,16999
2005,481,2537,5283,473523,473923,549,10.446,494,9.400,29249,6824,22425,1.440,6.172,29984,5559,24425,1.173,6.327,-735,-0.155,12.343,239,256,2015
2005,483,1224,1692,66730,66014,215,12.928,157,9.441,11302,3744,7558,5.672,17.121,10045,3811,6234,5.773,15.217,1257,1.904,30.433,108,108,3271
2005,484,86542,99683,1480488,1460042,15708,15.940,13436,13.634,234249,72154,162095,4.942,16.044,191877,66637,125240,4.564,13.142,42372,2.902,26.284,10061,10216,42382
2005,485,13192,15480,400439,399737,1948,12.608,1890,12.232,57823,25195,32628,6.303,14.465,56852,22321,34531,5.584,14.222,971,0.243,28.445,1446,1450,11964
2005,486,200,2605,36313,36744,176,6.793,148,5.712,4423,2247,2176,6.115,12.038,5306,1696,3610,4.616,14.441,-883,-2.403,24.075,20,21,162
2005,487,1756,1854,22235,22118,280,15.160,266,14.402,3357,1030,2327,4.657,15.178,3168,971,2197,4.390,14.323,189,0.855,28.646,187,187,665
2005,488,26006,33810,543640,536408,4342,13.039,3322,9.976,92261,35145,57116,6.552,17.200,77726,27628,50098,5.151,14.490,14535,2.710,28.980,2071,2129,11800
2005,492,6884,12608,547145,569093,1560,12.155,2012,15.677,66933,36627,30306,6.436,11.761,108307,17060,91247,2.998,19.032,-41374,-7.270,23.523,846,876,4495
2005,493,6733,13047,595745,592791,1102,8.458,1067,8.189,81697,28290,53407,4.772,13.782,76781,24113,52668,4.068,12.952,4916,0.829,25.905,392,401,4344
2005,511,20920,29315,1028774,1025963,2881,9.831,2862,9.766,121203,37260,83943,3.632,11.814,115865,43149,72716,4.206,11.293,5338,0.520,22.587,1715,1783,18346
2005,512,14603,18335,304144,304805,2632,14.429,2445,13.404,45189,20651,24538,6.775,14.826,46401,17679,28722,5.800,15.223,-1212,-0.398,29.651,1514,1527,7561
2005,515,4709,9543,284202,283866,826,8.592,967,10.059,32704,15768,16936,5.555,11.521,31882,13037,18845,4.593,11.231,822,0.290,22.463,397,427,5715
2005,517,11353,50138,1293908,1331970,6770,13.526,6601,13.188,194473,77841,116632,5.844,14.600,271021,89809,181212,6.743,20.347,-76548,-5.747,29.201,1838,2110,17282
2005,518,7321,14035,390762,389359,2045,14.892,1439,10.479,65487,26950,38537,6.922,16.819,63185,19224,43961,4.937,16.228,2302,0.591,32.456,659,676,6409
2005,519,4862,5896,104598,101783,773,13.383,533,9.228,18436,6540,11896,6.425,18.113,12566,3788,8778,3.722,12.346,5870,5.767,24.692,369,370,2252
2005,521,19,54,20090,20863,3,5.357,7,12.500,571,10,561,0.048,2.737,2194,403,1791,1.932,10.516,-1623,-7.780,5.474,D,D,D
2005,522,58709,203746,3175945,3169012,25479,12.654,20687,10.274,527664,210226,317438,6.634,16.651,513025,233494,279531,7.368,16.189,14639,0.462,32.378,5014,5457,33593
2005,523,44471,72161,841767,847607,12181,16.797,12899,17.787,201918,131804,70114,15.550,23.822,212103,119197,92906,14.063,25.024,-10185,-1.202,47.644,4082,4151,18432
2005,524,124309,164214,2327517,2355412,19977,12.303,16296,10.036,298153,124797,173356,5.298,12.658,351535,132368,219167,5.620,14.925,-53382,-2.266,25.316,7737,7946,37534
2005,525,773,815,6406,5613,196,24.685,154,19.395,3075,810,2265,14.431,54.784,1623,731,892,13.023,28.915,1452,25.869,57.830,112,114,551
2005,531,215293,250903,1489271,1470623,39421,16.130,26408,10.805,294880,152268,142612,10.354,20.051,258253,94702,163551,6.440,17.561,36627,2.491,35.122,17983,18606,62395
2005,532,26434,61282,620543,620077,7169,11.859,5514,9.121,102049,45888,56161,7.400,16.457,100209,30630,69579,4.940,16.161,1840,0.297,32.321,2898,3290,13849
2005,533,1924,1989,28632,28638,251,12.680,232,11.720,5747,1741,4006,6.079,20.068,5698,2811,2887,9.816,19.897,49,0.171,39.794,167,170,789
2005,541,627541,695694,7383262,7315756,90777,13.197,75102,10.918,1279561,443164,836397,6.058,17.490,1139553,397832,741721,5.438,15.577,140008,1.914,31.153,50619,51223,213133
2005,551,25901,47717,2836320,2839140,4662,9.871,3685,7.802,421067,140498,280569,4.949,14.831,427533,119272,308261,4.201,15.059,-6466,-0.228,29.662,1061,1102,16602
2005,561,253357,299904,8634593,8376962,43997,14.809,38363,12.913,2017127,624348,1392779,7.453,24.079,1501356,525436,975920,6.272,17.922,515771,6.157,35.845,25052,25440,304036
2005,562,14461,17948,335356,341485,1870,10.449,1766,9.868,50753,15338,35415,4.492,14.862,61915,28165,33750,8.248,18.131,-11162,-3.269,29.725,1007,1010,5918
2005,611,63651,71797,2880425,2850363,8752,12.403,6288,8.911,295619,96880,198739,3.399,10.371,235610,45370,190240,1.592,8.266,60009,2.105,16.532,4411,4457,26564
2005,621,415249,481779,5383401,5355626,42073,8.835,30950,6.499,764370,257474,506896,4.808,14.272,710911,191645,519266,3.578,13.274,53459,0.998,26.548,21888,22386,118344
2005,622,4143,6779,5258130,5235839,298,4.433,185,2.752,226394,42123,184271,0.805,4.324,181835,51438,130397,0.982,3.473,44559,0.851,6.946,86,88,11959
2005,623,32051,70018,2939295,2920614,6287,9.099,4447,6.436,324915,139550,185365,4.778,11.125,288063,112123,175940,3.839,9.863,36852,1.262,19.726,2262,2442,50124
2005,624,101826,138321,2330424,2293428,13356,9.741,10936,7.976,349146,106346,242800,4.637,15.224,275664,75564,200100,3.295,12.020,73482,3.204,24.039,7462,7650,47859
2005,711,29944,30719,417520,410249,5065,16.675,4378,14.413,90536,34589,55947,8.431,22.069,75696,21011,54685,5.122,18.451,14840,3.617,36.902,2827,2839,13393
2005,712,5931,6351,121108,120370,433,6.886,307,4.882,10742,1604,9138,1.333,8.924,9328,939,8389,0.780,7.749,1414,1.175,15.499,184,184,578
2005,713,53414,59864,1398792,1384902,7965,13.501,6230,10.560,206078,76036,130042,5.490,14.880,179153,54379,124774,3.927,12.936,26925,1.944,25.872,4712,4750,38031
2005,721,44051,54489,1838837,1839366,5684,10.448,5510,10.128,243005,107424,135581,5.840,13.211,243906,109398,134508,5.948,13.260,-901,-0.049,26.423,3649,3840,59854
2005,722,354172,482906,9193025,9055816,65824,13.817,52824,11.088,1725883,916629,809254,10.122,19.058,1458209,518916,939293,5.730,16.102,267674,2.956,32.205,40505,41451,366353
2005,811,191057,208166,1290120,1304163,21172,10.159,21650,10.388,211941,86759,125182,6.652,16.251,240130,80006,160124,6.135,18.413,-28189,-2.161,32.502,16381,16664,58482
2005,812,149041,186314,1323130,1330672,24005,12.960,21835,11.788,222428,102035,120393,7.668,16.715,237484,89324,148160,6.713,17.847,-15056,-1.131,33.431,15484,15846,59777
2005,813,278868,287432,2740691,2750834,14880,5.190,13425,4.683,282832,50945,231887,1.852,10.282,303493,51930,251563,1.888,11.033,-20661,-0.751,20.563,8691,8719,31114
2006,113,9383,9562,66265,67761,1057,10.985,1177,12.232,10909,3902,7007,5.759,16.099,13914,6173,7741,9.110,20.534,-3005,-4.435,32.199,873,873,3185
2006,114,1430,1443,7320,7193,293,20.569,256,17.971,1515,639,876,8.884,21.064,1253,515,738,7.160,17.421,262,3.643,34.842,159,159,326
2006,115,8171,8634,90616,90162,1279,14.929,1145,13.365,18184,6356,11828,7.050,20.168,17155,5789,11366,6.421,19.027,1029,1.141,38.054,866,866,4344
2006,211,5729,6860,91114,86955,778,11.532,551,8.167,19476,7956,11520,9.150,22.398,10938,4694,6244,5.398,12.579,8538,9.819,25.158,349,352,1434
2006,212,4098,6763,205008,200809,656,9.831,476,7.133,29251,8515,20736,4.240,14.567,20816,6810,14006,3.391,10.366,8435,4.201,20.732,272,279,2389
2006,213,8101,9652,254721,234774,1548,16.659,828,8.911,66608,25179,41429,10.725,28.371,26399,12416,13983,5.289,11.244,40209,17.127,22.489,497,511,4535
2006,221,6039,16675,618629,626020,1125,6.750,1106,6.636,52121,18924,33197,3.023,8.326,66565,14255,52310,2.277,10.633,-14444,-2.307,16.652,258,263,2700
2006,236,203272,205827,1714372,1650355,38591,19.239,28111,14.014,423069,145537,277532,8.819,25.635,295970,103023,192947,6.242,17.934,127099,7.701,35.867,20756,20821,74188
2006,237,43163,45329,989783,950995,5432,12.141,4256,9.513,210984,47723,163261,5.018,22.186,133940,34054,99886,3.581,14.084,77044,8.101,28.168,3029,3040,18380
2006,238,429965,436091,4657076,4470749,68046,15.969,48109,11.290,1091034,310436,780598,6.944,24.404,720212,214503,505709,4.798,16.109,370822,8.294,32.219,35818,35873,158562
2006,311,19840,24033,1454598,1457329,1911,7.908,2173,8.993,125436,28296,97140,1.942,8.607,131371,40677,90694,2.791,9.015,-5935,-0.407,17.215,1611,1629,16734
2006,312,2706,3291,155951,155492,398,12.422,224,6.991,13783,2681,11102,1.724,8.864,13017,2693,10324,1.732,8.372,766,0.493,16.743,158,158,1373
2006,313,2575,3039,190269,198731,190,6.095,347,11.131,15902,5479,10423,2.757,8.002,33261,13346,19915,6.716,16.737,-17359,-8.735,16.004,235,239,3228
2006,314,6502,6783,161397,165665,545,7.881,809,11.699,15575,3519,12056,2.124,9.402,24245,10197,14048,6.155,14.635,-8670,-5.233,18.803,657,659,4580
2006,315,8362,8589,205549,215933,1440,16.497,1720,19.704,33070,16485,16585,7.634,15.315,53648,24670,28978,11.425,24.845,-20578,-9.530,30.630,1517,1522,17309
2006,316,1203,1248,37035,38160,107,8.455,142,11.221,3739,880,2859,2.306,9.798,5941,3018,2923,7.909,15.569,-2202,-5.771,19.597,104,106,1025
2006,321,14106,16075,585932,575905,1431,8.935,1311,8.186,77200,22150,55050,3.846,13.405,56824,17673,39151,3.069,9.867,20376,3.538,19.734,1005,1014,9906
2006,322,3180,5032,442000,449290,222,4.361,338,6.640,26196,7909,18287,1.760,5.831,41234,16530,24704,3.679,9.178,-15038,-3.347,11.661,161,162,2990
2006,323,30402,32009,646552,654633,1990,6.129,2913,8.971,62085,18936,43149,2.893,9.484,78150,27834,50316,4.252,11.938,-16065,-2.454,18.968,2406,2411,16518
2006,324,1035,2270,100086,100449,193,8.593,145,6.456,8157,2504,5653,2.493,8.121,8986,3964,5022,3.946,8.946,-829,-0.825,16.241,47,47,812
2006,325,9097,12746,802569,804573,942,7.421,837,6.594,62199,14244,47955,1.770,7.731,66205,16275,49930,2.023,8.229,-4006,-0.498,15.461,489,491,6100
2006,326,11001,14118,894413,895740,747,5.269,867,6.115,79950,19911,60039,2.223,8.926,82720,24004,58716,2.680,9.235,-2770,-0.309,17.851,572,580,9064
2006,327,10655,16650,484090,476473,1571,9.584,1055,6.436,66364,20927,45437,4.392,13.928,50719,13268,37451,2.785,10.645,15645,3.284,21.289,644,661,5940
2006,331,3777,4745,444661,445292,262,5.508,285,5.992,29436,5909,23527,1.327,6.611,30956,8979,21977,2.016,6.952,-1520,-0.341,13.221,193,194,2350
2006,332,52585,56642,1567112,1547239,3695,6.533,3529,6.240,182246,40135,142111,2.594,11.779,142412,41621,100791,2.690,9.204,39834,2.575,18.409,2642,2663,21279
2006,333,22845,25317,1138761,1129033,1422,5.592,1646,6.473,113229,20308,92921,1.799,10.029,92792,32663,60129,2.893,8.219,20437,1.810,16.437,1178,1184,11831
2006,334,11950,13777,1050496,1046881,1033,7.505,1007,7.316,119481,27936,91545,2.668,11.413,111781,29777,82004,2.844,10.678,7700,0.736,21.355,687,692,9255
2006,335,4997,5901,420211,422587,367,6.204,397,6.711,34468,7563,26905,1.790,8.156,39216,11833,27383,2.800,9.280,-4748,-1.124,16.313,253,253,3278
2006,336,9973,12176,1622617,1623949,1030,8.499,915,7.550,167464,34632,132832,2.133,10.312,170227,39678,130549,2.443,10.482,-2763,-0.170,20.624,657,672,14837
2006,337,19353,20156,546974,549503,1727,8.556,1784,8.838,59694,13273,46421,2.415,10.863,63996,22919,41077,4.171,11.646,-4302,-0.783,21.727,1383,1393,10385
2006,339,27987,29305,687424,682953,2546,8.706,2423,8.286,79773,20267,59506,2.968,11.681,70948,19724,51224,2.888,10.388,8825,1.292,20.777,1905,1913,13269
2006,423,172172,237333,3464908,3421411,21764,9.231,18617,7.897,500339,168596,331743,4.928,14.624,413237,145270,267967,4.246,12.078,87102,2.546,24.156,11691,12217,68321
2006,424,96035,124277,2281345,2291959,11740,9.444,11804,9.496,301542,97147,204395,4.239,13.157,322555,101722,220833,4.438,14.073,-21013,-0.917,26.313,8227,8380,50927
2006,425,38741,40835,298212,298874,5663,13.986,4973,12.282,46448,16653,29795,5.572,15.541,48692,22379,26313,7.488,16.292,-2244,-0.751,31.082,3876,3901,15259
2006,441,88436,120366,1942103,1942189,10413,8.689,9356,7.807,225219,89980,135239,4.633,11.596,224857,64613,160244,3.327,11.578,362,0.019,23.155,7202,7372,46824
2006,442,43708,61162,574285,572952,6361,10.403,6327,10.348,90424,38833,51591,6.778,15.782,88349,29126,59223,5.084,15.420,2075,0.362,30.840,4443,4687,18702
2006,443,29049,49149,510952,509543,5286,10.660,6163,12.429,89090,28071,61019,5.509,17.484,85725,39208,46517,7.695,16.824,3365,0.660,33.648,4075,4217,19145
2006,444,58982,84158,1385766,1331767,6976,8.381,5131,6.164,225529,117680,107849,8.836,16.935,120083,30938,89145,2.323,9.017,105446,7.918,18.034,3730,3814,17815
2006,445,99284,132715,2881638,2892382,15489,11.683,15212,11.474,336064,137354,198710,4.749,11.619,358806,123061,235745,4.255,12.405,-22742,-0.786,23.238,11257,11413,57149
2006,446,40087,83114,1088597,1054334,8664,10.609,5775,7.071,183876,86395,97481,8.194,17.440,117296,34868,82428,3.307,11.125,66580,6.315,22.250,3342,3537,16281
2006,447,63583,112750,919986,917763,10779,9.567,10607,9.415,160489,68998,91491,7.518,17.487,155804,59055,96749,6.435,16.977,4685,0.510,33.953,6704,7130,36843
2006,448,59561,142505,1618615,1576820,14898,10.536,12683,8.970,294833,113129,181704,7.175,18.698,212688,62289,150399,3.950,13.488,82145,5.210,26.977,6478,7485,25982
2006,451,33709,49681,579256,567751,5291,10.649,5302,10.671,100630,48933,51697,8.619,17.724,75918,27796,48122,4.896,13.372,24712,4.353,26.743,3954,4062,14958
2006,452,8767,44073,2887154,2820416,3603,8.273,2555,5.867,284586,111776,172810,3.963,10.090,151948,21818,130130,0.774,5.387,132638,4.703,10.775,1547,1655,7979
2006,453,87327,112725,806097,807348,12597,11.087,14376,12.653,135980,54808,81172,6.789,16.843,138084,51049,87035,6.323,17.103,-2104,-0.261,33.686,11137,11427,36463
2006,454,40698,47672,548267,543364,5790,12.193,5418,11.410,89621,33023,56598,6.078,16.494,79381,30303,49078,5.577,14.609,10240,1.885,29.218,4068,4120,17274
2006,481,2481,5180,465154,469467,559,10.762,587,11.302,40619,10281,30338,2.190,8.652,50536,14522,36014,3.093,10.765,-9917,-2.112,17.304,258,260,2733
2006,483,1225,1671,72597,69338,180,10.769,181,10.829,12639,3119,9520,4.498,18.228,6147,1577,4570,2.274,8.865,6492,9.363,17.731,96,97,742
2006,484,89557,103155,1529723,1505797,17523,17.267,14184,13.976,247958,90308,157650,5.997,16.467,199955,72250,127705,4.798,13.279,48003,3.188,26.558,10862,11003,44924
2006,485,13164,15555,417801,410706,2092,13.483,2014,12.980,64742,29456,35286,7.172,15.764,50629,20631,29998,5.023,12.327,14113,3.436,24.655,1545,1587,12830
2006,486,199,2524,35742,36466,386,14.984,490,19.022,7096,4320,2776,11.847,19.459,8662,5931,2731,16.265,23.754,-1566,-4.294,38.919,17,17,354
2006,487,1815,1917,22519,22333,329,17.412,274,14.501,3912,1238,2674,5.543,17.517,3481,976,2505,4.370,15.587,431,1.930,31.174,190,192,612
2006,488,26920,35503,585827,566894,5051,14.552,3464,9.980,114942,48493,66449,8.554,20.276,76299,26906,49393,4.746,13.459,38643,6.817,26.918,2223,2308,13597
2006,492,6855,12575,571863,560159,1558,12.384,1569,12.472,62498,12874,49624,2.298,11.157,39477,16985,22492,3.032,7.047,23021,4.110,14.095,884,905,6169
2006,493,6805,13431,629454,619168,1364,10.234,1157,8.681,116046,52570,63476,8.490,18.742,96560,26411,70149,4.266,15.595,19486,3.147,31.190,392,415,5248
2006,511,20867,29829,1038088,1033382,3237,10.921,2861,9.652,125496,44250,81246,4.282,12.144,116886,41828,75058,4.048,11.311,8610,0.833,22.622,1732,1776,16083
2006,512,15212,18926,336042,327709,3077,16.528,2458,13.203,67848,27355,40493,8.347,20.704,50894,18612,32282,5.679,15.530,16954,5.173,31.060,1512,1531,6278
2006,515,4660,10105,299763,292692,1281,13.028,737,7.495,49260,19206,30054,6.562,16.830,34862,10178,24684,3.477,11.911,14398,4.919,23.822,364,380,3271
2006,517,10652,49599,1240812,1268358,7039,14.151,7325,14.726,190461,83516,106945,6.585,15.016,250058,73892,176166,5.826,19.715,-59597,-4.699,30.033,1696,1906,18559
2006,518,7407,15362,405569,396306,2703,18.416,1334,9.089,73417,26909,46508,6.790,18.525,55655,17134,38521,4.323,14.043,17762,4.482,28.087,712,727,6465
2006,519,5120,6417,118707,111515,1148,18.633,636,10.323,26695,8529,18166,7.648,23.939,12401,4983,7418,4.468,11.121,14294,12.818,22.241,418,423,1885
2006,521,21,55,19859,19971,5,9.346,D,D,1155,43,1112,0.215,5.784,1386,D,1373,D,6.940,-231,-1.157,11.567,D,D,D
2006,522,60232,214465,3271305,3220263,31528,15.088,20523,9.821,664456,300029,364427,9.317,20.634,567019,240440,326579,7.466,17.608,97437,3.026,35.216,5547,5854,31812
2006,523,45905,76892,904058,872037,14149,19.030,9067,12.195,188981,96920,92061,11.114,21.671,122905,53063,69842,6.085,14.094,66076,7.577,28.188,4509,4559,16811
2006,524,126500,168313,2376851,2353053,18212,10.955,14078,8.468,324518,133009,191509,5.653,13.791,273998,94003,179995,3.995,11.644,50520,2.147,23.289,8222,8343,27913
2006,525,632,663,6440,6300,145,20.700,220,31.406,1729,1101,628,17.476,27.444,1429,919,510,14.587,22.683,300,4.762,45.365,181,182,699
2006,531,224177,264126,1553228,1519925,44540,17.304,31095,12.080,316822,155381,161441,10.223,20.845,250048,108461,141587,7.136,16.451,66774,4.393,32.903,22215,22431,70928
2006,532,25791,62139,617762,618015,6731,10.918,5749,9.326,99000,34244,64756,5.541,16.019,98763,34014,64749,5.504,15.981,237,0.038,31.961,3042,3306,14515
2006,533,1910,1987,29077,28533,268,13.639,224,11.399,5107,2159,2948,7.567,17.899,4178,1298,2880,4.549,14.643,929,3.256,29.285,165,166,804
2006,541,647549,722275,7785599,7587237,104216,14.696,78000,10.999,1479325,512963,966362,6.761,19.498,1083644,394825,688819,5.204,14.282,395681,5.215,28.565,53725,54203,216240
2006,551,26249,49228,2917518,2917628,5477,11.258,4318,8.876,483322,149498,333824,5.124,16.566,486133,125251,360882,4.293,16.662,-2811,-0.096,33.131,1091,1125,13906
2006,561,261468,313292,9326957,8994133,51102,16.655,38161,12.438,2206216,687289,1518927,7.642,24.530,1546105,508260,1037845,5.651,17.190,660111,7.339,34.380,26170,26476,266115
2006,562,15105,18881,348670,344313,2158,11.625,1524,8.209,55215,20102,35113,5.838,16.036,46178,15354,30824,4.459,13.412,9037,2.625,26.823,1049,1070,8436
2006,611,65727,74946,2980168,2931672,9687,13.184,6741,9.175,312346,84003,228343,2.865,10.654,215097,43329,171768,1.478,7.337,97249,3.317,14.674,4969,5050,31910
2006,621,422905,495307,5638446,5515614,46049,9.422,32946,6.741,887236,323837,563399,5.871,16.086,639585,204080,435505,3.700,11.596,247651,4.490,23.192,23160,23708,117583
2006,622,3776,6536,5352331,5312153,270,4.151,206,3.167,236642,44582,192060,0.839,4.455,156044,44276,111768,0.833,2.937,80598,1.517,5.875,102,102,17809
2006,623,32583,71943,2992908,2967782,6501,9.151,4694,6.608,338799,140959,197840,4.750,11.416,288360,106268,182092,3.581,9.716,50439,1.700,19.433,2221,2368,53646
2006,624,103357,143758,2442288,2385093,17144,12.150,11840,8.391,406183,157245,248938,6.593,17.030,289833,81350,208483,3.411,12.152,116350,4.878,24.304,8165,8360,50048
2006,711,31095,31900,427836,419893,5713,18.242,4547,14.519,80838,25210,55628,6.004,19.252,64883,19446,45437,4.631,15.452,15955,3.800,30.905,3038,3041,13513
2006,712,5994,6471,123099,122266,524,8.175,401,6.256,11774,2241,9533,1.833,9.630,10073,1300,8773,1.063,8.239,1701,1.391,16.477,238,239,617
2006,713,54381,61227,1430595,1416265,8402,13.882,6997,11.561,210777,80819,129958,5.706,14.883,182052,59999,122053,4.236,12.854,28725,2.028,25.709,5485,5532,44262
2006,721,44683,55179,1878076,1863070,6441,11.729,5917,10.774,271673,121959,149714,6.546,14.582,242626,103637,138989,5.563,13.023,29047,1.559,26.046,4107,4179,55891
2006,722,363209,497919,9542180,9372565,68792,14.017,54472,11.100,1779107,928578,850529,9.907,18.982,1439411,521656,917755,5.566,15.358,339696,3.624,30.715,42508,43454,370910
2006,811,190022,207433,1301173,1296569,21468,10.326,22405,10.777,225283,87468,137815,6.746,17.375,216183,83191,132992,6.416,16.673,9100,0.702,33.347,17083,17432,58271
2006,812,149715,187041,1343378,1332592,24268,13.017,23045,12.361,233115,110334,122781,8.280,17.493,211392,92227,119165,6.921,15.863,21723,1.630,31.726,16863,17309,63745
2006,813,275290,284254,2773689,2755366,16242,5.684,19219,6.726,310407,56662,253745,2.056,11.266,273865,56612,217253,2.055,9.939,36542,1.326,19.879,11981,12025,34982
2007,113,9138,9326,63909,65170,953,10.087,1197,12.669,9921,3782,6139,5.803,15.223,12319,4152,8167,6.371,18.903,-2398,-3.680,30.447,911,912,3258
2007,114,1463,1472,7084,7222,279,19.110,255,17.466,1234,581,653,8.045,17.087,1528,681,847,9.430,21.158,-294,-4.071,34.173,164,164,327
2007,115,8374,8850,97252,96688,1149,13.048,1061,12.049,18379,6806,11573,7.039,19.009,17084,6053,11031,6.260,17.669,1295,1.339,35.339,747,749,4209
2007,211,5818,6964,142194,115357,876,12.785,652,9.515,66849,12233,54616,10.605,57.950,13236,7797,5439,6.759,11.474,53613,46.476,22.948,355,357,2006
2007,212,4045,6599,216452,208375,603,9.150,586,8.892,42882,11441,31441,5.491,20.579,26743,6839,19904,3.282,12.834,16139,7.745,25.668,286,289,3274
2007,213,8823,10620,348844,302000,1903,18.867,836,8.288,126107,36135,89972,11.965,41.757,32025,14792,17233,4.898,10.604,94082,31.153,21.209,519,531,5694
2007,221,5457,16201,645266,635759,1031,6.358,1063,6.555,69884,16890,52994,2.657,10.992,51119,13853,37266,2.179,8.041,18765,2.952,16.081,240,252,1611
2007,236,202130,204773,1641726,1662975,33999,16.659,32631,15.989,335379,118459,216920,7.123,20.167,378876,123322,255554,7.416,22.783,-43497,-2.616,40.335,24567,24576,84247
2007,237,42483,44556,1013189,992021,4543,10.177,4713,10.558,201675,38201,163474,3.851,20.330,159847,40161,119686,4.048,16.113,41828,4.216,32.227,3322,3334,23352
2007,238,441654,448136,4662092,4708972,59808,13.424,54593,12.254,887863,243080,644783,5.162,18.855,983438,243173,740265,5.164,20.884,-95575,-2.030,37.709,40939,40973,179956
2007,311,20027,24293,1442080,1452581,1771,7.249,2050,8.390,136363,32400,103963,2.231,9.388,156998,47818,109180,3.292,10.808,-20635,-1.421,18.775,1455,1479,15897
2007,312,2858,3457,155356,154878,398,11.775,244,7.219,15522,4197,11325,2.710,10.022,14986,4447,10539,2.871,9.676,536,0.346,19.352,157,157,1831
2007,313,2394,2800,163996,176870,158,5.445,362,12.474,11666,3461,8205,1.957,6.596,37339,17949,19390,10.148,21.111,-25673,-14.515,13.192,242,244,5310
2007,314,6027,6287,146408,150359,431,6.693,736,11.429,14342,4276,10066,2.844,9.539,22464,6850,15614,4.556,14.940,-8122,-5.402,19.077,590,597,4480
2007,315,7537,7711,174134,181414,1073,13.519,1525,19.214,27272,11467,15805,6.321,15.033,41650,21464,20186,11.832,22.959,-14378,-7.926,30.066,1332,1337,15635
2007,316,1185,1227,33840,35160,106,8.566,127,10.263,2854,672,2182,1.911,8.117,5460,1978,3482,5.626,15.529,-2606,-7.412,16.234,99,99,832
2007,321,14180,16214,536969,563561,1273,7.826,1379,8.477,44398,15220,29178,2.701,7.878,97734,25613,72121,4.545,17.342,-53336,-9.464,15.756,996,1029,14219
2007,322,3127,4871,419979,427890,168,3.400,308,6.234,24638,5708,18930,1.334,5.758,40148,14728,25420,3.442,9.383,-15510,-3.625,11.516,138,141,3143
2007,323,30490,32115,646571,655298,1919,5.895,2795,8.586,60905,19197,41708,2.930,9.294,78354,29447,48907,4.494,11.957,-17449,-2.663,18.588,2213,2225,14925
2007,324,1054,2229,101386,100495,160,7.162,170,7.610,9419,2562,6857,2.549,9.373,7854,1822,6032,1.813,7.815,1565,1.557,15.631,51,59,684
2007,325,9473,13220,804907,812771,904,6.843,887,6.714,75897,20002,55895,2.461,9.338,92025,21295,70730,2.620,11.322,-16128,-1.984,18.676,496,501,7566
2007,326,10855,13870,850205,870318,668,4.769,940,6.711,66198,12270,53928,1.410,7.606,106869,30903,75966,3.551,12.279,-40671,-4.673,15.212,583,592,11544
2007,327,10697,16791,476543,482266,1076,6.395,1147,6.817,50049,12364,37685,2.564,10.378,61650,15218,46432,3.156,12.783,-11601,-2.406,20.756,692,709,7076
2007,331,3656,4630,436472,443486,233,4.984,322,6.888,28768,5198,23570,1.172,6.487,43242,13464,29778,3.036,9.750,-14474,-3.264,12.974,223,225,6120
2007,332,53955,58043,1593314,1592739,3690,6.360,3646,6.284,172978,37531,135447,2.356,10.860,171922,48034,123888,3.016,10.794,1056,0.066,21.588,2665,2671,24871
2007,333,22837,25289,1145138,1141056,1319,5.190,1569,6.174,108915,19025,89890,1.667,9.545,100733,28729,72004,2.518,8.828,8182,0.717,17.656,1103,1110,14292
2007,334,11968,13769,1057359,1057143,945,6.816,1136,8.194,104264,19190,85074,1.815,9.863,104292,38139,66153,3.608,9.865,-28,-0.003,19.726,718,724,10223
2007,335,5084,5985,416334,421250,314,5.209,400,6.636,33432,4051,29381,0.962,7.936,43607,17992,25615,4.271,10.352,-10175,-2.415,15.873,239,239,4914
2007,336,10206,12388,1591428,1610536,939,7.559,1006,8.099,141043,33323,107720,2.069,8.758,180867,47440,133427,2.946,11.230,-39824,-2.473,17.515,657,662,12301
2007,337,19304,20117,514449,527786,1642,8.122,1841,9.106,50104,12962,37142,2.456,9.493,76778,21471,55307,4.068,14.547,-26674,-5.054,18.987,1430,1434,11640
2007,339,28023,29324,659231,658797,2785,9.545,2494,8.547,75588,19915,55673,3.023,11.474,74688,25811,48877,3.918,11.337,900,0.137,22.674,1911,1921,13043
2007,423,171382,237945,3538466,3539762,20036,8.429,19538,8.220,514922,152765,362157,4.316,14.547,516883,174895,341988,4.941,14.602,-1961,-0.055,29.094,11462,11837,69447
2007,424,94895,124057,2295879,2308699,11326,9.101,12101,9.724,317461,98732,218729,4.277,13.751,343754,119721,224033,5.186,14.890,-26293,-1.139,27.501,7567,7768,47606
2007,425,37256,39329,277897,282841,4985,12.546,5795,14.584,50500,22065,28435,7.801,17.855,61587,29140,32447,10.303,21.774,-11087,-3.920,35.709,4297,4327,14696
2007,441,86660,119283,1918339,1923406,9761,8.166,10267,8.589,235307,80269,155038,4.173,12.234,246265,94953,151312,4.937,12.804,-10958,-0.570,24.468,7413,7573,67534
2007,442,42601,61024,585273,576544,6982,11.462,6767,11.109,118151,49187,68964,8.531,20.493,101974,35508,66466,6.159,17.687,16177,2.806,35.374,4359,4860,22510
2007,443,27715,50646,500686,500943,8656,17.469,6464,13.045,97763,51466,46297,10.274,19.516,96179,39566,56613,7.898,19.200,1584,0.316,38.399,3848,4118,20927
2007,444,59603,86118,1359948,1365512,6865,8.026,5701,6.665,151566,69471,82095,5.088,11.100,163773,35478,128295,2.598,11.994,-12207,-0.894,22.199,3761,3905,20042
2007,445,97404,130704,2822697,2836611,15810,12.135,14972,11.492,345314,140386,204928,4.949,12.173,375317,127305,248012,4.488,13.231,-30003,-1.058,24.347,10846,10967,57092
2007,446,40055,84070,1021198,1046184,8100,9.718,6662,7.993,150046,60251,89795,5.759,14.342,198512,47446,151066,4.535,18.975,-48466,-4.633,28.684,3269,3378,15538
2007,447,62225,110666,898950,910431,10065,9.048,11201,10.070,151975,65033,86942,7.143,16.693,175837,64317,111520,7.064,19.314,-23862,-2.621,33.385,6603,7054,35552
2007,448,59182,145784,1640326,1628264,16142,11.196,12936,8.972,328634,127195,201439,7.812,20.183,299842,74845,224997,4.597,18.415,28792,1.768,36.830,6434,6796,25153
2007,451,32813,48651,586760,580613,5234,10.714,5634,11.533,104531,42802,61729,7.372,18.004,91911,29997,61914,5.166,15.830,12620,2.174,31.660,3609,3821,14840
2007,452,7867,44419,2883634,2881571,3666,8.332,2827,6.425,256467,88017,168450,3.054,8.900,253787,43097,210690,1.496,8.807,2680,0.093,17.614,1527,1557,5657
2007,453,85334,110077,787975,792018,12447,11.190,14751,13.262,142615,56861,85754,7.179,18.007,148351,56958,91393,7.192,18.731,-5736,-0.724,36.013,10257,10528,34616
2007,454,45325,53040,605871,601455,6536,12.505,4993,9.553,101594,37081,64513,6.165,16.891,92898,30782,62116,5.118,15.446,8696,1.446,30.891,3601,3637,16612
2007,481,2527,5240,479549,474721,655,12.622,554,10.675,67186,12215,54971,2.573,14.153,57536,20677,36859,4.356,12.120,9650,2.033,24.240,234,237,1453
2007,483,1154,1538,74551,73862,173,11.161,197,12.710,11148,2990,8158,4.048,15.093,9331,3247,6084,4.396,12.633,1817,2.460,25.266,102,103,1378
2007,484,90211,103805,1474242,1475623,16433,15.936,15063,14.607,242581,74827,167754,5.071,16.439,247000,87213,159787,5.910,16.739,-4419,-0.299,32.878,11396,11498,48199
2007,485,13311,16026,440352,430113,2276,14.395,1845,11.669,74371,31131,43240,7.238,17.291,53059,21355,31704,4.965,12.336,21312,4.955,24.672,1341,1351,10591
2007,486,187,2486,35662,34816,273,11.193,179,7.339,6310,1847,4463,5.305,18.124,4670,1985,2685,5.701,13.413,1640,4.710,26.827,13,29,658
2007,487,1787,1885,22137,21936,325,17.492,271,14.586,4274,1590,2684,7.248,19.484,3878,1327,2551,6.049,17.679,396,1.805,35.357,203,203,842
2007,488,28834,38665,618936,605343,5352,14.121,3822,10.084,115630,48536,67094,8.018,19.102,88337,31782,56555,5.250,14.593,27293,4.509,29.186,2201,2222,11429
2007,492,6491,11945,561399,562733,1537,12.814,1636,13.640,54175,23370,30805,4.153,9.627,57376,18331,39045,3.257,10.196,-3201,-0.569,19.254,815,838,4098
2007,493,6721,13612,731729,723652,1183,8.656,1293,9.461,116569,35619,80950,4.922,16.108,99722,31002,68720,4.284,13.780,16847,2.328,27.561,345,363,3638
2007,511,20206,28841,1063105,1067066,2666,9.124,3425,11.721,133882,34963,98919,3.277,12.547,143102,47222,95880,4.425,13.411,-9220,-0.864,25.093,1662,1717,17285
2007,512,15456,19025,343643,342346,2884,15.275,2596,13.749,58808,16750,42058,4.893,17.178,56728,21808,34920,6.370,16.570,2080,0.608,33.141,1655,1674,13971
2007,515,4614,9835,293621,297834,1022,10.197,1398,13.948,41374,15727,25647,5.280,13.892,51192,13748,37444,4.616,17.188,-9818,-3.296,27.783,329,339,3508
2007,517,9483,49665,1246350,1238469,7893,16.012,7152,14.509,239199,115864,123335,9.355,19.314,220264,112370,107894,9.073,17.785,18935,1.529,35.570,1617,1759,10765
2007,518,8098,14576,409865,413221,1876,12.288,3259,21.346,91895,31022,60873,7.507,22.239,98603,40675,57928,9.843,23.862,-6708,-1.623,44.477,644,665,6271
2007,519,5201,6505,122036,119083,1005,15.862,667,10.527,20983,5704,15279,4.790,17.621,15137,4218,10919,3.542,12.711,5846,4.909,25.423,459,461,2256
2007,521,13,48,19519,19743,D,D,6,12.000,820,D,801,D,4.153,1218,75,1143,0.380,6.169,-398,-2.016,8.307,5,5,43
2007,522,58937,221483,3266009,3283950,29344,13.444,22913,10.498,563238,233520,329718,7.111,17.151,597055,228401,368654,6.955,18.181,-33817,-1.030,34.302,7046,7853,56911
2007,523,48822,79475,923084,921977,13060,16.564,11805,14.972,188795,73105,115690,7.929,20.477,188568,80338,108230,8.714,20.453,227,0.025,40.905,4382,4452,16664
2007,524,127432,169739,2382507,2392464,18268,10.815,16620,9.839,355872,138651,217221,5.795,14.875,375763,143645,232118,6.004,15.706,-19891,-0.831,29.749,8351,8494,31543
2007,525,443,457,6886,6155,149,32.009,166,35.661,2849,2007,842,32.608,46.288,1459,735,724,11.942,23.704,1390,22.583,47.409,140,141,616
2007,531,224977,267782,1537102,1544929,41023,15.427,37284,14.021,306516,143365,163151,9.280,19.840,323688,131904,191784,8.538,20.952,-17172,-1.112,39.680,25491,25747,79087
2007,532,24912,61062,620754,616481,5391,8.756,6402,10.398,107996,28677,79319,4.652,17.518,99724,39354,60370,6.384,16.176,8272,1.342,32.353,2761,2948,14009
2007,533,1928,2023,29736,29144,294,14.656,260,12.961,7428,3797,3631,13.029,25.488,6388,2493,3895,8.554,21.919,1040,3.569,43.838,178,178,799
2007,541,656038,731500,7738660,7695483,96029,13.264,81007,11.189,1371442,453728,917714,5.896,17.821,1290623,462562,828061,6.011,16.771,80819,1.050,33.542,54913,55330,231025
2007,551,26438,50097,2855677,2834537,5872,11.765,5501,11.022,572430,179093,393337,6.318,20.195,525464,203021,322443,7.162,18.538,46966,1.657,37.076,870,904,11324
2007,561,264917,317168,9385767,9364079,46181,14.682,40921,13.010,1900568,584477,1316091,6.242,20.296,1861610,566153,1295457,6.046,19.880,38958,0.416,39.761,26392,26695,302184
2007,562,15912,20103,374953,370661,2518,12.768,1754,8.894,79120,36829,42291,9.936,21.346,71251,24751,46500,6.678,19.223,7869,2.123,38.445,1063,1069,7936
2007,611,68281,77854,3040446,3009506,8997,11.725,6757,8.806,285682,71506,214176,2.376,9.493,225057,49619,175438,1.649,7.478,60625,2.014,14.956,4743,4791,28127
2007,621,429855,506970,5669641,5603577,46483,9.270,35413,7.062,889093,314467,574626,5.612,15.867,757951,241022,516929,4.301,13.526,131142,2.340,27.052,23318,23945,122053
2007,622,3639,6446,5494032,5438028,138,2.134,178,2.753,349715,42242,307473,0.777,6.431,235935,51575,184360,0.948,4.339,113780,2.092,8.677,87,89,18698
2007,623,32616,73334,3065474,3040174,6683,9.177,5660,7.772,368630,152162,216468,5.005,12.125,319402,130276,189126,4.285,10.506,49228,1.619,21.012,2403,2561,69353
2007,624,103500,143641,2523639,2499474,14359,10.036,13216,9.237,383746,110117,273629,4.406,15.353,336880,105415,231465,4.217,13.478,46866,1.875,26.956,7726,7925,48080
2007,711,31849,32683,431558,427803,5381,16.637,4704,14.543,82468,27267,55201,6.374,19.277,75234,22904,52330,5.354,17.586,7234,1.691,35.172,3154,3159,14451
2007,712,6128,6613,128450,126025,432,6.578,341,5.192,13268,1851,11417,1.469,10.528,8479,1576,6903,1.251,6.728,4789,3.800,13.456,194,196,915
2007,713,54511,61914,1470097,1463876,8111,13.183,7335,11.922,213501,73647,139854,5.031,14.585,201676,64326,137350,4.394,13.777,11825,0.808,27.554,5651,5696,43769
2007,721,45101,55555,1935626,1927215,6338,11.447,5963,10.770,281471,125130,156341,6.493,14.605,264184,128468,135716,6.666,13.708,17287,0.897,27.416,3902,3946,58076
2007,722,370196,512902,9675883,9618686,72006,14.233,58018,11.468,1806513,933155,873358,9.701,18.781,1683572,581056,1102516,6.041,17.503,122941,1.278,35.006,42856,43789,384013
2007,811,187201,204163,1268535,1270696,20184,9.851,21664,10.573,222525,87527,134998,6.888,17.512,225586,82873,142713,6.522,17.753,-3061,-0.241,35.024,15899,16199,55719
2007,812,150329,187969,1335769,1334267,25162,13.455,23233,12.424,253461,110691,142770,8.296,18.996,250898,100640,150258,7.543,18.804,2563,0.192,37.608,16001,16285,59804
2007,813,277611,286264,2764896,2756476,16458,5.771,14293,5.012,305911,57358,248553,2.081,11.098,288277,51434,236843,1.866,10.458,17634,0.640,20.916,9036,9051,31567
2008,113,8558,8729,60908,62402,722,8.009,1294,14.354,9175,2452,6723,3.929,14.703,12250,4369,7881,7.001,19.631,-3075,-4.928,29.406,941,942,3308
2008,114,1394,1400,7231,7182,209,14.529,286,19.882,1291,505,786,7.032,17.977,1191,503,688,7.004,16.584,100,1.392,33.169,162,162,263
2008,115,8293,8829,95123,95267,1058,11.943,1118,12.620,16344,4695,11649,4.928,17.156,16751,5846,10905,6.136,17.583,-407,-0.427,34.312,779,781,4543
2008,211,5742,6993,101602,121488,781,11.319,595,8.623,17930,6847,11083,5.636,14.759,57341,9610,47731,7.910,47.199,-39411,-32.440,29.517,373,373,3342
2008,212,3889,6414,202091,209497,398,6.127,561,8.637,25985,5393,20592,2.574,12.404,40596,6029,34567,2.878,19.378,-14611,-6.974,24.807,328,332,2873
2008,213,9013,11042,317959,331644,1562,14.486,1044,9.682,59798,17758,42040,5.355,18.031,88011,16089,71922,4.851,26.538,-28213,-8.507,36.062,707,710,7590
2008,221,5416,16379,636236,638340,1319,8.101,1123,6.898,65445,23604,41841,3.698,10.252,69468,18885,50583,2.958,10.883,-4023,-0.630,20.505,221,224,1435
2008,236,194128,196847,1538942,1588243,28625,14.229,37284,18.533,300192,100266,199926,6.313,18.901,399555,130603,268952,8.223,25.157,-99363,-6.256,37.802,27928,27943,91654
2008,237,40907,43106,996203,1002912,3541,8.061,5186,11.806,166342,31591,134751,3.150,16.586,180314,37759,142555,3.765,17.979,-13972,-1.393,33.172,3810,3811,19513
2008,238,425942,432608,4470080,4568940,48884,11.099,64560,14.658,808490,201328,607162,4.406,17.695,1005206,249639,755567,5.464,22.001,-196716,-4.306,35.391,48046,48069,187822
2008,311,19323,23477,1443066,1437181,1676,7.113,1847,7.839,131068,26445,104623,1.840,9.120,119436,32908,86528,2.290,8.310,11632,0.809,16.621,1383,1389,17445
2008,312,3029,3626,154254,154012,474,13.430,281,7.961,16908,5577,11331,3.621,10.978,16258,3958,12300,2.570,10.556,650,0.422,21.113,194,199,1698
2008,313,2288,2639,146208,154138,162,5.988,295,10.904,11157,2338,8819,1.517,7.238,27082,12872,14210,8.351,17.570,-15925,-10.332,14.477,203,211,4991
2008,314,6012,6278,141249,144870,508,8.062,555,8.807,15228,4752,10476,3.280,10.512,22732,7859,14873,5.425,15.691,-7504,-5.180,21.023,432,432,3337
2008,315,7217,7360,162527,167639,1015,13.406,1437,18.980,27749,10501,17248,6.264,16.553,37651,19883,17768,11.861,22.460,-9902,-5.907,33.106,1237,1239,14146
2008,316,1163,1209,32933,33395,105,8.589,132,10.798,3321,863,2458,2.584,9.945,4162,1945,2217,5.824,12.463,-841,-2.518,19.889,96,96,421
2008,321,13500,15511,486214,509888,1049,6.655,1551,9.840,43541,15080,28461,2.958,8.539,91228,24408,66820,4.787,17.892,-47687,-9.352,17.079,1161,1176,13262
2008,322,3044,4745,409368,415863,159,3.310,275,5.726,20168,4403,15765,1.059,4.850,32983,10136,22847,2.437,7.931,-12815,-3.082,9.699,154,155,2550
2008,323,29199,30749,617552,628762,1644,5.257,2692,8.608,48605,12410,36195,1.974,7.730,71342,25041,46301,3.983,11.346,-22737,-3.616,15.461,2195,2207,14472
2008,324,1039,2213,103384,102007,163,7.382,153,6.929,9283,1331,7952,1.305,9.100,6468,1833,4635,1.797,6.341,2815,2.760,12.681,62,62,667
2008,325,9256,12828,805227,801462,765,5.942,858,6.664,78509,14593,63916,1.821,9.796,70060,18670,51390,2.329,8.742,8449,1.054,17.483,480,486,5298
2008,326,10422,13360,809568,826279,569,4.211,876,6.482,63407,12067,51340,1.460,7.674,96984,27481,69503,3.326,11.737,-33577,-4.064,15.348,574,586,12532
2008,327,10276,16405,449308,460739,1041,6.311,1221,7.402,42668,12545,30123,2.723,9.261,65651,15001,50650,3.256,14.249,-22983,-4.988,18.522,705,751,7134
2008,331,3671,4626,430990,433077,288,6.217,301,6.498,29730,8052,21678,1.859,6.865,34113,8719,25394,2.013,7.877,-4383,-1.012,13.730,198,200,3431
2008,332,52852,56946,1570232,1576822,3105,5.426,3653,6.384,155620,38001,117619,2.410,9.869,169769,54599,115170,3.463,10.767,-14149,-0.897,19.738,2784,2798,31640
2008,333,22231,24628,1137237,1139510,1230,4.963,1542,6.222,102787,19301,83486,1.694,9.020,107198,29156,78042,2.559,9.407,-4411,-0.387,18.041,1108,1116,12743
2008,334,11459,13124,1010027,1017922,895,6.766,1104,8.346,98263,23823,74440,2.340,9.653,113508,36906,76602,3.626,11.151,-15245,-1.498,19.307,726,729,9974
2008,335,4923,5755,403560,408312,330,5.702,394,6.808,34580,8766,25814,2.147,8.469,44432,16527,27905,4.048,10.882,-9852,-2.413,16.938,270,271,2968
2008,336,9859,11911,1516393,1552038,811,6.734,1074,8.918,116310,21813,94497,1.405,7.494,186703,44188,142515,2.847,12.030,-70393,-4.536,14.988,736,743,13308
2008,337,18186,18870,478015,494050,1281,6.651,2061,10.701,43046,10964,32082,2.219,8.713,74992,24239,50753,4.906,15.179,-31946,-6.466,17.426,1633,1643,12833
2008,339,26451,27750,637601,642535,2001,7.116,2738,9.737,61960,14626,47334,2.276,9.643,71958,21908,50050,3.410,11.199,-9998,-1.556,19.286,2200,2205,12754
2008,423,167084,234856,3542258,3555283,19459,8.263,20754,8.813,497809,155397,342412,4.371,14.002,527257,170196,357061,4.787,14.830,-29448,-0.828,28.004,12359,12857,74195
2008,424,92360,121359,2290582,2288852,10278,8.413,11910,9.748,301456,87660,213796,3.830,13.171,298086,105727,192359,4.619,13.023,3370,0.147,26.047,7761,8053,46403
2008,425,41262,43331,295586,294909,5090,11.764,4963,11.471,46556,17785,28771,6.031,15.787,44864,21446,23418,7.272,15.213,1692,0.574,30.426,3681,3693,13298
2008,441,84142,117154,1883925,1899999,8157,6.914,9795,8.303,207936,74853,133083,3.940,10.944,239026,78306,160720,4.121,12.580,-31090,-1.636,21.888,7382,7538,58277
2008,442,40723,58542,531941,559703,4598,7.678,7281,12.159,69936,23941,45995,4.277,12.495,123021,41498,81523,7.414,21.980,-53085,-9.484,24.990,4711,5338,26116
2008,443,26874,49322,488723,493479,4442,8.928,5302,10.657,68284,23388,44896,4.739,13.837,78497,27156,51341,5.503,15.907,-10213,-2.070,27.675,3526,3675,14442
2008,444,58067,84780,1328437,1343509,4885,5.723,6031,7.066,132144,40120,92024,2.986,9.836,162427,33740,128687,2.511,12.090,-30283,-2.254,19.671,3994,4188,19145
2008,445,97728,131216,2857465,2839721,14523,11.104,13680,10.459,313290,105249,208041,3.706,11.032,277535,96742,180793,3.407,9.773,35755,1.259,19.547,10262,10409,51420
2008,446,39559,84697,1018895,1021236,6740,8.003,5778,6.861,138908,57686,81222,5.649,13.602,145488,41267,104221,4.041,14.246,-6580,-0.644,27.204,3208,3363,16318
2008,447,61370,108377,893128,896657,8286,7.562,10678,9.745,145704,49321,96383,5.501,16.250,152622,57240,95382,6.384,17.021,-6918,-0.772,32.499,6496,6963,33919
2008,448,58100,146591,1645262,1640140,13303,9.106,12299,8.419,289622,94170,195452,5.742,17.658,281084,68277,212807,4.163,17.138,8538,0.521,34.276,6544,6855,24060
2008,451,31898,47738,574041,579522,4588,9.518,5514,11.440,91693,41646,50047,7.186,15.822,102355,30584,71771,5.277,17.662,-10662,-1.840,31.644,3621,3938,15810
2008,452,7447,44017,2973306,2928083,2045,4.627,2399,5.428,243883,93629,150254,3.198,8.329,157796,25041,132755,0.855,5.389,86087,2.940,10.778,1364,1420,5533
2008,453,82110,106893,775789,782118,10256,9.465,13176,12.160,121747,46436,75311,5.937,15.566,134285,48024,86261,6.140,17.169,-12538,-1.603,31.133,9876,10098,33059
2008,454,45097,52569,590547,597259,5992,11.388,6092,11.578,91323,27246,64077,4.562,15.290,105743,40696,65047,6.814,17.705,-14420,-2.414,30.581,4293,4329,17055
2008,481,2477,5108,484906,481680,451,8.717,583,11.268,34371,3883,30488,0.806,7.136,27825,6414,21411,1.332,5.777,6546,1.359,11.553,276,304,3878
2008,483,1149,1526,68463,70528,146,9.499,168,10.930,7020,1402,5618,1.988,9.954,11117,3792,7325,5.377,15.763,-4097,-5.809,19.907,102,102,1362
2008,484,87351,100793,1423809,1442620,13875,13.580,16627,16.274,193042,58098,134944,4.027,13.381,229936,76302,153634,5.289,15.939,-36894,-2.557,26.763,12424,12459,51519
2008,485,13565,16164,449137,444047,2140,13.277,2047,12.700,70612,20758,49854,4.675,15.902,60893,30368,30525,6.839,13.713,9719,2.189,27.426,1363,1367,9242
2008,486,206,2775,40020,38334,523,19.684,287,10.802,9277,5141,4136,13.411,24.200,5593,2464,3129,6.428,14.590,3684,9.610,29.180,13,13,210
2008,487,1812,1918,22723,22248,297,15.591,271,14.226,4356,1366,2990,6.140,19.579,3456,834,2622,3.749,15.534,900,4.045,31.068,174,174,464
2008,488,29145,38998,644186,642470,4398,11.333,4016,10.349,97400,30031,67369,4.674,15.160,92954,31262,61692,4.866,14.468,4446,0.692,28.936,2421,2442,13051
2008,492,6837,12735,595392,581553,2171,17.561,1426,11.535,67796,19188,48608,3.299,11.658,38264,14172,24092,2.437,6.580,29532,5.078,13.159,831,852,5058
2008,493,6846,13916,704663,717652,1264,9.074,1292,9.275,95296,29047,66249,4.048,13.279,121908,35486,86422,4.945,16.987,-26612,-3.708,26.558,375,403,4486
2008,511,19809,28366,1052800,1053945,2730,9.554,3148,11.017,128353,41447,86906,3.933,12.178,131796,47000,84796,4.459,12.505,-3443,-0.327,24.357,1689,1737,15543
2008,512,15779,19367,348382,345719,2917,15.152,2685,13.947,60703,22689,38014,6.563,17.559,56405,26314,30091,7.611,16.315,4298,1.243,32.631,1708,1717,17798
2008,515,4600,9514,288074,290328,1036,10.712,1350,13.959,33997,15554,18443,5.357,11.710,38186,15590,22596,5.370,13.153,-4189,-1.443,23.420,311,322,2398
2008,517,9318,50105,1193547,1201385,7167,14.316,7082,14.146,204219,88721,115498,7.385,16.999,224022,60209,163813,5.012,18.647,-19803,-1.648,33.997,1309,1325,9149
2008,518,8219,14655,396772,400670,1347,9.211,1284,8.780,73022,18946,54076,4.729,18.225,80004,28044,51960,6.999,19.968,-6982,-1.743,36.450,691,702,7725
2008,519,5341,6723,139458,131249,965,14.565,770,11.622,29341,11984,17357,9.131,22.355,12348,4568,7780,3.480,9.408,16993,12.947,18.816,509,514,2192
2008,521,12,47,19003,19258,0,0.000,0,0.000,319,0,319,0.000,1.656,839,0,839,0.000,4.357,-520,-2.700,3.313,0,0,0
2008,522,51961,215166,3062059,3158682,18826,8.625,25030,11.468,420433,141174,279259,4.469,13.310,612266,227257,385009,7.195,19.384,-191833,-6.073,26.621,10566,11864,79415
2008,523,49311,82686,954153,939836,12385,15.270,9226,11.375,164295,73538,90757,7.825,17.481,135513,57597,77916,6.128,14.419,28782,3.062,28.838,4825,4867,20012
2008,524,126601,168883,2387281,2375599,17447,10.308,18180,10.742,375084,166110,208974,6.992,15.789,349709,139474,210235,5.871,14.721,25375,1.068,29.442,8921,9068,31286
2008,525,640,661,8196,7698,192,30.000,150,23.438,3126,1801,1325,23.396,40.608,2172,1826,346,23.720,28.215,954,12.393,56.430,124,124,1643
2008,531,213707,257835,1500359,1515857,32837,12.501,42524,16.189,277619,114853,162766,7.577,18.314,308559,136585,171974,9.010,20.355,-30940,-2.041,36.629,28846,29104,85516
2008,532,23982,60309,617178,618119,5863,9.655,6692,11.020,100222,36683,63539,5.935,16.214,101966,40796,61170,6.600,16.496,-1744,-0.282,32.428,2847,2982,13119
2008,533,1992,2095,31571,31069,279,13.430,244,11.745,6272,1725,4547,5.552,20.188,5339,1425,3914,4.587,17.185,933,3.003,34.369,180,183,1235
2008,541,658784,734529,7880230,7818217,88695,12.090,86921,11.848,1333434,447839,885595,5.728,17.055,1203244,453994,749250,5.807,15.390,130190,1.665,30.781,58781,59240,228320
2008,551,26639,50298,2860402,2911161,4512,8.938,4873,9.654,473393,141356,332037,4.856,16.261,576023,149680,426343,5.142,19.787,-102630,-3.525,32.523,1025,1069,16203
2008,561,263854,318098,9315107,9317134,44512,14.040,42411,13.377,1863668,616788,1246880,6.620,20.003,1881768,587840,1293928,6.309,20.197,-18100,-0.194,40.005,27714,28090,296726
2008,562,16067,20369,367077,366943,1974,9.736,1785,8.804,51448,15550,35898,4.238,14.021,51348,17151,34197,4.674,13.993,100,0.027,27.987,1196,1210,8149
2008,611,69519,79338,3119766,3079027,8647,11.000,7187,9.143,285394,58328,227066,1.894,9.269,203996,55083,148913,1.789,6.625,81398,2.644,13.251,5171,5259,37307
2008,621,433318,513358,5846617,5762667,42295,8.292,35658,6.991,886399,272892,613507,4.736,15.382,719698,228665,491033,3.968,12.489,166701,2.893,24.978,23618,24093,124102
2008,622,3699,6681,5583532,5538037,321,4.873,134,2.034,297180,35867,261313,0.648,5.366,211028,61491,149537,1.110,3.811,86152,1.556,7.621,39,39,17239
2008,623,32704,74093,3119556,3093317,6043,8.195,5343,7.245,364738,117227,247511,3.790,11.791,312772,131760,181012,4.260,10.111,51966,1.680,20.222,2316,2461,66740
2008,624,106063,145531,2606643,2565202,14273,9.874,12313,8.518,401831,115071,286760,4.486,15.665,318845,98466,220379,3.839,12.430,82986,3.235,24.859,7507,7691,49213
2008,711,31911,32723,448992,441587,4992,15.237,5070,15.475,82358,22551,59807,5.107,18.650,67646,20811,46835,4.713,15.319,14712,3.332,30.638,3347,3349,14144
2008,712,6246,6729,133039,130825,391,5.838,327,4.883,12845,1677,11168,1.282,9.818,8506,1045,7461,0.799,6.502,4339,3.317,13.004,181,181,555
2008,713,53984,61435,1481371,1472823,7315,11.869,7705,12.502,204436,68981,135455,4.684,13.881,185862,70952,114910,4.817,12.619,18574,1.261,25.239,5879,5937,45635
2008,721,45221,55910,1969156,1957546,6016,10.795,5658,10.152,257173,126887,130286,6.482,13.138,234698,99462,135236,5.081,11.989,22475,1.148,23.979,3867,3935,61767
2008,722,373398,520087,9913695,9798903,66011,12.775,59260,11.469,1816558,847215,969343,8.646,18.538,1595827,590152,1005675,6.023,16.286,220731,2.253,32.572,44418,45308,398296
2008,811,185028,201584,1271415,1276674,17803,8.752,21465,10.552,201251,68230,133021,5.344,15.764,212002,79461,132541,6.224,16.606,-10751,-0.842,31.527,15892,16197,55158
2008,812,151350,189771,1364022,1350050,24231,12.831,22379,11.850,281142,116006,165136,8.593,20.825,251727,101522,150205,7.520,18.646,29415,2.179,37.292,15512,15968,62816
2008,813,278464,287174,2803916,2783201,15070,5.257,14007,4.887,305274,49085,256189,1.764,10.968,263224,50507,212717,1.815,9.458,42050,1.511,18.915,8972,9015,34060
2009,113,7896,8061,52893,56952,641,7.627,1327,15.790,6350,2045,4305,3.591,11.150,14426,4515,9911,7.928,25.330,-8076,-14.180,22.299,896,896,3192
2009,114,1389,1399,7194,7252,232,16.524,242,17.236,1298,551,747,7.598,17.900,1411,636,775,8.771,19.458,-113,-1.558,35.799,147,147,427
2009,115,8190,8709,89283,91887,922,10.504,1059,12.065,12322,3810,8512,4.146,13.410,17362,5578,11784,6.071,18.895,-5040,-5.485,26.820,751,751,4047
2009,211,5791,7115,107032,105524,747,10.580,638,9.036,17665,6262,11403,5.934,16.740,14730,6069,8661,5.751,13.959,2935,2.781,27.918,369,375,2408
2009,212,3784,6280,198816,200906,486,7.639,651,10.232,27274,8449,18825,4.205,13.576,31127,7815,23312,3.890,15.493,-3853,-1.918,27.151,331,336,3171
2009,213,9241,11345,295652,307455,1366,12.149,1164,10.352,43544,13574,29970,4.415,14.163,67491,15731,51760,5.117,21.952,-23947,-7.789,28.325,745,763,8296
2009,221,5354,16839,644570,639551,1290,7.762,852,5.126,66135,23052,43083,3.604,10.341,56565,15513,41052,2.426,8.844,9570,1.496,17.689,233,320,5234
2009,236,173180,175932,1276070,1409902,22887,12.221,45589,24.342,202980,71763,131217,5.090,14.397,471064,143461,327603,10.175,33.411,-268084,-19.014,28.794,31656,31675,100167
2009,237,37720,40000,897270,946560,2826,6.792,6038,14.512,122374,32858,89516,3.471,12.928,219857,40548,179309,4.284,23.227,-97483,-10.299,25.857,4374,4389,27131
2009,238,388084,394730,3771443,4124978,38086,9.202,76417,18.463,531202,157863,373339,3.827,12.878,1238514,296479,942035,7.187,30.025,-707312,-17.147,25.755,52258,52289,209852
2009,311,19073,23206,1431486,1439661,1696,7.262,1992,8.530,111794,26497,85297,1.841,7.765,128419,31060,97359,2.157,8.920,-16625,-1.155,15.531,1475,1492,15064
2009,312,3148,3743,143614,149009,409,11.113,284,7.716,11906,3856,8050,2.588,7.990,22665,4883,17782,3.277,15.210,-10759,-7.220,15.980,184,185,1244
2009,313,2184,2502,121277,133610,147,5.724,279,10.864,7917,3392,4525,2.539,5.925,32022,8403,23619,6.289,23.967,-24105,-18.041,11.851,197,199,2899
2009,314,5887,6127,118627,129965,477,7.601,774,12.334,7604,3054,4550,2.350,5.851,30424,6400,24024,4.924,23.409,-22820,-17.559,11.702,567,571,3622
2009,315,6426,6549,131806,145385,840,12.200,1512,21.961,18376,8951,9425,6.157,12.640,45656,17332,28324,11.921,31.404,-27280,-18.764,25.279,1272,1273,13157
2009,316,1101,1142,29402,30989,94,8.017,155,13.220,2697,1032,1665,3.330,8.703,5889,1702,4187,5.492,19.004,-3192,-10.300,17.406,120,120,1010
2009,321,12666,14575,387055,438833,800,5.302,1826,12.102,25068,9528,15540,2.171,5.712,128724,26392,102332,6.014,29.333,-103656,-23.621,11.425,1255,1272,12777
2009,322,2935,4581,380759,395720,134,2.872,305,6.536,19091,6094,12997,1.540,4.824,49072,13122,35950,3.316,12.401,-29981,-7.576,9.649,174,184,4766
2009,323,27665,29089,547367,581895,1394,4.654,3122,10.423,35336,11701,23635,2.011,6.073,104592,28894,75698,4.966,17.974,-69256,-11.902,12.145,2509,2521,17102
2009,324,996,2142,99729,101475,145,6.679,203,9.351,5570,1016,4554,1.001,5.489,9027,2960,6067,2.917,8.896,-3457,-3.407,10.978,76,76,640
2009,325,9117,12642,753568,776588,792,6.217,988,7.755,59322,19247,40075,2.478,7.639,104909,27002,77907,3.477,13.509,-45587,-5.870,15.278,589,597,6743
2009,326,10073,12935,687807,749397,474,3.592,994,7.533,33428,10165,23263,1.356,4.461,157241,34220,123021,4.566,20.982,-123813,-16.522,8.921,621,643,14140
2009,327,9763,15590,378576,413659,827,5.174,1612,10.086,30246,11188,19058,2.705,7.312,100479,20089,80390,4.856,24.290,-70233,-16.978,14.624,820,831,7125
2009,331,3598,4531,377833,403650,253,5.533,336,7.348,18079,6710,11369,1.662,4.479,69920,9288,60632,2.301,17.322,-51841,-12.843,8.958,228,231,4185
2009,332,51403,55491,1398605,1487087,2568,4.561,4187,7.437,97968,31395,66573,2.111,6.588,275024,47832,227192,3.216,18.494,-177056,-11.906,13.176,2969,2983,25699
2009,333,21591,23970,1036494,1087655,1094,4.497,1812,7.448,72763,20960,51803,1.927,6.690,175616,33199,142417,3.052,16.146,-102853,-9.456,13.380,1248,1262,14550
2009,334,11092,12756,955992,981636,757,5.844,1151,8.886,83182,18652,64530,1.900,8.474,136591,33267,103324,3.389,13.915,-53409,-5.441,16.948,759,763,11461
2009,335,4830,5652,360739,381788,280,4.902,399,6.986,20780,5409,15371,1.417,5.443,62522,12445,50077,3.260,16.376,-41742,-10.933,10.886,248,249,3445
2009,336,9481,11494,1266502,1388750,757,6.462,1200,10.243,80392,20910,59482,1.506,5.789,324345,52128,272217,3.754,23.355,-243953,-17.566,11.578,808,817,14384
2009,337,16698,17327,385790,431586,951,5.246,2555,14.093,23633,8411,15222,1.949,5.476,115177,28552,86625,6.616,26.687,-91544,-21.211,10.952,1945,1951,13699
2009,339,25640,26938,593951,616833,1781,6.502,2686,9.806,47909,12654,35255,2.051,7.767,94456,20764,73692,3.366,15.313,-46547,-7.546,15.534,2044,2048,11817
2009,423,162204,230304,3332862,3449898,15846,6.797,21510,9.226,356037,114149,241888,3.309,10.320,590665,169033,421632,4.900,17.121,-234628,-6.801,20.640,13095,13574,77260
2009,424,89975,119708,2200620,2251053,9586,7.938,11684,9.676,237360,69305,168055,3.079,10.544,336955,93439,243516,4.151,14.969,-99595,-4.424,21.089,7856,8053,50235
2009,425,39927,42060,288798,292785,4580,10.683,6202,14.467,41627,17123,24504,5.848,14.218,49562,20353,29209,6.952,16.928,-7935,-2.710,28.435,4568,4588,14185
2009,441,80052,113480,1647053,1768283,7124,6.172,11026,9.552,118746,51256,67490,2.899,6.715,361372,96071,265301,5.433,20.436,-242626,-13.721,13.431,8196,8333,71775
2009,442,37617,54293,445911,489500,3500,6.195,7903,13.989,45313,20277,25036,4.142,9.257,133764,51645,82119,10.551,27.327,-88451,-18.070,18.514,4955,5949,39621
2009,443,25842,47992,465774,478076,4358,8.948,5777,11.862,56855,25558,31297,5.346,11.892,82003,36305,45698,7.594,17.153,-25148,-5.260,23.785,3555,4208,18690
2009,444,55358,81993,1218108,1273724,3873,4.644,6688,8.019,86316,35643,50673,2.798,6.777,198235,39919,158316,3.134,15.563,-111919,-8.787,13.553,4491,4663,23793
2009,445,98202,132064,2847514,2852928,13862,10.525,13147,9.982,304717,142113,162604,4.981,10.681,316615,106096,210519,3.719,11.098,-11898,-0.417,21.362,9797,9890,48652
2009,446,39052,85486,984728,1003068,6088,7.147,5483,6.437,94118,37149,56969,3.704,9.383,131042,28107,102935,2.802,13.064,-36924,-3.681,18.766,3248,3377,14544
2009,447,61041,107770,855084,875189,7915,7.306,9048,8.352,109664,42661,67003,4.874,12.530,149607,49281,100326,5.631,17.094,-39943,-4.564,25.061,6093,6339,30625
2009,448,55972,142177,1534146,1593205,11354,7.853,16145,11.167,198713,98193,100520,6.163,12.473,312243,96368,215875,6.049,19.598,-113530,-7.126,24.945,7005,8020,29238
2009,451,30735,46101,535666,555642,3637,7.739,5430,11.554,57155,25511,31644,4.591,10.286,97942,27973,69969,5.034,17.627,-40787,-7.341,20.573,3568,3665,14239
2009,452,7114,43621,2910800,2941367,2062,4.703,2500,5.703,186745,50797,135948,1.727,6.349,251152,60484,190668,2.056,8.539,-64407,-2.190,12.698,1241,1462,34095
2009,453,77946,103287,731111,754215,8888,8.444,12839,12.197,90073,37073,53000,4.915,11.943,136029,43619,92410,5.783,18.036,-45956,-6.093,23.885,9970,10123,31876
2009,454,43892,51471,559575,576258,5185,9.952,6448,12.376,79333,31385,47948,5.446,13.767,112897,37516,75381,6.510,19.591,-33564,-5.824,27.534,4861,4922,21106
2009,481,2404,4954,438435,460835,464,9.237,603,12.004,16599,4085,12514,0.886,3.602,60887,8740,52147,1.897,13.212,-44288,-9.610,7.204,287,303,5041
2009,483,1153,1539,67406,68007,174,11.387,152,9.948,6820,2199,4621,3.233,10.028,8080,1665,6415,2.448,11.881,-1260,-1.853,20.057,108,108,1125
2009,484,82644,96299,1322462,1377709,12444,12.604,17314,17.536,165696,68873,96823,4.999,12.027,277467,92402,185065,6.707,20.140,-111771,-8.113,24.054,12371,12513,56728
2009,485,13561,16231,437056,443703,2066,12.735,2051,12.642,54985,21059,33926,4.746,12.392,69358,21521,47837,4.850,15.632,-14373,-3.239,24.785,1448,1451,11583
2009,486,193,2772,41308,40760,174,6.260,189,6.800,5079,2181,2898,5.351,12.461,4089,1279,2810,3.138,10.032,990,2.429,20.064,22,22,103
2009,487,1756,1859,21304,22225,229,12.030,318,16.706,2975,1039,1936,4.675,13.386,4768,1288,3480,5.795,21.454,-1793,-8.068,26.772,220,222,975
2009,488,28726,38523,600821,622277,3855,9.938,4390,11.317,83209,29772,53437,4.784,13.372,125767,38501,87266,6.187,20.211,-42558,-6.839,26.743,2637,2793,22375
2009,492,6980,12708,548206,571958,1464,11.470,1576,12.347,30403,12710,17693,2.222,5.316,80238,10040,70198,1.755,14.029,-49835,-8.713,10.631,910,919,4930
2009,493,6856,14098,682954,697525,1314,9.328,1290,9.158,85506,36940,48566,5.296,12.258,114864,37082,77782,5.316,16.467,-29358,-4.209,24.517,423,468,7989
2009,511,19021,27622,965018,1012965,2417,8.625,3219,11.487,91538,33581,57957,3.315,9.037,187660,53126,134534,5.245,18.526,-96122,-9.489,18.073,1745,1818,23012
2009,512,15375,19015,338226,344982,2511,13.059,2936,15.270,43058,17424,25634,5.051,12.481,55960,15910,40050,4.612,16.221,-12902,-3.740,24.962,1907,1946,7632
2009,515,4536,9391,270917,279983,957,10.122,1085,11.475,23524,11100,12424,3.965,8.402,41690,12153,29537,4.341,14.890,-18166,-6.488,16.804,304,318,2674
2009,517,8887,49955,1181440,1189096,7707,15.370,8081,16.116,176372,80348,96024,6.757,14.832,193276,73015,120261,6.140,16.254,-16904,-1.422,29.665,1315,1411,12590
2009,518,7958,11850,394884,396442,1845,13.958,4582,34.664,67977,34205,33772,8.628,17.147,70540,29708,40832,7.494,17.793,-2563,-0.647,34.294,813,826,8157
2009,519,5978,7385,139053,139688,1185,16.413,855,11.842,25120,10872,14248,7.783,17.983,26164,7542,18622,5.399,18.730,-1044,-0.747,35.966,538,546,3426
2009,521,13,48,18775,18894,D,D,D,D,994,D,972,D,5.261,1164,D,1034,D,6.161,-170,-0.900,10.522,0,0,0
2009,522,44884,202318,2855837,2944440,13729,6.577,26605,12.745,349585,131616,217969,4.470,11.873,525996,180189,345807,6.120,17.864,-176411,-5.991,23.745,9678,11041,52954
2009,523,48630,84849,920518,942432,12762,15.187,11127,13.241,153394,77127,76267,8.184,16.276,197088,46619,150469,4.947,20.913,-43694,-4.636,32.553,4999,5056,19068
2009,524,124670,166796,2355757,2367799,14565,8.668,17047,10.145,272986,107724,165262,4.550,11.529,297754,102343,195411,4.322,12.575,-24768,-1.046,23.058,9320,9471,34130
2009,525,660,676,7880,8679,179,26.637,171,25.446,2392,1953,439,22.504,27.562,3946,1660,2286,19.128,45.469,-1554,-17.906,55.125,138,139,1329
2009,531,201778,246874,1427700,1471678,28228,11.162,40269,15.923,232469,105340,127129,7.158,15.796,320001,134993,185008,9.173,21.744,-87532,-5.948,31.592,26116,26382,79006
2009,532,22910,58021,555837,586064,3796,6.411,6178,10.434,59610,21840,37770,3.727,10.171,120645,36825,83820,6.283,20.586,-61035,-10.414,20.342,2699,2861,14294
2009,533,1979,2083,33159,32898,260,12.425,279,13.333,5230,2300,2930,6.991,15.898,4689,2054,2635,6.244,14.253,541,1.644,28.506,197,197,1001
2009,541,647986,729092,7791191,7879376,84251,11.491,92469,12.612,1205625,475055,730570,6.029,15.301,1380670,460940,919730,5.850,17.523,-175045,-2.222,30.602,62420,62930,254564
2009,551,26703,50351,2817786,2853174,4357,8.633,4596,9.106,408766,140104,268662,4.910,14.327,479402,123869,355533,4.341,16.802,-70636,-2.476,28.653,993,1124,18573
2009,561,258239,312505,8253073,8789863,39250,12.417,46418,14.685,1314180,459583,854597,5.229,14.951,2394880,608925,1785955,6.928,27.246,-1080700,-12.295,29.902,28276,28638,312912
2009,562,15781,20252,349427,358575,1664,8.172,1886,9.262,42906,15812,27094,4.410,11.966,60929,16823,44106,4.692,16.992,-18023,-5.026,23.931,1260,1279,8702
2009,611,70366,80378,3187937,3150715,8221,10.283,7361,9.207,280652,55530,225122,1.762,8.908,207087,52832,154255,1.677,6.573,73565,2.335,13.145,5266,5327,37058
2009,621,437929,522348,6025551,5946390,42182,8.134,34639,6.680,874840,290240,584600,4.881,14.712,716484,235719,480765,3.964,12.049,158356,2.663,24.098,23552,24166,141651
2009,622,3829,6849,5628558,5600610,342,5.048,194,2.863,255752,44144,211608,0.788,4.567,198410,57214,141196,1.022,3.543,57342,1.024,7.085,76,80,29510
2009,623,33294,74745,3173626,3147651,4728,6.341,4357,5.844,311691,92027,219664,2.924,9.902,257380,96155,161225,3.055,8.177,54311,1.725,16.354,2011,2145,59510
2009,624,108220,148451,2649631,2635950,13517,9.175,11251,7.637,348474,97452,251022,3.697,13.220,320046,93774,226272,3.558,12.142,28428,1.078,24.283,7706,7856,65147
2009,711,31565,32378,427113,437406,4710,14.420,5281,16.168,63817,19267,44550,4.405,14.590,84636,24268,60368,5.548,19.350,-20819,-4.760,29.180,3469,3481,15694
2009,712,6293,6779,128750,131161,333,4.911,336,4.955,8663,1665,6998,1.269,6.605,13247,1292,11955,0.985,10.100,-4584,-3.495,13.210,214,215,928
2009,713,53197,60959,1451767,1470346,6430,10.473,7303,11.895,173373,61501,111872,4.183,11.791,211546,59344,152202,4.036,14.387,-38173,-2.596,23.583,5671,5715,45814
2009,721,45305,56505,1846897,1913058,5370,9.531,5047,8.958,182172,99676,82496,5.210,9.523,315769,71898,243871,3.758,16.506,-133597,-6.983,19.045,3482,3533,45112
2009,722,374179,523285,9595082,9768322,60649,11.603,59458,11.375,1435247,754450,680797,7.723,14.693,1780350,607543,1172807,6.220,18.226,-345103,-3.533,29.386,45190,46359,418891
2009,811,180108,196527,1187737,1231393,16155,8.097,22127,11.091,154241,59625,94616,4.842,12.526,241843,77835,164008,6.321,19.640,-87602,-7.114,25.051,15782,16022,53190
2009,812,151417,188836,1315213,1339311,20298,10.706,21828,11.513,198302,84106,114196,6.280,14.806,245169,96835,148334,7.230,18.306,-46867,-3.499,29.613,15641,16328,65790
2009,813,280368,289253,2752439,2777800,14770,5.116,13641,4.725,263686,48796,214890,1.757,9.493,315895,47631,268264,1.715,11.372,-52209,-1.880,18.985,9036,9052,33138
2010,113,7657,7793,53514,53092,735,9.281,987,12.464,9193,2358,6835,4.441,17.315,8365,2902,5463,5.466,15.756,828,1.560,31.511,648,652,1987
2010,114,1417,1428,7543,7245,228,16.090,206,14.538,1751,611,1140,8.433,24.168,1185,621,564,8.571,16.356,566,7.812,32.712,122,122,319
2010,115,8176,8718,90330,89250,1002,11.522,959,11.027,15949,4846,11103,5.430,17.870,13808,4353,9455,4.877,15.471,2141,2.399,30.942,636,636,3342
2010,211,5754,7042,108214,107845,593,8.401,627,8.882,13949,5039,8910,4.672,12.934,13334,4763,8571,4.417,12.364,615,0.570,24.728,400,404,2050
2010,212,3664,6205,192297,195594,450,7.192,554,8.854,23668,6794,16874,3.474,12.101,30404,6028,24376,3.082,15.544,-6736,-3.444,24.201,301,306,2731
2010,213,9119,11384,286037,292622,1291,11.293,1387,12.133,49894,20543,29351,7.020,17.051,62988,15147,47841,5.176,21.525,-13094,-4.475,34.101,876,878,7381
2010,221,5420,17196,639651,640686,1111,6.546,664,3.912,41281,14918,26363,2.328,6.443,43266,10676,32590,1.666,6.753,-1985,-0.310,12.887,179,181,1287
2010,236,160839,163739,1146085,1212029,25396,14.946,37748,22.216,223362,94166,129196,7.769,18.429,356156,113566,242590,9.370,29.385,-132794,-10.956,36.858,24364,24399,75520
2010,237,35535,37923,841306,870642,3077,7.883,5298,13.573,127177,32443,94734,3.726,14.607,186956,33226,153730,3.816,21.473,-59779,-6.866,29.215,3587,3604,21104
2010,238,363580,370238,3363146,3562267,41425,10.847,64763,16.958,551984,162353,389631,4.558,15.495,950859,240323,710536,6.746,26.693,-398875,-11.197,30.991,41507,41567,160488
2010,311,19144,23247,1426027,1428554,1734,7.478,1613,6.957,102201,22172,80029,1.552,7.154,106580,33444,73136,2.341,7.461,-4379,-0.307,14.308,1134,1138,9905
2010,312,3309,3899,139427,141484,434,11.391,256,6.719,10687,2840,7847,2.007,7.554,14775,4112,10663,2.906,10.443,-4088,-2.889,15.107,175,175,1035
2010,313,2088,2360,109576,114896,150,6.200,269,11.118,8423,2089,6334,1.818,7.331,18773,7129,11644,6.205,16.339,-10350,-9.008,14.662,182,185,1917
2010,314,5582,5812,112150,115193,451,7.558,761,12.753,11500,2961,8539,2.570,9.983,17434,4524,12910,3.927,15.135,-5934,-5.151,19.966,566,566,2417
2010,315,5958,6056,118602,122890,849,13.600,1222,19.575,20377,6783,13594,5.520,16.581,28878,12233,16645,9.954,23.499,-8501,-6.918,33.163,1039,1044,9262
2010,316,1037,1076,26828,28019,81,7.387,122,11.126,1756,244,1512,0.871,6.267,4062,786,3276,2.805,14.497,-2306,-8.230,12.534,88,88,409
2010,321,11918,13707,352245,368911,815,5.764,1679,11.875,35131,9823,25308,2.663,9.523,68185,21335,46850,5.783,18.483,-33054,-8.960,19.046,1095,1104,9722
2010,322,2878,4488,365884,373013,164,3.617,257,5.668,18069,3660,14409,0.981,4.844,32532,9492,23040,2.545,8.721,-14463,-3.877,9.688,154,154,1828
2010,323,26319,27676,499575,524969,1382,4.862,2876,10.119,33382,10849,22533,2.067,6.359,84421,26756,57665,5.097,16.081,-51039,-9.722,12.718,2299,2305,15852
2010,324,1000,2165,99728,100907,167,7.766,138,6.417,6189,2665,3524,2.641,6.133,8808,2159,6649,2.140,8.729,-2619,-2.595,12.267,53,54,338
2010,325,9029,12447,722746,733276,704,5.621,861,6.874,53199,15155,38044,2.067,7.255,74001,15407,58594,2.101,10.092,-20802,-2.837,14.510,522,528,5833
2010,326,9786,12552,667469,678571,520,4.077,928,7.275,57347,13135,44212,1.936,8.451,79956,26780,53176,3.947,11.783,-22609,-3.332,16.902,572,580,8706
2010,327,9460,15159,344047,362267,767,4.974,1288,8.353,27898,7086,20812,1.956,7.701,64754,14339,50415,3.958,17.875,-36856,-10.174,15.402,702,709,4943
2010,331,3497,4384,349638,363736,215,4.821,367,8.229,21398,4089,17309,1.124,5.883,49490,10347,39143,2.845,13.606,-28092,-7.723,11.766,231,232,4059
2010,332,49263,53208,1279716,1338879,2265,4.161,4705,8.644,99688,23038,76650,1.721,7.446,218196,47400,170796,3.540,16.297,-118508,-8.851,14.891,3143,3155,23290
2010,333,20827,23128,929108,980644,1066,4.530,1871,7.951,59736,16641,43095,1.697,6.092,162035,29411,132624,2.999,16.523,-102299,-10.432,12.183,1249,1255,11818
2010,334,10911,12483,875451,912710,824,6.533,1085,8.602,65322,15120,50202,1.657,7.157,138864,31480,107384,3.449,15.214,-73542,-8.058,14.314,703,708,7940
2010,335,4764,5547,326588,341516,302,5.384,427,7.612,18500,4176,14324,1.223,5.417,48415,11455,36960,3.354,14.176,-29915,-8.759,10.834,259,265,2361
2010,336,9173,11154,1205786,1237998,789,6.969,1124,9.928,110536,23996,86540,1.938,8.929,175911,43548,132363,3.518,14.209,-65375,-5.281,17.857,724,739,13332
2010,337,15520,16091,344311,364596,1018,6.077,2342,13.980,28619,7259,21360,1.991,7.850,69136,21078,48058,5.781,18.962,-40517,-11.113,15.699,1691,1695,11159
2010,339,24999,26302,555952,572885,1828,6.862,2505,9.403,44034,10294,33740,1.797,7.686,78022,23868,54154,4.166,13.619,-33988,-5.933,15.373,1845,1851,10432
2010,423,157549,226003,3141659,3230969,16452,7.221,20089,8.818,326786,114949,211837,3.558,10.114,505655,141006,364649,4.364,15.650,-178869,-5.536,20.228,12112,12670,67184
2010,424,88919,119128,2161632,2185044,9785,8.189,10518,8.802,230051,67343,162708,3.082,10.528,276823,84219,192604,3.854,12.669,-46772,-2.141,21.057,7064,7230,40658
2010,425,39123,41339,297411,294030,4772,11.411,5735,13.713,66260,32274,33986,10.976,22.535,57854,21626,36228,7.355,19.676,8406,2.859,39.352,4158,4189,15453
2010,441,77328,110969,1628439,1638133,7108,6.336,9550,8.512,175786,55124,120662,3.365,10.731,196025,78783,117242,4.809,11.966,-20239,-1.235,21.462,6835,7045,56033
2010,442,35234,51636,426564,436723,3351,6.323,6070,11.454,50946,17533,33413,4.015,11.666,71252,25103,46149,5.748,16.315,-20306,-4.650,23.331,4104,4464,17276
2010,443,25372,46253,425772,445905,5333,11.325,7009,14.884,66353,28672,37681,6.430,14.881,102682,69669,33013,15.624,23.028,-36329,-8.147,29.761,3050,4441,58079
2010,444,53340,79658,1206779,1212795,3502,4.331,5907,7.305,101369,22249,79120,1.835,8.358,115481,29534,85947,2.435,9.522,-14112,-1.164,16.717,3730,3876,15490
2010,445,99683,133569,2814981,2830131,13452,10.144,11522,8.689,249749,101647,148102,3.592,8.825,280366,73068,207298,2.582,9.906,-30617,-1.082,17.649,8536,8681,38914
2010,446,39056,85904,991020,986663,5744,6.703,5314,6.201,97447,29965,67482,3.037,9.876,88210,26657,61553,2.702,8.940,9237,0.936,17.880,2866,3026,13584
2010,447,61796,107730,853587,854327,7471,6.925,7792,7.222,116021,41655,74366,4.876,13.580,117595,42548,75047,4.980,13.765,-1574,-0.184,27.161,4862,5171,23739
2010,448,54562,139465,1529909,1532326,9943,7.064,12506,8.885,215796,80996,134800,5.286,14.083,218859,77984,140875,5.089,14.283,-3063,-0.200,28.166,6233,7411,32904
2010,451,30005,44942,524061,529627,3400,7.465,4612,10.126,66967,18394,48573,3.473,12.644,77733,21280,56453,4.018,14.677,-10766,-2.033,25.288,3050,3360,12519
2010,452,7098,44413,2790937,2850719,2375,5.397,1562,3.549,119122,42915,76207,1.505,4.179,236223,15601,220622,0.547,8.286,-117101,-4.108,8.357,919,956,3146
2010,453,75293,100561,717875,724983,8661,8.492,11529,11.303,94628,37008,57620,5.105,13.052,109321,36934,72387,5.094,15.079,-14693,-2.027,26.105,8402,8781,26374
2010,454,43678,51178,542598,547371,5473,10.675,5651,11.023,71878,26139,45739,4.775,13.131,81728,26670,55058,4.872,14.931,-9850,-1.800,26.263,4197,4270,17479
2010,481,2338,4722,416923,428146,486,10.091,674,13.995,44594,7388,37206,1.726,10.416,67282,34308,32974,8.013,15.715,-22688,-5.299,20.831,254,262,1236
2010,483,1086,1523,63419,65396,148,9.676,161,10.526,5318,1800,3518,2.752,8.132,9416,1880,7536,2.875,14.398,-4098,-6.266,16.264,108,109,1075
2010,484,79792,93210,1263144,1293193,11545,12.184,14634,15.444,164907,54147,110760,4.187,12.752,222978,68830,154148,5.322,17.242,-58071,-4.491,25.504,10076,10167,40522
2010,485,13627,16374,439590,438259,2036,12.478,1922,11.779,54761,21838,32923,4.983,12.495,52444,17779,34665,4.057,11.966,2317,0.529,23.933,1343,1347,8943
2010,486,197,2967,44957,44754,227,7.757,146,4.989,8402,1192,7210,2.663,18.774,7973,1403,6570,3.135,17.815,429,0.959,35.630,13,13,101
2010,487,1717,1819,20651,21082,252,13.707,291,15.828,3124,941,2183,4.464,14.818,4059,1642,2417,7.789,19.253,-935,-4.435,29.637,179,179,1094
2010,488,28434,38444,582108,593255,4048,10.507,4213,10.935,79737,32501,47236,5.478,13.441,102115,31639,70476,5.333,17.213,-22378,-3.772,26.881,2519,2613,14202
2010,492,6790,12125,516747,531667,1181,9.505,1782,14.341,27928,8176,19752,1.538,5.253,57435,18917,38518,3.558,10.803,-29507,-5.550,10.506,911,945,5076
2010,493,6843,14109,668183,675501,1101,7.779,1189,8.401,75657,25841,49816,3.825,11.200,89528,23558,65970,3.487,13.254,-13871,-2.053,22.400,417,451,5623
2010,511,18426,26677,909255,935198,1909,7.026,2898,10.666,83173,34610,48563,3.701,8.894,135324,37710,97614,4.032,14.470,-52151,-5.576,17.787,1559,1608,12384
2010,512,15149,18843,317506,322588,2555,13.487,2758,14.558,40635,16291,24344,5.050,12.597,51041,14194,36847,4.400,15.822,-10406,-3.226,25.193,1733,1763,7503
2010,515,4484,9637,261979,266484,777,8.164,538,5.653,22512,9139,13373,3.429,8.448,30702,8553,22149,3.210,11.521,-8190,-3.073,16.896,291,294,3650
2010,517,8432,48773,1115958,1147810,5205,10.564,6202,12.587,116326,50689,65637,4.416,10.135,177689,71515,106174,6.231,15.481,-61363,-5.346,20.269,1097,1125,6218
2010,518,7905,11876,391430,394739,1450,12.186,1496,12.572,76423,25742,50681,6.521,19.360,82719,26148,56571,6.624,20.955,-6296,-1.595,38.721,694,713,6807
2010,519,6244,7783,137865,139852,1305,17.151,957,12.577,28947,15073,13874,10.778,20.698,32763,6753,26010,4.829,23.427,-3816,-2.729,41.397,637,638,2811
2010,521,12,47,18192,18484,D,D,D,D,343,D,338,D,1.856,933,D,874,D,5.048,-590,-3.192,3.711,D,D,D
2010,522,41294,194153,2754456,2807696,12186,6.147,20392,10.286,350571,112808,237763,4.018,12.486,454175,149418,304757,5.322,16.176,-103604,-3.690,24.972,5807,6766,38279
2010,523,48937,84486,869236,896430,11912,14.077,12177,14.390,158958,69231,89727,7.723,17.732,213034,69497,143537,7.753,23.765,-54076,-6.032,35.465,4550,4647,16985
2010,524,123901,164467,2269026,2312146,14928,9.015,17170,10.369,254860,105163,149697,4.548,11.023,341620,112683,228937,4.874,14.775,-86760,-3.752,22.045,8131,8276,25722
2010,525,609,624,6397,6155,129,20.204,158,24.745,1423,959,464,15.581,23.119,956,505,451,8.205,15.532,467,7.587,31.064,124,124,336
2010,531,200076,248016,1397296,1409074,30497,12.324,29383,11.874,227600,112385,115215,7.976,16.152,249901,99386,150515,7.053,17.735,-22301,-1.583,32.305,19158,19471,55682
2010,532,21862,52950,505572,530062,3619,6.528,8594,15.502,59325,22110,37215,4.171,11.192,109658,56406,53252,10.641,20.688,-50333,-9.496,22.384,2454,2580,11170
2010,533,1980,2065,28650,30298,235,11.347,247,11.927,4098,1553,2545,5.126,13.526,7253,3983,3270,13.146,23.939,-3155,-10.413,27.051,173,173,1509
2010,541,644190,728402,7723625,7765226,86939,11.924,88355,12.118,1171693,448538,723155,5.776,15.089,1257655,405991,851664,5.228,16.196,-85962,-1.107,30.178,57126,57716,213636
2010,551,26850,50068,2837069,2842990,4115,8.168,4736,9.401,395550,125873,269677,4.427,13.913,406385,115438,290947,4.060,14.294,-10835,-0.381,27.826,913,983,15674
2010,561,254995,308180,8272110,8269089,38408,12.372,42932,13.829,1583247,441381,1141866,5.338,19.147,1578605,498198,1080407,6.025,19.090,4642,0.056,38.181,25790,26322,243338
2010,562,15871,20602,355797,358727,1895,9.226,1771,8.622,46573,18131,28442,5.054,12.983,52886,16800,36086,4.683,14.743,-6313,-1.760,25.966,1118,1143,8717
2010,611,70963,81627,3265393,3226998,8817,10.891,7474,9.232,294092,73277,220815,2.271,9.113,217245,50024,167221,1.550,6.732,76847,2.381,13.464,5162,5218,32635
2010,621,443012,533454,6148987,6091081,42339,8.017,31711,6.004,819390,292135,527255,4.796,13.452,703440,201579,501861,3.309,11.549,115950,1.904,23.097,21632,22119,116926
2010,622,3592,6578,5629262,5621006,173,2.641,120,1.832,185684,37493,148191,0.667,3.303,170727,24293,146434,0.432,3.037,14957,0.266,6.075,67,67,13983
2010,623,33833,77145,3231389,3205868,6255,8.232,3941,5.186,315487,134309,181178,4.189,9.841,263406,74199,189207,2.314,8.216,52081,1.625,16.433,1770,1877,35392
2010,624,108778,150438,2722575,2690763,14295,9.566,12292,8.226,385459,123476,261983,4.589,14.325,319783,83051,236732,3.087,11.884,65676,2.441,23.769,8276,8550,49717
2010,711,31265,32082,425321,427141,4592,14.254,4861,15.089,63822,21253,42569,4.976,14.942,67636,19514,48122,4.569,15.835,-3814,-0.893,29.883,3138,3151,13959
2010,712,6310,6793,126138,127386,328,4.837,303,4.469,10051,3028,7023,2.377,7.890,12706,2602,10104,2.043,9.974,-2655,-2.084,15.780,185,185,1796
2010,713,52487,60585,1443644,1448396,6295,10.363,6613,10.887,169843,67645,102198,4.670,11.726,180005,50384,129621,3.479,12.428,-10162,-0.702,23.453,5039,5106,38845
2010,721,45590,57011,1821933,1836201,4695,8.272,4189,7.380,188120,87106,101014,4.744,10.245,216093,57121,158972,3.111,11.768,-27973,-1.523,20.490,2701,2740,31276
2010,722,379689,530538,9483196,9542426,59088,11.208,52371,9.934,1320307,687665,632642,7.206,13.836,1430362,483351,947011,5.065,14.990,-110055,-1.153,27.672,39426,40444,334548
2010,811,178130,194755,1155083,1170466,16401,8.374,18595,9.494,159374,62625,96749,5.350,13.616,190099,63755,126344,5.447,16.241,-30725,-2.625,27.233,13031,13186,39971
2010,812,151871,189440,1306023,1309289,20495,10.835,19920,10.531,200750,87754,112996,6.702,15.333,206840,84199,122641,6.431,15.798,-6090,-0.465,30.665,13979,14181,53259
2010,813,282413,291314,2731669,2741408,15402,5.302,13780,4.743,263751,55349,208402,2.019,9.621,283577,45192,238385,1.648,10.344,-19826,-0.723,19.242,8943,9002,29652
2011,113,7583,7723,53289,53361,801,10.314,887,11.422,8250,2420,5830,4.535,15.461,8335,2782,5553,5.214,15.620,-85,-0.159,30.921,630,630,2059
2011,114,1383,1394,7547,7485,230,16.329,259,18.388,1545,568,977,7.589,20.643,1384,622,762,8.311,18.492,161,2.151,36.983,149,149,347
2011,115,8170,8714,92743,91928,994,11.393,1016,11.645,14491,4432,10059,4.821,15.764,12914,3984,8930,4.334,14.048,1577,1.715,28.096,697,697,2751
2011,211,5789,7160,114172,110972,707,9.962,581,8.187,19303,6649,12654,5.992,17.395,12884,3888,8996,3.504,11.610,6419,5.784,23.220,379,386,1544
2011,212,3625,6190,199120,196430,448,7.225,469,7.564,23843,5214,18629,2.654,12.138,18278,4290,13988,2.184,9.305,5565,2.833,18.610,286,298,2554
2011,213,9519,11895,335449,310782,1654,14.210,1144,9.828,90426,21462,68964,6.906,29.096,40742,12300,28442,3.958,13.110,49684,15.987,26.219,739,742,6210
2011,221,5436,17144,642280,642466,990,5.761,1073,6.244,48163,17624,30539,2.743,7.497,48676,16271,32405,2.533,7.576,-513,-0.080,14.993,198,206,1033
2011,236,154809,157559,1086174,1116492,26688,16.630,32528,20.269,224342,81768,142574,7.324,20.093,284434,100627,183807,9.013,25.476,-60092,-5.382,40.187,20703,20763,63499
2011,237,34330,36933,833011,839505,3390,9.036,4558,12.149,145479,28113,117366,3.349,17.329,157420,31559,125861,3.759,18.752,-11941,-1.422,34.658,3021,3035,17664
2011,238,353323,360023,3249887,3307697,44451,12.165,55177,15.101,600228,148794,451434,4.498,18.146,715478,199068,516410,6.018,21.631,-115250,-3.484,36.293,35387,35458,138345
2011,311,19542,23653,1421885,1423945,1921,8.178,1596,6.794,104605,21729,82876,1.526,7.346,108603,25218,83385,1.771,7.627,-3998,-0.281,14.692,1165,1166,12529
2011,312,3582,4190,144441,141965,567,14.003,285,7.039,18488,4922,13566,3.467,13.023,13482,3912,9570,2.756,9.497,5006,3.526,18.993,197,199,1149
2011,313,2053,2316,109787,109683,152,6.514,187,8.014,10563,2121,8442,1.934,9.631,10319,3071,7248,2.800,9.408,244,0.222,18.816,138,139,1217
2011,314,5439,5681,112228,112483,463,8.044,612,10.633,12134,2599,9535,2.311,10.787,12753,3920,8833,3.485,11.338,-619,-0.550,21.575,458,458,2547
2011,315,5763,5852,110946,113819,864,14.555,1032,17.385,17313,7092,10221,6.231,15.211,23004,9964,13040,8.754,20.211,-5691,-5.000,30.422,880,881,8106
2011,316,1008,1048,28405,27748,93,8.757,121,11.394,4079,591,3488,2.130,14.700,2684,1138,1546,4.101,9.673,1395,5.027,19.346,95,95,371
2011,321,11539,13275,345747,348882,859,6.370,1280,9.492,36779,8028,28751,2.301,10.542,42812,15298,27514,4.385,12.271,-6033,-1.729,21.084,893,907,8164
2011,322,2804,4392,362049,363660,150,3.375,255,5.737,22025,5061,16964,1.392,6.056,25293,10985,14308,3.021,6.955,-3268,-0.899,12.113,149,151,2535
2011,323,25342,26654,481125,490693,1499,5.514,2563,9.428,36895,8455,28440,1.723,7.519,55853,21207,34646,4.322,11.382,-18958,-3.864,15.038,2028,2041,12629
2011,324,972,2113,98229,98691,108,5.061,150,7.029,5468,1235,4233,1.251,5.541,6464,1081,5383,1.095,6.550,-996,-1.009,11.081,69,69,427
2011,325,9005,12483,725192,725608,795,6.366,805,6.446,56954,13207,43747,1.820,7.849,57915,12359,45556,1.703,7.982,-961,-0.132,15.698,532,551,5569
2011,326,9686,12394,685540,675916,538,4.313,700,5.611,69595,10477,59118,1.550,10.296,50323,16696,33627,2.470,7.445,19272,2.851,14.890,445,451,6737
2011,327,9205,14772,339032,341906,742,4.955,1149,7.673,31289,5244,26045,1.534,9.151,36976,8935,28041,2.613,10.815,-5687,-1.663,18.303,615,646,4309
2011,331,3482,4381,371347,361087,248,5.665,241,5.505,38603,4354,34249,1.206,10.691,18315,4976,13339,1.378,5.072,20288,5.619,10.144,167,169,2139
2011,332,49107,53015,1331201,1304719,2919,5.488,3270,6.148,166557,27352,139205,2.096,12.766,113220,30204,83016,2.315,8.678,53337,4.088,17.355,2303,2314,16889
2011,333,20708,23008,970848,949473,1275,5.532,1352,5.866,111341,15348,95993,1.616,11.727,68068,22834,45234,2.405,7.169,43273,4.558,14.338,943,954,8996
2011,334,10839,12361,870782,868034,838,6.756,923,7.441,76693,12959,63734,1.493,8.835,71662,21474,50188,2.474,8.256,5031,0.580,16.511,632,633,7461
2011,335,4729,5488,331410,328918,345,6.257,397,7.200,30638,6804,23834,2.069,9.315,25535,10072,15463,3.062,7.763,5103,1.551,15.527,254,254,2486
2011,336,9060,10972,1206610,1191841,727,6.569,917,8.286,126160,18738,107422,1.572,10.585,97653,25790,71863,2.164,8.193,28507,2.392,16.387,598,614,7247
2011,337,14807,15351,334531,339699,1071,6.794,1896,12.028,32291,6196,26095,1.824,9.506,42647,13982,28665,4.116,12.554,-10356,-3.049,19.012,1381,1389,8578
2011,339,24774,26053,557493,555808,2002,7.640,2302,8.785,56406,12979,43427,2.335,10.148,53083,16360,36723,2.943,9.551,3323,0.598,19.101,1718,1724,9089
2011,423,156589,226892,3174971,3162408,17554,7.740,17381,7.663,397038,118341,278697,3.742,12.555,371323,135762,235561,4.293,11.742,25715,0.813,23.484,10798,11241,57575
2011,424,88144,119098,2164622,2160499,10073,8.456,10122,8.497,244447,76379,168068,3.535,11.314,237330,72310,165020,3.347,10.985,7117,0.329,21.970,6759,6907,36720
2011,425,38366,40680,299064,297329,4655,11.368,5192,12.679,48413,14416,33997,4.849,16.283,44199,16516,27683,5.555,14.865,4214,1.417,29.731,3909,3941,12672
2011,441,75896,109987,1658585,1643053,7093,6.425,7912,7.167,185956,55742,130214,3.393,11.318,155044,53717,101327,3.269,9.436,30912,1.881,18.873,5814,6001,40767
2011,442,33381,49739,422550,423606,3535,6.989,5223,10.326,55578,17245,38333,4.071,13.120,57699,19834,37865,4.682,13.621,-2121,-0.501,26.240,3523,3784,12262
2011,443,24682,47523,440597,433074,6200,13.249,4746,10.142,71424,34585,36839,7.986,16.492,55620,18478,37142,4.267,12.843,15804,3.649,25.686,3024,3349,12300
2011,444,51562,77818,1194000,1199412,3568,4.538,5174,6.581,86330,19540,66790,1.629,7.198,97120,22075,75045,1.840,8.097,-10790,-0.900,14.395,3486,3671,14944
2011,445,100600,134626,2834201,2824528,13564,10.123,12305,9.183,252752,105309,147443,3.728,8.948,232922,72356,160566,2.562,8.246,19830,0.702,16.493,9075,9227,39489
2011,446,39363,88059,964904,977392,7841,9.016,5653,6.500,115408,45360,70048,4.641,11.808,142347,40677,101670,4.162,14.564,-26939,-2.756,23.615,2900,2967,13044
2011,447,62040,107889,853027,853776,7769,7.202,7731,7.167,115012,43154,71858,5.054,13.471,115754,38672,77082,4.530,13.558,-742,-0.087,26.942,5134,5471,25536
2011,448,53752,139977,1658632,1595326,11294,8.077,10989,7.859,315828,87636,228192,5.493,19.797,189922,67801,122121,4.250,11.905,125906,7.892,23.810,5727,6264,21676
2011,451,29264,44309,519030,521476,3537,7.930,4130,9.259,56920,18637,38283,3.574,10.915,61645,18425,43220,3.533,11.821,-4725,-0.906,21.830,2851,2957,9942
2011,452,7216,45535,2835610,2813318,2635,5.856,1557,3.460,180180,40788,139392,1.450,6.405,135442,12527,122915,0.445,4.814,44738,1.590,9.629,920,984,3530
2011,453,73434,98854,714782,716057,9457,9.486,11128,11.163,101080,38998,62082,5.446,14.116,103406,39957,63449,5.580,14.441,-2326,-0.325,28.232,7847,8094,24495
2011,454,44418,51805,551021,547007,6126,11.891,5549,10.771,83750,27419,56331,5.013,15.311,75438,28074,47364,5.132,13.791,8312,1.520,27.582,4108,4166,15608
2011,481,2321,4741,424080,418541,372,7.837,383,8.069,30982,4672,26310,1.116,7.402,19516,3371,16145,0.805,4.663,11466,2.740,9.326,214,218,1378
2011,483,1059,1470,63324,62652,145,9.791,167,11.276,7491,2666,4825,4.255,11.957,6012,2045,3967,3.264,9.596,1479,2.361,19.192,102,102,1384
2011,484,81137,94368,1313930,1289309,14520,15.503,13100,13.987,213546,67588,145958,5.242,16.563,164287,60981,103306,4.730,12.742,49259,3.821,25.485,9125,9203,36033
2011,485,13750,16548,448416,443420,2085,12.669,1904,11.569,53263,18387,34876,4.147,12.012,43301,17294,26007,3.900,9.765,9962,2.247,19.530,1369,1377,8664
2011,486,172,3236,45250,44194,499,16.175,197,6.386,9490,3925,5565,8.881,21.474,7182,2150,5032,4.865,16.251,2308,5.222,32.503,13,13,57
2011,487,1753,1867,22455,21942,275,14.801,257,13.832,3672,1007,2665,4.589,16.735,2594,751,1843,3.423,11.822,1078,4.913,23.645,164,167,536
2011,488,28712,38619,593646,587594,4026,10.458,3781,9.822,88449,28352,60097,4.825,15.053,76567,28739,47828,4.891,13.031,11882,2.022,26.061,2282,2346,10392
2011,492,7893,12781,522305,518949,2513,20.260,1758,14.173,36064,10288,25776,1.982,6.949,28064,10395,17669,2.003,5.408,8000,1.542,10.816,1007,1025,3975
2011,493,6838,14164,681744,676527,1016,7.172,1019,7.194,87745,26004,61741,3.844,12.970,75011,17904,57107,2.646,11.088,12734,1.882,22.175,334,345,3015
2011,511,17878,26203,874579,885236,2292,8.689,2643,10.020,93592,25768,67824,2.911,10.573,115688,44904,70784,5.073,13.069,-22096,-2.496,21.145,1389,1418,12426
2011,512,15364,19054,310840,311698,2823,14.933,2523,13.346,44849,17419,27430,5.588,14.389,46957,13806,33151,4.429,15.065,-2108,-0.676,28.777,1576,1591,5764
2011,515,4437,9506,260655,262119,1174,12.249,1331,13.887,34843,18966,15877,7.236,13.293,37555,14921,22634,5.692,14.327,-2712,-1.035,26.586,251,256,2237
2011,517,8058,49138,1105012,1111088,6966,14.251,6454,13.203,159240,82165,77075,7.395,14.332,171618,66405,105213,5.977,15.446,-12378,-1.114,28.664,992,1043,7638
2011,518,7920,12551,419234,405444,1927,15.795,1225,10.041,98706,38743,59963,9.556,24.345,71736,19426,52310,4.791,17.693,26970,6.652,35.386,716,730,6941
2011,519,6678,8679,177091,169276,1555,18.499,1009,12.003,35589,13142,22447,7.764,21.024,19522,7010,12512,4.141,11.533,16067,9.492,23.065,708,717,3197
2011,521,12,47,18039,18449,0,0.000,D,D,468,0,468,0.000,2.537,1355,D,514,D,7.345,-887,-4.808,5.073,0,0,0
2011,522,38946,190785,2758098,2753719,12889,6.696,16272,8.454,367331,104400,262931,3.791,13.339,360668,111347,249321,4.044,13.097,6663,0.242,26.195,4423,5078,24885
2011,523,49524,84854,870130,872292,10680,12.593,10595,12.492,126893,45929,80964,5.265,14.547,131092,57688,73404,6.613,15.028,-4199,-0.481,29.094,4364,4436,16792
2011,524,122450,161769,2229739,2248099,13889,8.515,16580,10.165,246482,94922,151560,4.222,10.964,283690,94754,188936,4.215,12.619,-37208,-1.655,21.928,8500,8670,27076
2011,525,523,536,4320,5162,109,19.534,153,27.419,522,306,216,5.928,10.112,2158,934,1224,18.094,41.806,-1636,-31.693,20.225,132,132,880
2011,531,197684,247424,1387256,1393512,28797,11.629,29209,11.795,209481,93816,115665,6.732,15.033,221797,95124,126673,6.826,15.916,-12316,-0.884,30.065,18599,18897,53271
2011,532,21118,49491,488893,495827,5663,11.096,8754,17.152,75641,30805,44836,6.213,15.256,91035,53887,37148,10.868,18.360,-15394,-3.105,30.511,2270,5339,28199
2011,533,1938,2049,29069,28904,267,13.028,268,13.076,4986,1962,3024,6.788,17.251,4697,2266,2431,7.840,16.251,289,1.000,32.501,200,200,829
2011,541,645641,732492,7844558,7791906,89578,12.264,85422,11.695,1268587,407532,861055,5.230,16.281,1168546,418412,750134,5.370,14.997,100041,1.284,29.994,56381,56957,206566
2011,551,26562,50568,2955969,2905433,4291,8.530,3760,7.475,472876,146118,326758,5.029,16.276,370517,89504,281013,3.081,12.753,102359,3.523,25.505,831,864,12898
2011,561,254530,307268,8702064,8488792,38958,12.664,39658,12.892,1803457,376390,1427067,4.434,21.245,1365447,462177,903270,5.445,16.085,438010,5.160,32.171,24303,24784,215806
2011,562,15958,21798,363084,359239,2899,13.645,1795,8.449,63369,28367,35002,7.896,17.640,56346,15066,41280,4.194,15.685,7023,1.955,31.370,1143,1152,7585
2011,611,72374,83444,3387189,3326751,9052,10.962,7319,8.863,342079,81521,260558,2.450,10.283,220385,47208,173177,1.419,6.625,121694,3.658,13.249,5020,5077,28270
2011,621,445714,540349,6319773,6238389,41420,7.715,34510,6.428,838148,274858,563290,4.406,13.435,674376,215296,459080,3.451,10.810,163772,2.625,21.620,23806,24445,133449
2011,622,3506,6549,5646680,5627261,114,1.742,108,1.650,218933,25660,193273,0.456,3.891,178332,28179,150153,0.501,3.169,40601,0.722,6.338,54,54,10435
2011,623,34028,77922,3252671,3239242,4971,6.416,4091,5.280,281628,96108,185520,2.967,8.694,256223,85967,170256,2.654,7.910,25405,0.784,15.820,1938,2208,47740
2011,624,109281,151711,2785175,2754782,13079,8.666,11514,7.629,354935,94837,260098,3.443,12.884,294433,80744,213689,2.931,10.688,60502,2.196,21.376,7867,8009,50423
2011,711,31553,32399,426504,426508,4850,15.027,4601,14.256,69614,19458,50156,4.562,16.322,70260,19030,51230,4.462,16.473,-646,-0.151,32.644,3013,3019,11690
2011,712,6323,6794,128888,127513,314,4.617,327,4.808,10338,1150,9188,0.902,8.107,7603,1186,6417,0.930,5.963,2735,2.145,11.925,195,195,888
2011,713,52037,60284,1440967,1442052,6425,10.650,6511,10.793,171277,62449,108828,4.331,11.877,173423,51606,121817,3.579,12.026,-2146,-0.149,23.755,4893,4958,37530
2011,721,45614,57341,1864939,1846868,4362,7.622,4140,7.234,191080,74319,116761,4.024,10.346,156068,55208,100860,2.989,8.450,35012,1.896,16.901,2750,2802,36726
2011,722,384705,537403,9693462,9596374,58557,10.966,51755,9.692,1424998,690172,734826,7.192,14.849,1226545,448806,777739,4.677,12.781,198453,2.068,25.563,40115,41186,327780
2011,811,177453,193814,1163418,1159969,17145,8.824,18113,9.322,171078,62222,108856,5.364,14.749,164406,59302,105104,5.112,14.173,6672,0.575,28.347,12747,12979,38978
2011,812,153100,190915,1308625,1307365,20984,11.034,19489,10.248,198704,83011,115693,6.349,15.199,197391,74277,123114,5.681,15.098,1313,0.100,30.197,14071,14367,51781
2011,813,281557,290600,2709199,2721479,15014,5.160,15726,5.405,266762,50615,216147,1.860,9.802,291657,51097,240560,1.878,10.717,-24895,-0.915,19.604,10188,10203,33328
2012,113,7560,7692,52538,52895,743,9.640,774,10.042,7778,2236,5542,4.227,14.705,8585,2929,5656,5.537,16.230,-807,-1.526,29.409,542,542,1995
2012,114,1440,1451,7686,7626,254,17.837,200,14.045,1425,594,831,7.789,18.686,1316,453,863,5.940,17.257,109,1.429,34.514,116,116,258
2012,115,8384,8923,96307,95139,1028,11.636,852,9.643,15934,4549,11385,4.781,16.748,13574,3695,9879,3.884,14.268,2360,2.481,28.535,590,593,2428
2012,211,5898,7323,127985,121348,674,9.276,560,7.707,23294,6451,16843,5.316,19.196,10277,4354,5923,3.588,8.469,13017,10.727,16.938,360,365,1680
2012,212,3599,6164,204555,202500,468,7.576,495,8.013,31340,7264,24076,3.587,15.477,27513,9302,18211,4.594,13.587,3827,1.890,27.173,235,240,2263
2012,213,10242,12788,393518,364556,1877,15.119,1131,9.110,101169,27263,73906,7.478,27.751,43767,15361,28406,4.214,12.006,57402,15.746,24.011,714,729,7950
2012,221,5489,17324,642577,642806,946,5.486,784,4.547,45921,15082,30839,2.346,7.144,46709,9668,37041,1.504,7.266,-788,-0.123,14.288,197,204,1748
2012,236,155576,158068,1080985,1072862,27549,17.522,25857,16.446,235219,80824,154395,7.533,21.924,218462,82837,135625,7.721,20.363,16757,1.562,40.725,16113,16142,51445
2012,237,33041,35530,857162,836501,3285,9.175,3831,10.700,160118,25349,134769,3.030,19.141,119793,28177,91616,3.368,14.321,40325,4.821,28.641,2428,2442,14785
2012,238,357695,364178,3362207,3321274,46023,12.673,44011,12.119,665472,154903,510569,4.664,20.037,582622,183182,399440,5.515,17.542,82850,2.495,35.084,28591,28721,125545
2012,311,19981,24136,1418984,1419763,2029,8.467,1683,7.023,112819,23898,88921,1.683,7.946,113813,29199,84614,2.057,8.016,-994,-0.070,15.893,1243,1253,15600
2012,312,3882,4506,150146,148317,582,13.324,306,7.005,16047,4184,11863,2.821,10.819,12485,3124,9361,2.106,8.418,3562,2.402,16.836,213,216,1239
2012,313,1984,2230,106139,107356,105,4.637,174,7.684,7522,1208,6314,1.125,7.007,10023,3890,6133,3.623,9.336,-2501,-2.330,14.013,127,128,1908
2012,314,5580,5818,113125,113150,431,7.354,517,8.821,12831,3526,9305,3.116,11.340,12826,3654,9172,3.229,11.335,5,0.004,22.671,378,386,1957
2012,315,5492,5571,108913,107937,849,15.136,925,16.491,18574,6274,12300,5.813,17.208,16481,8733,7748,8.091,15.269,2093,1.939,30.538,792,795,7092
2012,316,994,1028,26726,26420,90,8.717,99,9.588,3200,1507,1693,5.704,12.112,2681,929,1752,3.516,10.148,519,1.964,20.296,72,73,395
2012,321,11266,12936,341407,342816,774,5.908,1104,8.427,36350,7052,29298,2.057,10.603,39248,13294,25954,3.878,11.449,-2898,-0.845,21.207,743,763,7569
2012,322,2768,4324,354566,359600,139,3.178,239,5.464,18167,3694,14473,1.027,5.052,27843,9691,18152,2.695,7.743,-9676,-2.691,10.104,126,130,3350
2012,323,24928,26190,473332,479187,1407,5.293,2196,8.260,38512,10058,28454,2.099,8.037,50355,19284,31071,4.024,10.508,-11843,-2.471,16.074,1718,1725,11098
2012,324,948,2131,98723,99102,120,5.627,123,5.768,5933,730,5203,0.737,5.987,6821,2011,4810,2.029,6.883,-888,-0.896,11.974,51,51,377
2012,325,9290,12795,741566,736973,725,5.673,695,5.438,58164,9960,48204,1.351,7.892,48808,11961,36847,1.623,6.623,9356,1.270,13.246,441,446,6481
2012,326,9634,12351,701844,697599,482,3.872,674,5.415,62452,11184,51268,1.603,8.952,53761,14013,39748,2.009,7.707,8691,1.246,15.413,432,433,5504
2012,327,9172,14644,346188,345177,816,5.519,1096,7.413,37955,7649,30306,2.216,10.996,35529,8950,26579,2.593,10.293,2426,0.703,20.586,552,577,3440
2012,331,3461,4380,395872,385044,203,4.624,224,5.102,37794,4129,33665,1.072,9.816,16178,3594,12584,0.933,4.202,21616,5.614,8.403,142,144,1877
2012,332,49185,53051,1382664,1352252,2826,5.323,2907,5.475,159581,26896,132685,1.989,11.801,98835,32042,66793,2.370,7.309,60746,4.492,14.618,2062,2074,19167
2012,333,20860,23221,1046819,1017959,1054,4.523,1214,5.210,122146,16735,105411,1.644,11.999,64757,18141,46616,1.782,6.361,57389,5.638,12.723,839,844,8673
2012,334,11027,12539,854675,867838,815,6.475,909,7.222,65801,14278,51523,1.645,7.582,92644,23708,68936,2.732,10.675,-26843,-3.093,15.164,619,623,11366
2012,335,4727,5464,333314,330123,323,5.927,294,5.395,29313,4274,25039,1.295,8.879,23016,6346,16670,1.922,6.972,6297,1.907,13.944,193,193,1878
2012,336,9384,11316,1294643,1259100,729,6.441,734,6.485,159011,17563,141448,1.395,12.629,86984,24926,62058,1.980,6.908,72027,5.721,13.817,459,462,7484
2012,337,14631,15215,340949,341297,1098,7.101,1592,10.296,35553,6540,29013,1.916,10.417,36430,12748,23682,3.735,10.674,-877,-0.257,20.834,1099,1104,7567
2012,339,25162,26423,546947,542248,2746,10.538,2017,7.740,60483,18243,42240,3.364,11.154,51038,15771,35267,2.908,9.412,9445,1.742,18.825,1510,1512,8711
2012,423,160208,230017,3292177,3244630,17091,7.420,17739,7.701,461248,112999,348249,3.483,14.216,365334,118355,246979,3.648,11.260,95914,2.956,22.519,9381,9800,52907
2012,424,90221,120886,2201656,2193717,9709,8.002,10613,8.747,276932,73705,203227,3.360,12.624,260389,82642,177747,3.767,11.870,16543,0.754,23.740,6347,6533,38342
2012,425,34592,36871,272036,277237,4416,11.887,4973,13.386,53383,14917,38466,5.381,19.255,62759,19678,43081,7.098,22.637,-9376,-3.382,38.511,3616,3655,11636
2012,441,76037,110358,1715723,1684371,7437,6.750,7091,6.436,203871,55516,148355,3.296,12.104,141635,47224,94411,2.804,8.409,62236,3.695,16.818,4748,4875,30461
2012,442,32232,48609,423235,421637,4181,8.517,5142,10.475,61351,25333,36018,6.008,14.551,57986,24395,33591,5.786,13.753,3365,0.798,27.505,2891,3174,12623
2012,443,23557,45307,416422,420759,4546,9.936,5440,11.890,64583,22351,42232,5.312,15.349,73116,26351,46765,6.263,17.377,-8533,-2.028,30.698,2922,3199,13261
2012,444,49477,74594,1167394,1167826,3559,4.722,5125,6.799,92997,18672,74325,1.599,7.963,93333,26196,67137,2.243,7.992,-336,-0.029,15.927,3195,3356,13792
2012,445,100755,134858,2881828,2852942,13965,10.436,11876,8.875,301886,108120,193766,3.790,10.582,247392,76420,170972,2.679,8.671,54494,1.910,17.343,8663,8768,38159
2012,446,39481,86623,997513,972666,5598,6.449,5962,6.868,161181,34240,126941,3.520,16.571,108166,36670,71496,3.770,11.121,53015,5.450,22.241,2847,2971,13070
2012,447,62041,108081,856193,854021,7895,7.306,7844,7.259,126528,45715,80813,5.353,14.816,121775,39864,81911,4.668,14.259,4753,0.557,28.518,5016,5220,24593
2012,448,53464,138995,1630418,1637398,10523,7.555,11110,7.976,256020,84250,171770,5.145,15.636,271656,82028,189628,5.010,16.591,-15636,-0.955,31.272,5135,5578,21243
2012,451,28640,43079,513753,515599,3689,8.486,4473,10.290,66994,22497,44497,4.363,12.993,69208,33974,35234,6.589,13.423,-2214,-0.429,25.987,2523,3253,26151
2012,452,7130,46910,2866592,2853173,2912,6.300,1540,3.332,162749,44384,118365,1.556,5.704,134867,13575,121292,0.476,4.727,27882,0.977,9.454,900,981,3158
2012,453,72371,97638,710058,707106,9927,10.158,10112,10.347,107468,41475,65993,5.865,15.198,101767,38459,63308,5.439,14.392,5701,0.806,28.784,6895,7099,22121
2012,454,48176,55190,581579,568275,7686,14.182,5694,10.507,108805,36679,72126,6.454,19.147,82275,28275,54000,4.976,14.478,26530,4.669,28.956,4010,4105,16047
2012,481,2289,4641,434375,425464,343,7.347,398,8.525,33200,4944,28256,1.162,7.803,15634,2941,12693,0.691,3.675,17566,4.129,7.349,195,198,782
2012,483,952,1344,65009,64350,143,10.648,141,10.499,7016,1795,5221,2.789,10.903,5735,1741,3994,2.706,8.912,1281,1.991,17.825,82,82,297
2012,484,83884,96929,1334470,1316868,15069,15.780,12196,12.772,205818,66137,139681,5.022,15.629,169740,61171,108569,4.645,12.890,36078,2.740,25.779,8654,8750,38995
2012,485,14074,16857,462910,458152,2145,12.814,1910,11.410,55270,17566,37704,3.834,12.064,46581,16975,29606,3.705,10.167,8689,1.897,20.334,1398,1404,10256
2012,486,167,3425,46415,45301,453,13.692,220,6.650,9044,4253,4791,9.388,19.964,6597,2407,4190,5.313,14.563,2447,5.402,29.126,4,4,21
2012,487,1751,1867,23905,22908,269,14.447,259,13.910,4273,1177,3096,5.138,18.653,2315,1036,1279,4.522,10.106,1958,8.547,20.211,183,183,810
2012,488,29221,39292,615513,608023,3890,9.931,3649,9.315,96917,28764,68153,4.731,15.940,82203,27374,54829,4.502,13.520,14714,2.420,27.039,2120,2178,10841
2012,492,7871,12822,530362,528341,1329,10.419,1197,9.384,28409,8094,20315,1.532,5.377,23817,5802,18015,1.098,4.508,4592,0.869,9.016,897,903,3240
2012,493,6711,13975,713539,708481,956,6.788,1172,8.322,89867,25095,64772,3.542,12.684,79198,20347,58851,2.872,11.179,10669,1.506,22.357,324,340,3814
2012,511,17642,26154,872256,877606,2099,7.986,2360,8.979,102407,37379,65028,4.259,11.669,113065,39672,73393,4.520,12.883,-10658,-1.214,23.338,1283,1341,11805
2012,512,15909,19526,341737,326654,2914,15.082,2504,12.960,70463,17685,52778,5.414,21.571,43132,12636,30496,3.868,13.204,27331,8.367,26.408,1498,1523,6314
2012,515,4402,9227,270618,264919,560,6.004,761,8.159,35790,8795,26995,3.320,13.510,24097,8392,15705,3.168,9.096,11693,4.414,18.192,255,268,1764
2012,517,7629,48290,1060412,1082250,5559,11.350,6934,14.158,140423,54579,85844,5.043,12.975,186585,73167,113418,6.761,17.240,-46162,-4.265,25.950,876,973,6299
2012,518,8783,13393,490072,477642,1969,14.661,2043,15.212,107299,28411,78888,5.948,22.464,82051,37331,44720,7.816,17.178,25248,5.286,34.357,675,703,6550
2012,519,7362,9323,211541,199483,1597,17.602,1097,12.091,48631,19050,29581,9.550,24.379,23947,8370,15577,4.196,12.005,24684,12.374,24.009,690,697,3353
2012,521,13,57,17939,17989,D,D,D,D,799,D,698,D,4.442,855,D,851,D,4.753,-56,-0.311,8.883,0,0,0
2012,522,37737,190861,2797410,2786207,14627,7.674,14093,7.394,411871,114702,297169,4.117,14.782,390222,150672,239550,5.408,14.005,21649,0.777,28.011,3072,3516,19969
2012,523,50285,89147,899647,882844,12520,14.376,8401,9.647,143074,52462,90612,5.942,16.206,111080,38902,72178,4.406,12.582,31994,3.624,25.164,3985,4040,13997
2012,524,122707,162884,2275859,2260223,15368,9.459,14529,8.943,285107,112622,172485,4.983,12.614,253732,80329,173403,3.554,11.226,31375,1.388,22.452,7655,7875,23845
2012,525,422,423,4196,3114,114,26.481,129,29.965,2717,2394,323,76.891,87.265,445,340,105,10.920,14.293,2272,72.973,28.585,104,104,280
2012,531,201640,250318,1397853,1387371,28522,11.429,26987,10.814,230159,96107,134052,6.927,16.590,209158,85412,123746,6.156,15.076,21001,1.514,30.152,16093,16450,48595
2012,532,20380,49893,469548,477450,7528,15.192,6847,13.818,111284,56169,55115,11.764,23.308,125277,43843,81434,9.183,26.239,-13993,-2.931,46.616,1925,2369,10611
2012,533,1983,2137,33430,32139,293,13.979,211,10.067,5960,1935,4025,6.021,18.544,3241,890,2351,2.769,10.084,2719,8.460,20.169,150,150,627
2012,541,652872,737503,7919322,7876189,88655,12.077,81849,11.150,1296786,419091,877695,5.321,16.465,1206796,456202,750594,5.792,15.322,89990,1.143,30.644,52320,52921,213071
2012,551,26011,51374,3054139,3032965,4766,9.302,4494,8.771,480415,115777,364638,3.817,15.840,435939,129891,306048,4.283,14.373,44476,1.466,28.747,823,868,11363
2012,561,259809,311998,9099668,8879071,39733,12.840,34642,11.195,1704980,390543,1314437,4.398,19.202,1262413,415455,846958,4.679,14.218,442567,4.984,28.436,21879,22224,232205
2012,562,16222,21798,359139,361218,1855,8.489,1965,8.992,61578,16393,45185,4.538,17.047,65266,23967,41299,6.635,18.068,-3688,-1.021,34.095,1074,1093,6973
2012,611,74696,85867,3460096,3419783,9289,10.961,7045,8.313,314306,65521,248785,1.916,9.191,232483,54235,178248,1.586,6.798,81823,2.393,13.596,4693,4744,28220
2012,621,447148,544380,6384204,6299892,41932,7.733,37737,6.959,909663,281690,627973,4.471,14.439,740939,245790,495149,3.901,11.761,168724,2.678,23.522,24242,26402,155669
2012,622,3385,6496,5749218,5700748,134,2.067,110,1.696,316633,62196,254437,1.091,5.554,222346,27695,194651,0.486,3.900,94287,1.654,7.801,58,61,14085
2012,623,34424,78266,3325139,3300522,4707,6.030,4289,5.495,331845,113394,218451,3.436,10.054,282155,87735,194420,2.658,8.549,49690,1.506,17.098,1876,2014,50928
2012,624,111169,152736,2829241,2819193,13636,8.958,12616,8.288,376202,101785,274417,3.610,13.344,356463,102597,253866,3.639,12.644,19739,0.700,25.288,7655,7871,53392
2012,711,32220,33024,435685,430569,4990,15.258,4352,13.307,69353,20433,48920,4.746,16.107,59320,18529,40791,4.303,13.777,10033,2.330,27.554,2757,2766,11616
2012,712,6397,6840,136739,132998,362,5.324,281,4.133,14335,2117,12218,1.592,10.778,6952,1279,5673,0.962,5.227,7383,5.551,10.454,154,154,739
2012,713,52482,60952,1492894,1460084,6922,11.438,6051,9.999,214465,71852,142613,4.921,14.689,148546,48153,100393,3.298,10.174,65919,4.515,20.348,4386,4447,33062
2012,721,45833,57792,1943842,1927079,4698,8.157,4306,7.476,207735,89996,117739,4.670,10.780,174873,72107,102766,3.742,9.075,32862,1.705,18.149,2686,2735,40180
2012,722,392877,544290,10041138,9872158,61048,11.282,54651,10.100,1642383,721447,920936,7.308,16.637,1300400,504484,795916,5.110,13.172,341983,3.464,26.345,38610,39782,333253
2012,811,177983,194151,1165540,1155091,17501,9.049,16022,8.284,179659,60839,118820,5.267,15.554,157639,58258,99381,5.044,13.647,22020,1.906,27.295,11362,11566,37699
2012,812,155730,192928,1321243,1314827,21970,11.464,19390,10.118,224199,91141,133058,6.932,17.052,210826,81873,128953,6.227,16.035,13373,1.017,32.069,12937,13354,50375
2012,813,283799,292661,2737591,2719632,15553,5.332,13639,4.676,278340,56587,221753,2.081,10.234,242945,45720,197225,1.681,8.933,35395,1.301,17.866,8769,8808,29313
2013,113,7490,7650,53990,53228,761,9.919,806,10.505,8569,2946,5623,5.535,16.099,7054,2412,4642,4.531,13.252,1515,2.846,26.505,565,565,1784
2013,114,1448,1459,7368,7399,222,15.252,215,14.772,1180,434,746,5.866,15.948,1221,433,788,5.852,16.502,-41,-0.554,31.896,100,100,237
2013,115,8432,8954,92517,93762,988,11.042,976,10.907,13176,3879,9297,4.137,14.053,15763,7066,8697,7.536,16.812,-2587,-2.759,28.105,713,713,5492
2013,211,5873,7350,130727,129219,622,8.458,630,8.567,19914,6029,13885,4.666,15.411,16987,5488,11499,4.247,13.146,2927,2.265,26.292,390,393,1570
2013,212,3476,6056,203417,202932,401,6.564,508,8.315,22568,7854,14714,3.870,11.121,21488,4848,16640,2.389,10.589,1080,0.532,21.178,272,273,2160
2013,213,10416,12926,396618,394016,1665,12.996,1436,11.209,73594,20120,53474,5.106,18.678,68739,25812,42927,6.551,17.446,4855,1.232,34.891,892,922,9269
2013,221,5515,17453,635906,638521,1004,5.773,880,5.060,45986,17060,28926,2.672,7.202,51180,12002,39178,1.880,8.015,-5194,-0.813,14.404,206,215,2062
2013,236,157536,160083,1120392,1100100,26680,16.760,24895,15.638,246568,81404,165164,7.400,22.413,205578,75706,129872,6.882,18.687,40990,3.726,37.374,15616,15640,49923
2013,237,32129,34647,873261,865874,2835,8.082,3700,10.547,158442,28721,129721,3.317,18.299,144331,32909,111422,3.801,16.669,14111,1.630,33.338,2337,2380,21593
2013,238,356424,362908,3464059,3412486,41766,11.494,42703,11.752,649291,147157,502134,4.312,19.027,546069,164919,381150,4.833,16.002,103222,3.025,32.004,27163,27210,113804
2013,311,20371,24484,1424309,1422168,1962,8.041,1792,7.345,116740,22836,93904,1.606,8.209,112354,39283,73071,2.762,7.900,4386,0.308,15.800,1298,1314,14641
2013,312,4534,5157,159504,154963,872,17.955,271,5.580,18486,4821,13665,3.111,11.929,9377,2238,7139,1.444,6.051,9109,5.878,12.102,178,183,1011
2013,313,2049,2291,104822,105498,196,8.632,155,6.827,7903,1600,6303,1.517,7.491,9367,3027,6340,2.869,8.879,-1464,-1.388,14.982,102,105,817
2013,314,5617,5842,113037,113118,478,8.145,531,9.048,11674,2379,9295,2.103,10.320,11645,3738,7907,3.305,10.295,29,0.026,20.589,387,387,1943
2013,315,5593,5663,111704,110899,839,14.783,864,15.223,19456,9381,10075,8.459,17.544,17936,7694,10242,6.938,16.173,1520,1.371,32.347,745,745,6544
2013,316,993,1027,26285,26590,85,8.221,99,9.574,2407,316,2091,1.188,9.052,3026,961,2065,3.614,11.380,-619,-2.328,18.105,71,71,612
2013,321,11016,12666,353853,347212,784,6.125,1054,8.234,44189,8243,35946,2.374,12.727,30866,12318,18548,3.548,8.890,13323,3.837,17.779,739,745,7388
2013,322,2702,4256,352347,353166,144,3.364,193,4.509,19188,3967,15221,1.123,5.433,21009,6469,14540,1.832,5.949,-1821,-0.516,10.866,107,109,1928
2013,323,24194,25436,463451,468774,1343,5.198,2144,8.298,36179,9080,27099,1.937,7.718,46938,16668,30270,3.556,10.013,-10759,-2.295,15.436,1710,1714,10909
2013,324,921,2094,97748,98178,109,5.167,140,6.637,6062,1134,4928,1.155,6.174,6874,1441,5433,1.468,7.002,-812,-0.827,12.349,44,47,299
2013,325,9106,12597,743418,740873,639,5.052,740,5.851,65717,18563,47154,2.506,8.870,61722,13262,48460,1.790,8.331,3995,0.539,16.662,498,502,6661
2013,326,9481,12188,708820,705622,490,3.995,643,5.243,58772,9259,49513,1.312,8.329,52555,16336,36219,2.315,7.448,6217,0.881,14.896,417,429,8172
2013,327,8943,14329,351008,348620,662,4.570,974,6.724,38112,8065,30047,2.313,10.932,33802,9701,24101,2.783,9.696,4310,1.236,19.392,518,525,4557
2013,331,3455,4374,393794,394396,188,4.293,198,4.522,24138,4531,19607,1.149,6.120,25378,5428,19950,1.376,6.435,-1240,-0.314,12.240,142,143,1898
2013,332,48771,52664,1404718,1393760,2487,4.702,2941,5.560,135327,23529,111798,1.688,9.709,112939,31137,81802,2.234,8.103,22388,1.606,16.206,2137,2155,18402
2013,333,20705,23095,1053443,1048064,1028,4.437,1171,5.055,90813,14900,75913,1.422,8.665,80484,22701,57783,2.166,7.679,10329,0.986,15.359,803,805,8876
2013,334,10789,12272,841248,846589,666,5.378,890,7.187,59838,9896,49942,1.169,7.068,70923,18790,52133,2.219,8.378,-11085,-1.309,14.136,625,628,7985
2013,335,4702,5439,333093,333925,266,4.881,288,5.284,23221,3233,19988,0.968,6.954,24792,7830,16962,2.345,7.424,-1571,-0.470,13.908,191,191,2350
2013,336,9237,11168,1333190,1312238,700,6.247,775,6.916,135260,16934,118326,1.290,10.308,93357,23936,69421,1.824,7.114,41903,3.193,14.229,513,521,6328
2013,337,14361,14925,344599,343110,1037,6.882,1323,8.780,34053,6455,27598,1.881,9.925,30907,11348,19559,3.307,9.008,3146,0.917,18.016,925,930,6378
2013,339,23884,25144,543221,544114,2016,7.975,2288,9.051,49277,9997,39280,1.837,9.056,50871,15999,34872,2.940,9.349,-1594,-0.293,18.113,1741,1749,9837
2013,423,157778,228410,3344238,3316953,16650,7.280,17218,7.529,449042,144096,304946,4.344,13.538,394949,132380,262569,3.991,11.907,54093,1.631,23.814,10385,10723,59324
2013,424,89376,120091,2241533,2217722,9977,8.296,10328,8.588,296194,75690,220504,3.413,13.356,246351,84384,161967,3.805,11.108,49843,2.247,22.217,6550,6689,38113
2013,425,36343,38695,286469,282994,4518,11.709,4300,11.144,46792,21411,25381,7.566,16.535,39715,17562,22153,6.206,14.034,7077,2.501,28.068,3133,3143,9752
2013,441,75691,110503,1757857,1737354,7178,6.501,6992,6.333,190004,53882,136122,3.101,10.936,149562,44519,105043,2.562,8.609,40442,2.328,17.217,4845,4994,31194
2013,442,31457,48265,422753,422675,3712,7.666,4026,8.314,55903,17806,38097,4.213,13.226,55194,19526,35668,4.620,13.058,709,0.168,26.117,2583,2759,10217
2013,443,22853,44802,405637,413888,3489,7.676,4793,10.545,46778,16870,29908,4.076,11.302,63945,23042,40903,5.567,15.450,-17167,-4.148,22.604,2832,3035,11739
2013,444,48381,73752,1233251,1199371,3617,4.883,4269,5.763,133435,20108,113327,1.677,11.125,66520,19013,47507,1.585,5.546,66915,5.579,11.092,2845,2912,11637
2013,445,102343,136290,2906469,2895266,13718,10.129,12008,8.866,271470,107454,164016,3.711,9.376,246859,82437,164422,2.847,8.526,24611,0.850,17.053,8729,8880,39604
2013,446,39715,87809,1007012,1003015,6189,7.094,5048,5.786,110683,31574,79109,3.148,11.035,104618,37948,66670,3.783,10.430,6065,0.605,20.861,3010,3185,15760
2013,447,61600,107641,883126,869419,7546,6.991,8145,7.546,137404,45375,92029,5.219,15.804,110231,40810,69421,4.694,12.679,27173,3.125,25.357,5434,5683,25764
2013,448,53126,138416,1720983,1676177,10171,7.335,10684,7.704,274377,80659,193718,4.812,16.369,184298,65380,118918,3.901,10.995,90079,5.374,21.990,5089,5768,24789
2013,451,28428,43126,535265,525378,3462,8.024,3502,8.117,70172,22053,48119,4.198,13.356,50395,14957,35438,2.847,9.592,19777,3.764,19.184,2388,2430,8017
2013,452,7179,48395,2796815,2832564,2939,6.164,1508,3.163,125838,42600,83238,1.504,4.443,194560,18492,176068,0.653,6.869,-68722,-2.426,8.885,890,898,2892
2013,453,72211,97866,730512,719487,9303,9.515,9116,9.324,114009,41553,72456,5.775,15.846,92259,33652,58607,4.677,12.823,21750,3.023,25.646,6766,6874,22681
2013,454,49074,55972,600455,589431,7759,14.038,6359,11.505,106788,44291,62497,7.514,18.117,83756,32806,50950,5.566,14.210,23032,3.907,28.419,4525,4564,16026
2013,481,2296,4532,419910,427695,496,10.771,642,13.941,65637,7981,57656,1.866,15.347,81794,53628,28166,12.539,19.124,-16157,-3.778,30.693,209,210,949
2013,483,1009,1378,66570,66495,163,11.885,150,10.937,6255,1405,4850,2.113,9.407,6107,2765,3342,4.158,9.184,148,0.223,18.368,79,79,320
2013,484,84775,98377,1368010,1351944,14151,14.484,12794,13.095,203376,67430,135946,4.988,15.043,171368,63089,108279,4.667,12.676,32008,2.368,25.351,8851,8918,36811
2013,485,14356,17114,471345,466975,2107,12.381,1916,11.258,54594,17096,37498,3.661,11.691,46334,22767,23567,4.875,9.922,8260,1.769,19.844,1373,1384,12243
2013,486,202,3632,50239,48515,317,8.970,121,3.424,8994,2560,6434,5.277,18.539,5641,2128,3513,4.386,11.627,3353,6.911,23.255,10,10,40
2013,487,1771,1891,24528,24252,223,11.859,202,10.742,3327,840,2487,3.464,13.718,2774,733,2041,3.022,11.438,553,2.280,22.876,144,144,435
2013,488,29381,39229,635224,623308,3822,9.752,3746,9.558,96795,27098,69697,4.347,15.529,73595,25210,48385,4.045,11.807,23200,3.722,23.614,2231,2283,13003
2013,492,7864,12660,523593,527210,1095,8.561,1356,10.602,28585,7560,21025,1.434,5.422,36399,6742,29657,1.279,6.904,-7814,-1.482,10.844,819,832,3188
2013,493,6838,13895,721968,716074,1261,9.033,1392,9.971,94403,26119,68284,3.648,13.183,81511,28169,53342,3.934,11.383,12892,1.800,22.766,315,332,3559
2013,511,17365,25353,865305,868140,1827,7.099,2594,10.079,115311,36318,78993,4.183,13.283,121183,48986,72197,5.643,13.959,-5872,-0.676,26.565,1346,1378,14031
2013,512,15992,19502,334760,330383,2753,14.178,2583,13.303,44606,17170,27436,5.197,13.501,36002,14021,21981,4.244,10.897,8604,2.604,21.794,1659,1677,7851
2013,515,4391,9407,275696,273660,625,6.670,551,5.880,31348,8752,22596,3.198,11.455,27173,6352,20821,2.321,9.929,4175,1.526,19.859,278,334,3451
2013,517,7716,46672,1072866,1066277,5896,12.523,6717,14.266,198965,92545,106420,8.679,18.660,187059,88501,98558,8.300,17.543,11906,1.117,35.086,863,939,5492
2013,518,8633,13581,505476,492138,1941,14.516,1522,11.382,88063,24928,63135,5.065,17.894,61699,25369,36330,5.155,12.537,26364,5.357,25.074,765,782,8476
2013,519,7787,9752,219489,214899,1641,17.184,1236,12.943,40524,16497,24027,7.677,18.857,31493,9847,21646,4.582,14.655,9031,4.202,29.310,819,821,4807
2013,521,13,57,18502,18221,0,0.000,0,0.000,778,0,778,0.000,4.270,227,0,227,0.000,1.246,551,3.024,2.492,0,0,0
2013,522,37571,188594,2836873,2815133,10489,5.528,12787,6.739,368495,92515,275980,3.286,13.090,326379,95692,230687,3.399,11.594,42116,1.496,23.187,2558,2844,17279
2013,523,50931,86784,871345,883479,9922,11.302,11927,13.586,110648,41127,69521,4.655,12.524,132862,52913,79949,5.989,15.039,-22214,-2.514,25.048,4008,4053,23533
2013,524,122231,161995,2320775,2297349,14750,9.088,15371,9.470,283750,81484,202266,3.547,12.351,236927,88723,148204,3.862,10.313,46823,2.038,20.626,7692,7870,30341
2013,525,647,668,5603,5326,187,29.801,106,16.892,1269,920,349,17.274,23.827,703,392,311,7.360,13.199,566,10.627,26.399,87,87,265
2013,531,206835,257293,1431790,1415168,33239,13.118,25408,10.028,241522,113441,128081,8.016,17.067,208195,85333,122862,6.030,14.712,33327,2.355,29.423,15569,15854,50280
2013,532,20294,48973,483743,477561,4180,8.456,5096,10.309,90181,28008,62173,5.865,18.884,77575,32640,44935,6.835,16.244,12606,2.640,32.488,1786,1891,8053
2013,533,2034,2211,35115,34386,295,13.573,220,10.122,5850,1912,3938,5.560,17.013,4434,1509,2925,4.388,12.895,1416,4.118,25.790,153,153,796
2013,541,660354,748095,8210537,8054888,92036,12.380,82675,11.121,1439441,560415,879026,6.957,17.870,1129861,425955,703906,5.288,14.027,309580,3.843,28.054,52923,53258,215348
2013,551,25990,51783,3164210,3129676,4024,7.791,3756,7.272,492084,154520,337564,4.937,15.723,429770,123165,306605,3.935,13.732,62314,1.991,27.464,644,664,8447
2013,561,258718,315370,9491745,9344491,41760,13.332,37464,11.961,1696182,418654,1277528,4.480,18.152,1400501,455312,945189,4.873,14.987,295681,3.164,29.975,22591,22814,215744
2013,562,16275,22175,373269,367359,2120,9.624,1827,8.294,60689,17084,43605,4.650,16.520,49096,13876,35220,3.777,13.365,11593,3.156,26.729,1113,1137,6921
2013,611,76769,88214,3507807,3487104,9218,10.569,7225,8.284,287648,64398,223250,1.847,8.249,245162,53287,191875,1.528,7.031,42486,1.218,14.061,4981,5109,36625
2013,621,446464,547941,6541770,6465700,41744,7.647,37681,6.902,913330,281241,632089,4.350,14.126,762036,248134,513902,3.838,11.786,151294,2.340,23.572,25750,26218,150306
2013,622,3378,6607,5673176,5689670,198,3.018,104,1.585,214735,24900,189835,0.438,3.774,249792,42316,207476,0.744,4.390,-35057,-0.616,7.548,46,48,19044
2013,623,34977,79222,3361131,3341536,5174,6.571,4208,5.344,327118,113949,213169,3.410,9.789,287473,93545,193928,2.799,8.603,39645,1.186,17.206,1897,2056,51734
2013,624,114581,155808,2854765,2840613,15369,9.944,12859,8.320,388014,103750,284264,3.652,13.660,358811,109354,249457,3.850,12.631,29203,1.028,25.263,8060,8202,62901
2013,711,32799,33634,452597,445294,4923,14.753,4396,13.173,73246,21827,51419,4.902,16.449,58261,18307,39954,4.111,13.084,14985,3.365,26.167,2790,2791,10748
2013,712,6510,6967,139705,138257,375,5.420,278,4.018,10727,1970,8757,1.425,7.759,7781,967,6814,0.699,5.628,2946,2.131,11.256,170,170,634
2013,713,53093,61639,1521823,1508436,6792,11.081,6099,9.951,194600,74144,120456,4.915,12.901,167616,50332,117284,3.337,11.112,26984,1.789,22.224,4440,4464,34994
2013,721,46370,57984,1954147,1949721,4689,8.096,4550,7.856,207624,81180,126444,4.164,10.649,198150,87766,110384,4.501,10.163,9474,0.486,20.326,2735,2803,38119
2013,722,399143,554847,10426501,10234999,63460,11.546,53041,9.650,1724656,794126,930530,7.759,16.851,1336588,523938,812650,5.119,13.059,388068,3.792,26.118,39410,40375,337996
2013,811,178354,194819,1185036,1177566,17475,8.980,17041,8.757,178248,67712,110536,5.750,15.137,162516,61699,100817,5.240,13.801,15732,1.336,27.602,12236,12361,40704
2013,812,158619,195114,1342832,1334112,22172,11.426,20030,10.322,223216,91005,132211,6.821,16.731,204376,85569,118807,6.414,15.319,18840,1.412,30.639,13349,13604,51622
2013,813,284234,293062,2734261,2736454,14056,4.800,13639,4.657,249921,46805,203116,1.710,9.133,254379,50966,203413,1.862,9.296,-4458,-0.163,18.266,8790,8800,27407
2014,113,7521,7679,54175,54121,748,9.751,732,9.542,7696,2119,5577,3.915,14.220,7581,2345,5236,4.333,14.008,115,0.212,28.015,521,522,1568
2014,114,1480,1491,7429,7384,248,16.808,217,14.707,1108,459,649,6.217,15.006,1021,327,694,4.429,13.828,87,1.178,27.656,133,133,198
2014,115,8473,8979,93596,92096,997,11.140,939,10.492,15152,4877,10275,5.296,16.452,12100,4861,7239,5.278,13.138,3052,3.314,26.277,653,653,4044
2014,211,5845,7398,135797,133104,684,9.288,616,8.365,24422,8805,15617,6.615,18.348,18896,6578,12318,4.942,14.196,5526,4.152,28.393,375,388,2725
2014,212,3418,5963,194596,198857,373,6.199,482,8.010,21875,6158,15717,3.097,11.000,29911,11985,17926,6.027,15.041,-8036,-4.041,22.001,242,242,2809
2014,213,10817,13456,423000,410445,1792,13.585,1262,9.567,81260,25342,55918,6.174,19.798,56338,18870,37468,4.597,13.726,24922,6.072,27.452,863,881,9434
2014,221,5553,17482,634606,635248,867,4.967,814,4.663,44741,10337,34404,1.627,7.043,45741,10959,34782,1.725,7.201,-1000,-0.157,14.086,190,201,1241
2014,236,160979,163654,1173283,1144287,27251,16.859,23227,14.369,255268,84576,170692,7.391,22.308,196806,70907,125899,6.197,17.199,58462,5.109,34.398,14939,14945,46422
2014,237,31921,34514,900015,887976,3028,8.756,3167,9.158,160585,40265,120320,4.534,18.084,136207,29132,107075,3.281,15.339,24378,2.745,30.678,2002,2033,14024
2014,238,361234,368058,3624061,3541264,43313,11.845,38544,10.541,686273,166355,519918,4.698,19.379,520573,150525,370048,4.251,14.700,165700,4.679,29.400,24649,24681,96983
2014,311,20766,24912,1437659,1431893,2147,8.685,1762,7.128,122451,30921,91530,2.159,8.552,110270,27435,82835,1.916,7.701,12181,0.851,15.402,1325,1329,11000
2014,312,5079,5715,169302,165471,980,18.133,359,6.643,20021,5751,14270,3.476,12.099,12187,2725,9462,1.647,7.365,7834,4.734,14.730,269,269,1561
2014,313,1911,2145,103353,103882,105,4.823,169,7.763,7205,1114,6091,1.072,6.936,8138,2249,5889,2.165,7.834,-933,-0.898,13.872,114,114,929
2014,314,5465,5682,112847,112849,404,7.047,506,8.826,10778,2317,8461,2.053,9.551,10773,3699,7074,3.278,9.546,5,0.004,19.093,400,401,2389
2014,315,5655,5721,106737,109308,966,16.997,891,15.677,16365,7131,9234,6.524,14.972,21467,7690,13777,7.035,19.639,-5102,-4.668,29.943,761,765,6465
2014,316,1020,1054,25402,25574,116,11.116,95,9.104,2431,838,1593,3.277,9.506,2676,610,2066,2.385,10.464,-245,-0.958,19.011,75,75,406
2014,321,11036,12817,365526,359425,986,7.714,917,7.174,44622,11831,32791,3.292,12.415,32197,9101,23096,2.532,8.958,12425,3.457,17.916,665,669,5331
2014,322,2637,4175,351486,351693,150,3.561,224,5.318,22186,5171,17015,1.470,6.308,22717,7906,14811,2.248,6.459,-531,-0.151,12.617,119,123,2098
2014,323,23685,24923,458253,460683,1356,5.381,1906,7.564,38437,10229,28208,2.220,8.343,43236,16706,26530,3.626,9.385,-4799,-1.042,16.687,1543,1554,10357
2014,324,923,2093,101909,99958,133,6.361,129,6.169,8671,1427,7244,1.428,8.675,4828,964,3864,0.964,4.830,3843,3.845,9.660,40,42,150
2014,325,9008,12495,746565,742711,671,5.362,708,5.658,65224,12043,53181,1.621,8.782,57745,15701,42044,2.114,7.775,7479,1.007,15.550,446,451,5847
2014,326,9332,12055,724002,715976,474,3.913,591,4.879,63271,11695,51576,1.633,8.837,47060,13958,33102,1.950,6.573,16211,2.264,13.146,367,371,5495
2014,327,8767,14106,358984,354897,746,5.251,948,6.673,40494,8707,31787,2.453,11.410,32504,9273,23231,2.613,9.159,7990,2.251,18.317,462,476,4312
2014,331,3383,4308,390951,391213,172,3.971,219,5.056,24022,4575,19447,1.169,6.140,24937,4601,20336,1.176,6.374,-915,-0.234,12.281,147,148,1888
2014,332,48467,52425,1420404,1412634,2479,4.714,2811,5.345,131309,24574,106735,1.740,9.295,115534,30352,85182,2.149,8.179,15775,1.117,16.357,2052,2059,18299
2014,333,20472,22906,1059637,1054902,967,4.208,1113,4.844,89519,18097,71422,1.716,8.486,80983,22199,58784,2.104,7.677,8536,0.809,15.354,804,812,8525
2014,334,10604,12094,818546,830270,713,5.862,853,7.012,69673,16580,53093,1.997,8.392,92169,24072,68097,2.899,11.101,-22496,-2.709,16.783,590,592,6990
2014,335,4665,5394,336525,334718,290,5.355,334,6.167,27940,5622,22318,1.680,8.347,24493,7122,17371,2.128,7.318,3447,1.030,14.635,226,227,2275
2014,336,9199,11168,1382169,1357240,677,6.073,636,5.705,138150,20787,117363,1.532,10.179,87302,20420,66882,1.505,6.432,50848,3.746,12.865,452,453,6268
2014,337,14031,14600,354943,349011,978,6.642,1225,8.320,45251,8330,36921,2.387,12.966,33222,14004,19218,4.012,9.519,12029,3.447,19.038,906,908,9387
2014,339,23810,25134,541794,541105,2094,8.347,2002,7.980,51573,12642,38931,2.336,9.531,49851,14965,34886,2.766,9.213,1722,0.318,18.426,1556,1559,8450
2014,423,157298,228556,3385039,3362265,16094,7.036,16477,7.203,401078,101310,299768,3.013,11.929,355360,131441,223919,3.909,10.569,45718,1.360,21.138,9516,9862,52078
2014,424,89875,120751,2271394,2255813,9474,7.853,9242,7.661,260376,64491,195885,2.859,11.542,227736,82054,145682,3.637,10.096,32640,1.447,20.191,6033,6169,36671
2014,425,35003,37353,287834,286060,4108,10.889,4854,12.866,48257,15952,32305,5.576,16.870,44893,17702,27191,6.188,15.694,3364,1.176,31.387,3756,3781,11973
2014,441,75490,111394,1831135,1795205,7558,6.809,6764,6.094,198088,63454,134634,3.535,11.034,126201,44663,81538,2.488,7.030,71887,4.004,14.060,4902,4989,32442
2014,442,31043,47909,427496,425225,3436,7.145,3797,7.896,48853,16146,32707,3.797,11.489,44261,15693,28568,3.691,10.409,4592,1.080,20.818,2327,2415,8132
2014,443,22395,42165,398963,401923,3337,7.684,5868,13.511,47007,14769,32238,3.675,11.696,54360,25355,29005,6.308,13.525,-7353,-1.829,23.391,2734,3073,11339
2014,444,47598,73487,1260586,1247043,3450,4.686,3737,5.075,104966,22487,82479,1.803,8.417,78058,16895,61163,1.355,6.259,26908,2.158,12.519,2583,2639,10287
2014,445,103159,137323,3050627,2976630,13159,9.627,11878,8.690,345334,158372,186962,5.321,11.602,203183,72835,130348,2.447,6.826,142151,4.776,13.652,9076,9210,41026
2014,446,39744,88263,1014439,1010692,5565,6.328,4914,5.588,98256,31445,66811,3.111,9.722,91514,25896,65618,2.562,9.055,6742,0.667,18.109,3111,3403,15766
2014,447,61423,107093,901515,892950,7120,6.625,7872,7.325,119448,42092,77356,4.714,13.377,102088,38222,63866,4.280,11.433,17360,1.944,22.865,4952,5195,22162
2014,448,52772,139379,1740164,1731432,10751,7.734,9996,7.191,232658,87834,144824,5.073,13.437,219432,56089,163343,3.239,12.673,13226,0.764,25.347,5206,5716,19456
2014,451,28019,42678,556404,546001,3224,7.508,3748,8.728,75007,23831,51176,4.365,13.738,54868,15686,39182,2.873,10.049,20139,3.688,20.098,2494,2574,9072
2014,452,7109,49895,2838957,2817535,2959,6.018,1500,3.051,143915,26788,117127,0.951,5.108,96832,15193,81639,0.539,3.437,47083,1.671,6.874,959,993,2936
2014,453,72290,98345,746335,738234,9736,9.920,9336,9.512,107454,41000,66454,5.554,14.556,91186,30109,61077,4.079,12.352,16268,2.204,24.704,6781,6899,20834
2014,454,50475,57374,627638,614152,8031,14.203,6370,11.266,105818,31669,74149,5.157,17.230,77852,31193,46659,5.079,12.676,27966,4.554,25.353,4415,4486,17487
2014,481,2265,4507,428135,423645,360,7.974,375,8.307,30577,4987,25590,1.177,7.218,21312,4488,16824,1.059,5.031,9265,2.187,10.061,213,216,2700
2014,483,1033,1432,69054,67872,189,13.423,141,10.014,8598,2287,6311,3.370,12.668,6235,1186,5049,1.747,9.186,2363,3.482,18.373,84,84,442
2014,484,86315,100007,1402067,1384687,13997,14.106,12439,12.536,189678,58532,131146,4.227,13.698,155153,60440,94713,4.365,11.205,34525,2.493,22.410,8801,8864,35579
2014,485,14671,17480,479609,475164,2229,12.875,1894,10.940,76313,26909,49404,5.663,16.060,67576,21552,46024,4.536,14.222,8737,1.839,28.443,1423,1432,9967
2014,486,210,3986,53435,51719,660,17.309,314,8.235,10589,6293,4296,12.168,20.474,7128,2109,5019,4.078,13.782,3461,6.692,27.564,19,20,65
2014,487,1844,1960,25316,24775,275,14.267,210,10.895,3497,742,2755,2.995,14.115,2431,731,1700,2.951,9.812,1066,4.303,19.625,137,138,524
2014,488,29544,39803,656526,647719,3973,10.048,3449,8.723,91485,27610,63875,4.263,14.124,73841,22243,51598,3.434,11.400,17644,2.724,22.800,2188,2260,10496
2014,492,7736,12866,540609,531907,1418,11.108,1217,9.534,50853,15806,35047,2.972,9.561,33886,12633,21253,2.375,6.371,16967,3.190,12.741,847,849,4587
2014,493,6977,14151,751025,737276,1143,8.139,929,6.615,93147,24797,68350,3.363,12.634,64762,19744,45018,2.678,8.784,28385,3.850,17.568,317,350,3270
2014,511,17656,25547,875957,870461,2149,8.434,2016,7.912,104121,37023,67098,4.253,11.962,93298,25786,67512,2.962,10.718,10823,1.243,21.436,1137,1157,9517
2014,512,16280,19720,368767,351775,2711,13.838,2454,12.526,73951,15654,58297,4.450,21.022,40834,11867,28967,3.373,11.608,33117,9.414,23.216,1519,1546,7673
2014,515,4372,9339,265111,271259,480,5.115,571,6.085,27734,8799,18935,3.244,10.224,40525,10802,29723,3.982,14.940,-12791,-4.715,20.448,242,270,2551
2014,517,7873,50467,1050647,1062188,9557,19.671,5791,11.920,148026,76724,71302,7.223,13.936,170984,64043,106941,6.029,16.097,-22958,-2.161,27.872,810,837,4994
2014,518,8735,13002,534461,521040,1553,11.692,2115,15.923,120327,36010,84317,6.911,23.094,91017,32539,58478,6.245,17.468,29310,5.625,34.937,708,721,6015
2014,519,8083,10188,247140,233552,1633,16.323,1265,12.645,57918,14005,43913,5.997,24.799,29750,6819,22931,2.920,12.738,28168,12.061,25.476,934,941,4042
2014,521,12,58,18786,18644,D,D,0,0.000,523,D,453,D,2.805,211,0,211,0.000,1.132,312,1.674,2.264,0,0,0
2014,522,36668,187467,2786340,2810575,11910,6.335,12973,6.901,295993,87958,208035,3.130,10.531,346219,97183,249036,3.458,12.318,-50226,-1.787,21.063,2684,3004,17012
2014,523,52178,88832,881790,877495,10884,12.390,8914,10.147,128264,62397,65867,7.111,14.617,119683,39501,80182,4.502,13.639,8581,0.978,27.278,3935,3988,13660
2014,524,122710,163976,2367787,2361617,15155,9.296,13255,8.131,322117,120616,201501,5.107,13.640,311687,103699,207988,4.391,13.198,10430,0.442,26.396,7356,7443,23024
2014,525,647,670,6839,6320,163,24.604,148,22.340,2198,1765,433,27.927,34.778,1098,833,265,13.180,17.373,1100,17.405,34.747,127,127,724
2014,531,211950,265201,1484206,1458957,32749,12.529,25106,9.605,241853,105615,136238,7.239,16.577,191370,83240,108130,5.705,13.117,50483,3.460,26.234,15637,15923,49310
2014,532,19989,49150,489987,484496,5009,10.222,4716,9.624,95680,34838,60842,7.191,19.748,83010,37010,46000,7.639,17.133,12670,2.615,34.267,1837,1953,8812
2014,533,2033,2212,33018,34096,221,9.950,239,10.761,4351,950,3401,2.786,12.761,6595,2952,3643,8.658,19.342,-2244,-6.581,25.522,165,165,896
2014,541,667218,759185,8437208,8318038,93714,12.433,82899,10.998,1361420,470763,890657,5.660,16.367,1122901,378674,744227,4.552,13.500,238519,2.867,26.999,53546,54156,198727
2014,551,26213,52292,3240066,3235443,4226,8.094,4071,7.797,444205,134049,310156,4.143,13.729,429449,140717,288732,4.349,13.273,14756,0.456,26.547,689,717,10571
2014,561,260443,319701,9791697,9604777,40901,12.886,36296,11.435,1918220,498872,1419348,5.194,19.972,1554857,566158,988699,5.895,16.188,363363,3.783,32.377,21744,22035,207750
2014,562,16375,22431,378783,376452,1805,8.078,1631,7.299,45613,11507,34106,3.057,12.117,40862,11054,29808,2.936,10.855,4751,1.262,21.709,1055,1065,6176
2014,611,78107,89676,3560269,3532448,9043,10.165,7616,8.561,315979,86465,229514,2.448,8.945,258465,60744,197721,1.720,7.317,57514,1.628,14.634,5143,5215,37008
2014,621,445027,552015,6696829,6608990,42538,7.736,38274,6.960,906854,305256,601598,4.619,13.722,727827,241168,486659,3.649,11.013,179027,2.709,22.025,26570,27288,146787
2014,622,3364,6667,5634500,5644586,245,3.700,154,2.326,190951,42983,147968,0.761,3.383,210488,35879,174609,0.636,3.729,-19537,-0.346,6.766,74,76,12705
2014,623,35386,82564,3419455,3390103,7469,9.230,4184,5.170,351972,133192,218780,3.929,10.382,293515,99492,194023,2.935,8.658,58457,1.724,17.316,2017,2182,56582
2014,624,119089,160938,2933310,2895132,17268,10.891,12490,7.878,376724,117211,259513,4.049,13.012,300090,86716,213374,2.995,10.365,76634,2.647,20.731,8276,8583,52367
2014,711,33539,34422,472581,462693,5245,15.412,4466,13.123,76052,22898,53154,4.949,16.437,56326,18772,37554,4.057,12.174,19726,4.263,24.347,2926,2932,12062
2014,712,6526,6983,142620,141060,307,4.403,285,4.088,11074,1248,9826,0.885,7.851,8010,1271,6739,0.901,5.678,3064,2.172,11.357,179,179,739
2014,713,53716,62790,1552399,1529754,7070,11.364,5920,9.515,204516,78685,125831,5.144,13.369,157693,53435,104258,3.493,10.308,46823,3.061,20.617,4436,4513,39798
2014,721,46863,58474,1998280,1984801,4864,8.347,4457,7.649,217595,88143,129452,4.441,10.963,188338,77019,111319,3.880,9.489,29257,1.474,18.978,2915,3002,42843
2014,722,403690,561497,10779485,10605433,60256,10.794,53695,9.619,1673689,778515,895174,7.341,15.781,1325648,501010,824638,4.724,12.500,348041,3.282,24.999,40877,41911,355815
2014,811,178297,195553,1221288,1207515,16918,8.664,16364,8.380,179610,67199,112411,5.565,14.874,152325,56469,95856,4.676,12.615,27285,2.260,25.230,12022,12143,40845
2014,812,161290,198703,1361877,1352142,23171,11.767,19598,9.952,223496,111072,112424,8.215,16.529,203193,81844,121349,6.053,15.027,20303,1.502,30.055,13904,14140,51795
2014,813,284775,293749,2741446,2736457,14310,4.878,13502,4.603,245599,45285,200314,1.655,8.975,235079,43266,191813,1.581,8.591,10520,0.384,17.181,8932,8956,29271
2015,113,7624,7775,56128,55032,801,10.403,650,8.442,9350,2534,6816,4.605,16.990,7263,1967,5296,3.574,13.198,2087,3.792,26.396,458,458,1391
2015,114,1524,1539,7536,7459,263,17.394,209,13.823,1224,571,653,7.655,16.410,1064,467,597,6.261,14.265,160,2.145,28.529,117,117,284
2015,115,8618,9120,94926,93948,1120,12.456,863,9.598,15269,5121,10148,5.451,16.253,13227,4539,8688,4.831,14.079,2042,2.174,28.158,591,593,3773
2015,211,5696,7164,134458,134336,553,7.600,777,10.679,21781,8029,13752,5.977,16.214,21864,9515,12349,7.083,16.276,-83,-0.062,32.428,454,457,3962
2015,212,3323,5924,190004,193070,427,7.179,475,7.986,22638,7480,15158,3.874,11.725,29079,9360,19719,4.848,15.061,-6441,-3.336,23.451,262,262,3162
2015,213,10915,13748,416873,421962,1831,13.450,1561,11.467,64213,24773,39440,5.871,15.218,74472,17679,56793,4.190,17.649,-10259,-2.431,30.435,1086,1101,7893
2015,221,5541,17526,640792,638430,957,5.466,924,5.277,48600,11846,36754,1.855,7.612,43942,9516,34426,1.491,6.883,4658,0.730,13.766,225,227,1012
2015,236,166078,168935,1243831,1207890,27539,16.573,22013,13.247,264363,85888,178475,7.111,21.886,192289,69257,123032,5.734,15.919,72074,5.967,31.839,14327,14341,46823
2015,237,31931,34633,930846,916040,2998,8.665,2926,8.457,168801,40001,128800,4.367,18.427,140392,25187,115205,2.750,15.326,28409,3.101,30.652,1927,1930,13146
2015,238,369844,377081,3835230,3730746,45284,12.150,36541,9.804,719486,177991,541495,4.771,19.285,510658,145352,365306,3.896,13.688,208828,5.597,27.376,23884,23919,96236
2015,311,20857,25075,1479523,1457794,2076,8.327,1786,7.164,141594,31116,110478,2.134,9.713,97337,26075,71262,1.789,6.677,44257,3.036,13.354,1336,1346,11577
2015,312,5959,6602,181901,175644,1175,18.962,364,5.874,24191,6549,17642,3.729,13.773,11540,3602,7938,2.051,6.570,12651,7.203,13.140,267,271,2724
2015,313,1854,2089,103565,103896,106,5.011,159,7.516,7286,1768,5518,1.702,7.013,7985,1977,6008,1.903,7.686,-699,-0.673,14.026,124,124,779
2015,314,5401,5632,113941,113562,410,7.256,447,7.911,11269,4170,7099,3.672,9.923,10418,2528,7890,2.226,9.174,851,0.749,18.348,342,342,1453
2015,315,5703,5766,103559,104511,1003,17.533,912,15.943,16321,8142,8179,7.791,15.617,18161,9021,9140,8.632,17.377,-1840,-1.761,31.233,796,797,7994
2015,316,1031,1066,26265,25651,122,11.564,100,9.479,3507,1269,2238,4.947,13.672,2293,908,1385,3.540,8.939,1214,4.733,17.879,87,88,879
2015,321,11259,13095,380041,372687,1052,8.101,835,6.430,43520,9923,33597,2.663,11.677,28797,9548,19249,2.562,7.727,14723,3.951,15.454,602,607,5704
2015,322,2583,4125,350557,351087,133,3.201,192,4.621,22489,5285,17204,1.505,6.406,23679,6764,16915,1.927,6.744,-1190,-0.339,12.811,115,118,3276
2015,323,23109,24369,448416,453769,1302,5.276,1924,7.796,38046,8682,29364,1.913,8.384,48434,18311,30123,4.035,10.674,-10388,-2.289,16.769,1522,1526,9273
2015,324,914,2062,102317,102011,111,5.347,139,6.696,5979,1517,4462,1.487,5.861,5410,1187,4223,1.164,5.303,569,0.558,10.607,39,40,355
2015,325,9030,12607,752436,749656,785,6.249,696,5.540,69906,20606,49300,2.749,9.325,64219,17623,46596,2.351,8.566,5687,0.759,17.133,430,437,5024
2015,326,9203,11967,739956,729413,460,3.831,540,4.497,65403,10553,54850,1.447,8.967,44119,11353,32766,1.556,6.049,21284,2.918,12.097,380,383,5651
2015,327,8725,14189,370294,364343,893,6.305,841,5.938,42059,9023,33036,2.477,11.544,30307,8950,21357,2.456,8.318,11752,3.226,16.637,466,470,4298
2015,331,3341,4269,396939,394236,191,4.456,225,5.250,28444,3590,24854,0.911,7.215,23259,5952,17307,1.510,5.900,5185,1.315,11.800,152,152,2482
2015,332,48115,52178,1443523,1431762,2519,4.811,2872,5.486,136167,27422,108745,1.915,9.510,112428,30839,81589,2.154,7.852,23739,1.658,15.705,2157,2161,18279
2015,333,20347,22846,1077912,1071253,974,4.248,1134,4.946,91560,15195,76365,1.418,8.547,78096,15353,62743,1.433,7.290,13464,1.257,14.580,847,847,8178
2015,334,10438,11914,793950,799519,708,5.907,853,7.116,63127,12442,50685,1.556,7.896,75105,26028,49077,3.255,9.394,-11978,-1.498,15.791,595,600,8298
2015,335,4691,5405,345342,341763,330,6.098,343,6.338,30071,4535,25536,1.327,8.799,22746,6381,16365,1.867,6.655,7325,2.143,13.311,240,241,2609
2015,336,9211,11275,1438368,1413504,740,6.590,649,5.779,144181,20827,123354,1.473,10.200,93343,22139,71204,1.566,6.604,50838,3.597,13.207,451,453,5818
2015,337,13754,14311,360183,358297,910,6.298,1184,8.195,35941,7109,28832,1.984,10.031,32475,10457,22018,2.919,9.064,3466,0.967,18.127,868,880,6738
2015,339,23983,25328,539543,537512,2238,8.870,2042,8.094,56500,17229,39271,3.205,10.511,52808,14259,38549,2.653,9.825,3692,0.687,19.649,1576,1589,8000
2015,423,155608,226383,3440835,3412623,15033,6.609,17183,7.554,405262,103565,301697,3.035,11.875,345961,123393,222568,3.616,10.138,59301,1.738,20.275,9998,10305,55647
2015,424,89621,121789,2317218,2293894,10217,8.416,9443,7.778,262331,79473,182858,3.465,11.436,217134,67777,149357,2.955,9.466,45197,1.970,18.931,6589,6736,38312
2015,425,34659,37060,293175,288823,3984,10.725,4155,11.186,44745,17656,27089,6.113,15.492,35668,13958,21710,4.833,12.349,9077,3.143,24.699,3138,3163,8302
2015,441,75180,111863,1904117,1867596,7481,6.703,6979,6.253,210118,70232,139886,3.761,11.251,136864,49304,87560,2.640,7.328,73254,3.922,14.657,4808,4900,34080
2015,442,30543,47738,445994,436341,3352,7.008,3534,7.389,62396,19455,42941,4.459,14.300,42768,15138,27630,3.469,9.802,19628,4.498,19.603,2253,2533,9156
2015,443,21878,41245,392065,395086,3305,7.936,4102,9.850,41539,14559,26980,3.685,10.514,48418,18688,29730,4.730,12.255,-6879,-1.741,21.028,2543,2845,11732
2015,444,46986,73337,1275853,1267789,3334,4.542,3478,4.738,92600,19304,73296,1.523,7.304,75597,15169,60428,1.196,5.963,17003,1.341,11.926,2435,2502,10184
2015,445,103557,138267,3127817,3076896,13600,9.883,12287,8.929,362593,145501,217092,4.729,11.784,263381,115836,147545,3.765,8.560,99212,3.224,17.120,9149,9345,42232
2015,446,39705,88702,1035694,1024089,5414,6.123,4846,5.481,98046,29122,68924,2.844,9.574,74587,24985,49602,2.440,7.283,23459,2.291,14.567,3115,3227,15039
2015,447,61259,107144,919915,910198,7165,6.681,7379,6.880,120922,45136,75786,4.959,13.285,101691,36631,65060,4.025,11.172,19231,2.113,22.345,5109,5344,24622
2015,448,51916,139243,1718448,1724874,10913,7.833,11067,7.944,247668,99520,148148,5.770,14.359,264013,72559,191454,4.207,15.306,-16345,-0.948,28.717,5339,6602,31846
2015,451,27899,42808,576223,566383,3328,7.781,3254,7.608,74465,23579,50886,4.163,13.147,53981,14129,39852,2.495,9.531,20484,3.617,19.062,2311,2386,8651
2015,452,7178,51292,2894317,2867252,2979,5.883,1662,3.282,161746,80757,80989,2.817,5.641,106334,11172,95162,0.390,3.709,55412,1.933,7.417,868,897,2825
2015,453,72677,99079,753251,749871,10023,10.149,9390,9.508,108249,42886,65363,5.719,14.436,100972,33177,67795,4.424,13.465,7277,0.970,26.930,6776,6953,21585
2015,454,51964,58917,667447,646195,8469,14.596,6678,11.510,131945,61358,70587,9.495,20.419,88318,36451,51867,5.641,13.667,43627,6.751,27.335,4946,4987,19272
2015,481,2263,4246,452865,440241,372,8.497,636,14.527,65975,5339,60636,1.213,14.986,40117,18569,21548,4.218,9.113,25858,5.874,18.225,187,226,896
2015,483,1042,1448,67397,67811,157,10.891,144,9.990,5165,1106,4059,1.631,7.617,6121,1067,5054,1.574,9.027,-956,-1.410,15.234,88,90,530
2015,484,90249,104705,1453011,1427476,16319,15.942,11645,11.376,218975,74024,144951,5.186,15.340,167191,55075,112116,3.858,11.712,51784,3.628,23.425,8436,8490,34502
2015,485,14834,17813,493041,486512,2431,13.775,2100,11.900,69306,26475,42831,5.442,14.245,56612,24132,32480,4.960,11.636,12694,2.609,23.273,1558,1574,11186
2015,486,218,3598,51056,52420,191,5.032,587,15.464,6433,2386,4047,4.552,12.272,9409,6564,2845,12.522,17.949,-2976,-5.677,24.544,15,15,67
2015,487,1884,2005,26654,26099,282,14.174,251,12.616,3883,1042,2841,3.992,14.878,2794,900,1894,3.448,10.705,1089,4.173,21.411,171,172,683
2015,488,29776,40643,677576,667287,4420,10.988,3583,8.908,102583,33801,68782,5.065,15.373,82545,35062,47483,5.254,12.370,20038,3.003,24.740,2189,2218,10872
2015,492,7658,13781,592789,567079,2173,16.287,1295,9.706,76490,26865,49625,4.737,13.488,25033,8341,16692,1.471,4.414,51457,9.074,8.829,837,855,3668
2015,493,7174,14744,786168,770177,1450,10.004,951,6.561,103946,38188,65758,4.958,13.496,71785,20599,51186,2.675,9.321,32161,4.176,18.641,332,349,3794
2015,511,17810,25422,891127,892939,2200,8.616,2423,9.489,104128,23668,80460,2.651,11.661,108514,32535,75979,3.644,12.152,-4386,-0.491,23.323,1309,1374,11594
2015,512,16412,19889,388932,378944,2730,13.787,2555,12.903,55743,20584,35159,5.432,14.710,36650,12283,24367,3.241,9.672,19093,5.038,19.343,1669,1687,6745
2015,515,4323,8434,266347,266391,544,6.121,1451,16.326,37041,13239,23802,4.970,13.905,37301,12688,24613,4.763,14.002,-260,-0.098,27.810,240,289,3115
2015,517,8148,51936,1039402,1045905,5253,10.236,4016,7.826,122967,43338,79629,4.144,11.757,134312,34052,100260,3.256,12.842,-11345,-1.085,23.514,768,784,5603
2015,518,8812,13126,542360,529594,1649,12.661,1445,11.095,99483,22654,76829,4.278,18.785,73009,28046,44963,5.296,13.786,26474,4.999,27.572,784,912,14983
2015,519,8297,10419,258344,252017,1579,15.323,1350,13.101,50471,12057,38414,4.784,20.027,36580,17467,19113,6.931,14.515,13891,5.512,29.030,926,935,4795
2015,521,12,58,19188,18987,0,0.000,0,0.000,653,0,653,0.000,3.439,270,0,270,0.000,1.422,383,2.017,2.844,0,0,0
2015,522,36172,187164,2762255,2775385,12196,6.511,12500,6.673,336590,86143,250447,3.104,12.128,360095,87621,272474,3.157,12.975,-23505,-0.847,24.255,2501,2983,16843
2015,523,53356,88219,890826,886717,9655,10.901,10349,11.685,133420,41570,91850,4.688,15.047,125008,45769,79239,5.162,14.098,8412,0.949,28.196,4001,4033,14701
2015,524,123227,165383,2416578,2381014,16889,10.257,15445,9.380,327998,112992,215006,4.746,13.776,256566,89403,167163,3.755,10.775,71432,3.000,21.551,7471,7589,25406
2015,525,683,709,10256,8543,189,27.774,132,19.398,5377,4977,400,58.258,62.940,2269,1646,623,19.267,26.560,3108,36.381,53.120,113,114,1565
2015,531,217556,273003,1513651,1500953,33859,12.582,26060,9.684,240486,105374,135112,7.020,16.022,214726,98400,116326,6.556,14.306,25760,1.716,28.612,16392,16753,53374
2015,532,20033,49618,508073,498884,4260,8.622,3836,7.764,80290,26563,53727,5.324,16.094,62497,22660,39837,4.542,12.527,17793,3.567,25.055,1649,1770,9917
2015,533,2031,2207,34037,33412,242,10.990,232,10.536,4307,987,3320,2.954,12.891,2997,927,2070,2.774,8.970,1310,3.921,17.940,173,173,609
2015,541,673421,770466,8650330,8528552,94033,12.295,82765,10.821,1435756,518894,916862,6.084,16.835,1188285,415033,773252,4.866,13.933,247471,2.902,27.866,54782,55284,212738
2015,551,26653,52869,3348111,3306622,4527,8.611,3938,7.490,504673,159539,345134,4.825,15.262,421162,94862,326300,2.869,12.737,83511,2.526,25.474,681,717,10559
2015,561,263263,323868,10272259,10062087,41830,13.003,37502,11.657,1754474,449294,1305180,4.465,17.436,1330470,423107,907363,4.205,13.223,424004,4.214,26.445,21638,21869,221168
2015,562,16385,22586,381792,378672,1642,7.292,1508,6.697,48350,12429,35921,3.282,12.768,41878,11490,30388,3.034,11.059,6472,1.709,22.118,988,1007,6229
2015,611,80039,91994,3636957,3596752,9909,10.898,7770,8.546,304025,63484,240541,1.765,8.453,224269,55028,169241,1.530,6.235,79756,2.217,12.471,5218,5430,32860
2015,621,443086,564758,6989074,6846886,52212,9.350,39482,7.071,1118176,449471,668705,6.565,16.331,830936,284968,545968,4.162,12.136,287240,4.195,24.272,27253,27901,148465
2015,622,3132,6607,5615045,5630273,188,2.858,131,1.991,227198,50165,177033,0.891,4.035,258709,28703,230006,0.510,4.595,-31511,-0.560,8.071,73,74,7771
2015,623,35993,83918,3462840,3442476,6181,7.421,4922,5.910,388626,139573,249053,4.054,11.289,346262,115967,230295,3.369,10.059,42364,1.231,20.117,2096,2245,61817
2015,624,122375,164867,3038021,2986689,16841,10.332,13099,8.036,409527,114919,294608,3.848,13.712,308444,89072,219372,2.982,10.327,101083,3.384,20.655,8867,9033,56680
2015,711,34468,35425,481793,476721,5361,15.342,4398,12.586,73199,22942,50257,4.812,15.355,62940,18057,44883,3.788,13.203,10259,2.152,26.405,2793,2799,12560
2015,712,6583,7053,145791,144352,338,4.814,273,3.889,10709,1870,8839,1.295,7.419,7759,1062,6697,0.736,5.375,2950,2.044,10.750,158,158,767
2015,713,54884,64280,1604625,1575099,7601,11.959,6163,9.696,207881,75025,132856,4.763,13.198,148423,56747,91676,3.603,9.423,59458,3.775,18.846,4542,4602,40081
2015,721,47295,59196,2025036,2010912,5296,8.996,4641,7.884,226876,100060,126816,4.976,11.282,199340,83522,115818,4.153,9.913,27536,1.369,19.826,3201,3241,51834
2015,722,408824,567516,11171093,10973979,60800,10.769,54946,9.732,1834655,859168,975487,7.829,16.718,1442031,581408,860623,5.298,13.140,392624,3.578,26.281,39462,40693,384684
2015,811,179004,196725,1243282,1233792,17442,8.889,16453,8.385,179846,64587,115259,5.235,14.577,160859,63632,97227,5.157,13.038,18987,1.539,26.076,11933,12054,41075
2015,812,164760,202749,1397667,1379464,23880,11.896,19856,9.892,229412,99890,129522,7.241,16.631,194260,85498,108762,6.198,14.082,35152,2.548,28.165,13885,14246,51825
2015,813,284388,293369,2763673,2756437,14050,4.790,13911,4.743,244433,50987,193446,1.850,8.868,229360,46251,183109,1.678,8.321,15073,0.547,16.642,9065,9100,28609
2016,113,7756,7933,55866,56026,845,10.737,719,9.136,8384,2976,5408,5.312,14.965,8784,2293,6491,4.093,15.679,-400,-0.714,29.929,508,508,1734
2016,114,1583,1605,7107,7305,279,17.771,209,13.312,1234,619,615,8.474,16.894,1656,893,763,12.225,22.671,-422,-5.777,33.787,114,114,215
2016,115,8829,9353,96762,95916,1157,12.502,960,10.373,14968,5856,9112,6.105,15.605,13408,4461,8947,4.651,13.979,1560,1.626,27.958,700,700,3501
2016,211,5117,6649,119303,126563,486,7.093,892,13.018,13980,7919,6061,6.257,11.046,28339,8589,19750,6.786,22.391,-14359,-11.345,22.092,579,579,2345
2016,212,3240,5804,172382,181411,313,5.337,434,7.400,14838,4569,10269,2.519,8.179,32440,8726,23714,4.810,17.882,-17602,-9.703,16.358,234,252,4911
2016,213,9839,12516,292285,354719,1161,8.806,2496,18.933,24835,13578,11257,3.828,7.001,149621,24285,125336,6.846,42.180,-124786,-35.179,14.003,1582,1592,11615
2016,221,5537,17750,640551,640084,1074,6.099,795,4.514,44085,13268,30817,2.073,6.887,42992,11445,31547,1.788,6.717,1093,0.171,13.433,247,253,1465
2016,236,169839,172731,1299455,1264334,27995,16.516,21532,12.703,264466,87262,177204,6.902,20.917,194573,66948,127625,5.295,15.389,69893,5.528,30.779,14367,14372,44841
2016,237,31987,34772,951985,941629,2945,8.478,2873,8.271,156355,30537,125818,3.243,16.605,135050,29723,105327,3.157,14.342,21305,2.263,28.684,1937,1944,15725
2016,238,383416,390985,4064389,3954915,47747,12.405,35559,9.239,746427,181632,564795,4.593,18.873,527461,149464,377997,3.779,13.337,218966,5.537,26.674,23673,23722,100527
2016,311,21082,25346,1499786,1487738,2091,8.295,1813,7.192,129723,25003,104720,1.681,8.719,104868,25089,79779,1.686,7.049,24855,1.671,14.098,1411,1415,11891
2016,312,6644,7314,196192,188901,1212,17.523,417,6.029,26213,7875,18338,4.169,13.877,11515,2528,8987,1.338,6.096,14698,7.781,12.192,319,319,1452
2016,313,1778,2013,101677,101272,96,4.705,151,7.400,7569,952,6617,0.940,7.474,6598,1668,4930,1.647,6.515,971,0.959,13.030,125,125,1148
2016,314,5321,5540,112393,112791,408,7.323,471,8.454,9267,1848,7419,1.638,8.216,10063,3447,6616,3.056,8.922,-796,-0.706,16.432,360,360,1942
2016,315,5305,5371,96179,99123,731,13.331,956,17.434,15896,6569,9327,6.627,16.037,21944,8467,13477,8.542,22.138,-6048,-6.102,32.073,848,848,7507
2016,316,1029,1064,25697,25939,96,9.001,101,9.470,1684,372,1312,1.434,6.492,2141,566,1575,2.182,8.254,-457,-1.762,12.984,79,79,318
2016,321,11368,13293,392920,387244,1102,8.354,898,6.808,42481,10575,31906,2.731,10.970,31010,9037,21973,2.334,8.008,11471,2.962,16.016,675,677,6136
2016,322,2499,4029,348640,349755,127,3.123,202,4.967,20147,3459,16688,0.989,5.760,22154,7154,15000,2.045,6.334,-2007,-0.574,11.521,126,129,2259
2016,323,22720,24125,448030,447558,1533,6.311,1863,7.670,45844,15520,30324,3.468,10.243,44978,18115,26863,4.048,10.050,866,0.193,20.099,1490,1497,9997
2016,324,905,2090,104499,103550,130,6.245,113,5.429,8307,2034,6273,1.964,8.022,6482,1929,4553,1.863,6.260,1825,1.762,12.520,44,44,673
2016,325,9113,12836,762722,762264,868,6.809,693,5.436,64965,16338,48627,2.143,8.523,64076,15964,48112,2.094,8.406,889,0.117,16.812,457,463,6322
2016,326,9094,11861,751544,744048,435,3.652,536,4.500,62747,8184,54563,1.100,8.433,47343,10230,37113,1.375,6.363,15404,2.070,12.726,366,373,5666
2016,327,8812,14475,383366,376891,883,6.142,685,4.765,44257,9008,35249,2.390,11.743,31138,7733,23405,2.052,8.262,13119,3.481,16.524,407,415,3503
2016,331,3289,4208,375109,386085,148,3.487,220,5.184,18744,3039,15705,0.787,4.855,40116,5594,34522,1.449,10.390,-21372,-5.536,9.710,152,156,2474
2016,332,47900,51994,1402891,1422080,2683,5.140,3084,5.909,113796,26072,87724,1.833,8.002,152275,31857,120418,2.240,10.708,-38479,-2.706,16.004,2270,2286,18336
2016,333,20047,22553,1030418,1053911,975,4.294,1277,5.625,65201,13020,52181,1.235,6.187,112471,22512,89959,2.136,10.672,-47270,-4.485,12.373,903,905,8955
2016,334,10301,11765,786453,789991,677,5.721,813,6.871,56548,8525,48023,1.079,7.158,63407,17288,46119,2.188,8.026,-6859,-0.868,14.316,571,577,6870
2016,335,4626,5345,344060,344958,269,4.998,344,6.391,23570,3932,19638,1.140,6.833,25548,5350,20198,1.551,7.406,-1978,-0.573,13.665,245,245,2372
2016,336,9096,11199,1473406,1457662,647,5.765,694,6.184,124945,15019,109926,1.030,8.572,93816,24269,69547,1.665,6.436,31129,2.136,12.872,463,473,6922
2016,337,13636,14204,370738,365410,885,6.192,1061,7.424,38275,7616,30659,2.084,10.475,27669,9562,18107,2.617,7.572,10606,2.902,15.144,792,797,6000
2016,339,24041,25398,542830,541063,2051,8.089,1967,7.758,54005,12811,41194,2.368,9.981,50249,16149,34100,2.985,9.287,3756,0.694,18.574,1491,1493,8907
2016,423,153964,226336,3469209,3460956,15658,6.913,16011,7.068,391497,116098,275399,3.355,11.312,374411,125485,248926,3.626,10.818,17086,0.494,21.636,10034,10310,55820
2016,424,88868,121598,2354387,2345492,9458,7.767,9803,8.050,250598,72685,177913,3.099,10.684,233223,77474,155749,3.303,9.943,17375,0.741,19.887,6585,6836,41133
2016,425,34015,36398,293474,292155,3643,9.933,4195,11.439,40890,9817,31073,3.360,13.996,38198,14621,23577,5.005,13.075,2692,0.921,26.149,3200,3235,10250
2016,441,74829,112468,1969839,1939829,7314,6.520,6723,5.993,202606,66065,136541,3.406,10.445,142951,48484,94467,2.499,7.369,59655,3.075,14.739,4908,5015,35830
2016,442,30319,47895,456540,452181,3139,6.536,3399,7.078,53529,18819,34710,4.162,11.838,44240,15776,28464,3.489,9.784,9289,2.054,19.567,2156,2267,7795
2016,443,20260,38668,375583,382770,2232,5.623,4280,10.783,34252,8889,25363,2.322,8.948,48690,20867,27823,5.452,12.720,-14438,-3.772,17.897,2481,2814,13315
2016,444,46526,72923,1326206,1299342,3430,4.705,3401,4.665,117652,21611,96041,1.663,9.055,64451,16368,48083,1.260,4.960,53201,4.094,9.921,2425,2504,10597
2016,445,104012,138590,3169285,3147786,13316,9.644,12296,8.905,322468,127571,194897,4.053,10.244,278784,100203,178581,3.183,8.857,43684,1.388,17.713,8913,9030,40539
2016,446,39738,92760,1044255,1039790,10040,11.082,5720,6.313,167172,64004,103168,6.155,16.077,157830,48056,109774,4.622,15.179,9342,0.898,30.358,3148,3328,17012
2016,447,61836,107501,947328,937224,7154,6.658,7044,6.556,126042,46636,79406,4.976,13.448,105999,36463,69536,3.891,11.310,20043,2.139,22.620,4599,4893,23284
2016,448,51455,137673,1742007,1731031,9091,6.566,10672,7.707,222213,71653,150560,4.139,12.837,202743,61149,141594,3.533,11.712,19470,1.125,23.425,4940,6501,27237
2016,451,27809,42697,563870,567974,3260,7.629,3325,7.782,57882,21122,36760,3.719,10.191,67654,16401,51253,2.888,11.911,-9772,-1.721,20.382,2358,2406,8634
2016,452,7105,52052,2919318,2907861,2242,4.340,1446,2.799,179670,38132,141538,1.311,6.179,158733,15538,143195,0.534,5.459,20937,0.720,10.918,871,1056,5450
2016,453,73589,100985,776433,764557,10652,10.633,9043,9.027,120302,46691,73611,6.107,15.735,96311,39027,57284,5.105,12.597,23991,3.138,25.194,6674,6850,22131
2016,454,54264,61277,669895,664477,9004,15.009,6431,10.720,102128,40616,61512,6.112,15.370,90852,38430,52422,5.784,13.673,11276,1.697,27.345,4829,4867,19480
2016,481,2204,4171,465727,459455,332,7.903,392,9.331,65066,3491,61575,0.760,14.162,52981,36855,16126,8.021,11.531,12085,2.630,23.063,199,282,35049
2016,483,1009,1425,64927,66193,135,9.464,138,9.674,5571,1567,4004,2.367,8.416,8192,1702,6490,2.571,12.376,-2621,-3.960,16.833,95,96,489
2016,484,92511,107523,1468330,1457533,16303,15.370,13399,12.632,197922,76045,121877,5.217,13.579,177560,61731,115829,4.235,12.182,20362,1.397,24.364,9533,9584,37514
2016,485,14993,18121,514431,504484,2442,13.594,2127,11.841,70276,20178,50098,4.000,13.930,50371,17318,33053,3.433,9.985,19905,3.946,19.969,1598,1608,10317
2016,486,226,3628,52762,51967,153,4.228,135,3.730,6137,2245,3892,4.320,11.809,4509,1174,3335,2.259,8.677,1628,3.133,17.353,17,17,124
2016,487,1988,2109,29181,27961,304,14.707,220,10.643,5502,1112,4390,3.977,19.678,2933,1237,1696,4.424,10.490,2569,9.188,20.980,145,145,1060
2016,488,30386,41304,692034,685091,4084,9.946,3603,8.774,93142,26198,66944,3.824,13.596,78589,30355,48234,4.431,11.471,14553,2.124,22.943,2132,2196,11691
2016,492,7354,13728,611121,602997,1610,11.673,1740,12.615,60727,25675,35052,4.258,10.071,43187,16838,26349,2.792,7.162,17540,2.909,14.324,1075,1080,5065
2016,493,7277,15274,830017,809809,1543,10.295,971,6.479,112142,37032,75110,4.573,13.848,73587,24335,49252,3.005,9.087,38555,4.761,18.174,368,395,4035
2016,511,18199,26095,894730,887911,2822,10.926,2287,8.855,119262,51899,67363,5.845,13.432,105968,28079,77889,3.162,11.935,13294,1.497,23.869,1310,1455,11419
2016,512,16754,20257,409383,413745,2828,14.075,2500,12.442,65597,19002,46595,4.593,15.854,72554,25266,47288,6.107,17.536,-6957,-1.681,31.709,1570,1581,6792
2016,515,4292,8054,263645,264409,505,6.125,886,10.747,27340,9296,18044,3.516,10.340,29050,12878,16172,4.870,10.987,-1710,-0.647,20.680,228,234,1783
2016,517,8747,56832,1068694,1053949,8265,15.197,3374,6.204,139116,68399,70717,6.490,13.200,110706,39892,70814,3.785,10.504,28410,2.696,21.008,805,840,4832
2016,518,9044,13376,481085,478587,1520,11.451,1315,9.907,65959,18695,47264,3.906,13.782,60886,26373,34513,5.511,12.722,5073,1.060,25.444,817,831,9287
2016,519,8382,10705,283326,276907,1492,14.045,1328,12.501,45779,12232,33547,4.417,16.532,33160,11542,21618,4.168,11.975,12619,4.557,23.950,963,974,5615
2016,521,13,59,19366,19277,D,D,0,0.000,717,D,716,D,3.719,513,0,513,0.000,2.661,204,1.058,5.322,0,0,0
2016,522,35614,188361,2856551,2807816,11121,5.923,9941,5.294,382214,81525,300689,2.904,13.613,290318,77175,213143,2.749,10.340,91896,3.273,20.679,2478,2927,21112
2016,523,54083,91628,901464,894661,11560,12.850,8224,9.142,114425,43039,71386,4.811,12.790,100665,32167,68498,3.595,11.252,13760,1.538,22.503,4260,4303,13415
2016,524,123788,171002,2526202,2470372,19968,11.876,14243,8.471,385404,169419,215985,6.858,15.601,269679,86981,182698,3.521,10.917,115725,4.685,21.833,7483,7626,27456
2016,525,674,699,5941,7728,144,20.705,137,19.698,1252,849,403,10.987,16.202,4987,1077,3910,13.937,64.536,-3735,-48.334,32.404,109,109,463
2016,531,223924,283122,1550464,1526976,37434,13.465,27206,9.786,266773,125901,140872,8.245,17.471,220585,95448,125137,6.251,14.446,46188,3.025,28.892,16872,17099,55118
2016,532,19901,50068,510694,508620,4037,8.100,3577,7.177,69246,26632,42614,5.236,13.614,65451,18446,47005,3.627,12.868,3795,0.746,25.737,1708,1803,8728
2016,533,2020,2233,35758,34822,242,10.872,228,10.243,5846,1379,4467,3.960,16.788,4103,1256,2847,3.607,11.783,1743,5.006,23.566,175,175,1039
2016,541,679612,781606,8793302,8682440,93881,12.096,82892,10.680,1313924,451878,862046,5.205,15.133,1093901,386210,707691,4.448,12.599,220023,2.534,25.198,56294,56875,222411
2016,551,26849,54156,3378665,3366630,5059,9.461,3693,6.906,458923,130427,328496,3.874,13.632,437273,104696,332577,3.110,12.988,21650,0.643,25.977,684,722,13760
2016,561,270495,334421,10542954,10471633,43524,13.211,33572,10.190,1813387,499433,1313954,4.769,17.317,1665011,520961,1144050,4.975,15.900,148376,1.417,31.800,21476,21654,226147
2016,562,16659,23440,387846,385562,2209,9.565,1516,6.565,52101,16130,35971,4.184,13.513,47881,12306,35575,3.192,12.419,4220,1.095,24.837,1049,1078,7863
2016,611,81679,93511,3659607,3638786,9683,10.452,7944,8.575,298648,65659,232989,1.804,8.207,255543,69017,186526,1.897,7.023,43105,1.185,14.046,5291,5483,44443
2016,621,443373,573600,7234441,7103464,47900,8.414,39279,6.900,1025210,346104,679106,4.872,14.433,759326,257220,502106,3.621,10.690,265884,3.743,21.379,27546,28301,157306
2016,622,3057,6602,5732855,5676075,132,1.999,137,2.074,261399,23633,237766,0.416,4.605,149174,27794,121380,0.490,2.628,112225,1.977,5.256,60,60,8851
2016,623,36596,86360,3500258,3483997,6353,7.460,3954,4.643,351082,127069,224013,3.647,10.077,318117,103294,214823,2.965,9.131,32965,0.946,18.262,2166,2279,63161
2016,624,125927,169873,3142260,3096650,17956,10.726,13012,7.773,428070,119173,308897,3.848,13.824,338412,87839,250573,2.837,10.928,89658,2.895,21.857,8929,9136,59558
2016,711,35568,36622,500220,490893,5731,15.908,4538,12.597,77117,22942,54175,4.674,15.710,58166,16803,41363,3.423,11.849,18951,3.861,23.698,2925,2930,11759
2016,712,6655,7135,150824,148305,366,5.163,275,3.879,12642,1243,11399,0.838,8.524,7584,1069,6515,0.721,5.114,5058,3.411,10.228,173,173,744
2016,713,56757,66562,1661351,1630333,8333,12.729,6139,9.378,219392,77761,141631,4.770,13.457,155650,56942,98708,3.493,9.547,63742,3.910,19.094,4632,4683,40089
2016,721,48112,60118,2059355,2048172,5584,9.349,4811,8.054,220978,98238,122740,4.796,10.789,198850,84660,114190,4.133,9.709,22128,1.080,19.417,3195,3237,47151
2016,722,418859,585126,11642089,11408834,65636,11.388,48099,8.345,1859258,924243,935015,8.101,16.297,1397586,504815,892771,4.425,12.250,461672,4.047,24.500,37381,38390,368200
2016,811,180583,198726,1260583,1246733,18081,9.141,16220,8.200,184727,66300,118427,5.318,14.817,156551,58274,98277,4.674,12.557,28176,2.260,25.114,11997,12138,41403
2016,812,169297,207410,1443628,1421022,24355,11.876,19701,9.606,232155,99095,133060,6.974,16.337,186852,77185,109667,5.432,13.149,45303,3.188,26.298,14586,14874,55935
2016,813,286047,295489,2793565,2778711,15383,5.224,13348,4.533,265305,56041,209264,2.017,9.548,236442,53138,183304,1.912,8.509,28863,1.039,17.018,8720,8738,30377
2017,113,7649,7800,53599,54748,677,8.607,809,10.285,6558,1921,4637,3.509,11.979,8842,2823,6019,5.156,16.151,-2284,-4.172,23.957,545,545,1708
2017,114,1631,1650,7218,7027,280,17.199,236,14.496,1537,690,847,9.820,21.874,1115,437,678,6.219,15.868,422,6.006,31.737,144,144,279
2017,115,9020,9562,100874,98426,1177,12.441,975,10.305,19499,6430,13069,6.533,19.811,14589,5128,9461,5.210,14.822,4910,4.989,29.645,676,676,3538
2017,211,4603,5884,110369,112995,387,6.284,936,15.199,16854,6336,10518,5.607,14.916,22241,11736,10505,10.386,19.683,-5387,-4.767,29.832,523,541,2722
2017,212,2996,5514,171574,171736,319,5.713,458,8.203,24396,6209,18187,3.615,14.206,25062,8226,16836,4.790,14.593,-666,-0.388,28.411,215,219,1588
2017,213,9273,12100,293630,291877,1707,13.899,2070,16.855,62396,23161,39235,7.935,21.377,59752,25440,34312,8.716,20.472,2644,0.906,40.943,1204,1255,11624
2017,221,5518,17995,645142,644516,1096,6.120,925,5.165,50888,18486,32402,2.868,7.896,49700,9740,39960,1.511,7.711,1188,0.184,15.422,225,229,1349
2017,236,173147,176030,1324708,1299186,27799,16.015,22898,13.192,255710,86109,169601,6.628,19.682,204913,74752,130161,5.754,15.772,50797,3.910,31.545,15284,15293,49192
2017,237,31287,34053,966597,961245,2672,7.811,2980,8.712,145410,24100,121310,2.507,15.127,134324,32332,101992,3.364,13.974,11086,1.153,27.948,1901,1915,12534
2017,238,393768,401612,4242064,4169352,46377,11.668,38087,9.582,721487,172473,549014,4.137,17.305,576009,157374,418635,3.775,13.815,145478,3.489,27.631,25193,25228,104634
2017,311,21223,25604,1539727,1521619,2065,8.096,1871,7.335,149311,29116,120195,1.913,9.813,113977,30460,83517,2.002,7.491,35334,2.322,14.981,1373,1393,16128
2017,312,7418,8127,217847,206693,1295,16.767,488,6.318,36249,10574,25675,5.116,17.538,13660,3724,9936,1.802,6.609,22589,10.929,13.218,334,334,2006
2017,313,1650,1872,95575,97592,104,5.471,162,8.522,7677,1806,5871,1.851,7.866,11844,3562,8282,3.650,12.136,-4167,-4.270,15.733,112,119,1840
2017,314,5101,5309,108155,109068,379,7.070,482,8.992,10862,2759,8103,2.530,9.959,12936,4300,8636,3.942,11.860,-2074,-1.902,19.918,355,356,1417
2017,315,4946,5014,91798,94912,656,12.747,921,17.896,12621,5697,6924,6.002,13.298,18778,6728,12050,7.089,19.785,-6157,-6.487,26.595,818,820,5951
2017,316,1021,1055,27187,26780,89,8.361,108,10.146,3000,427,2573,1.595,11.203,2179,550,1629,2.054,8.137,821,3.066,16.274,88,88,294
2017,321,11597,13651,405968,398090,1146,8.450,968,7.138,51173,13328,37845,3.348,12.855,35052,12312,22740,3.093,8.805,16121,4.050,17.610,690,694,7053
2017,322,2432,3964,344290,346751,132,3.301,202,5.051,24059,5442,18617,1.569,6.938,29118,7571,21547,2.183,8.397,-5059,-1.459,13.877,112,115,1795
2017,323,22287,23742,452246,457088,1376,5.735,1882,7.843,40567,12192,28375,2.667,8.875,50373,16982,33391,3.715,11.020,-9806,-2.145,17.750,1452,1462,8973
2017,324,889,2065,105340,105662,94,4.514,129,6.194,6882,772,6110,0.731,6.513,7664,3217,4447,3.045,7.253,-782,-0.740,13.026,38,38,559
2017,325,9193,12912,789438,781740,829,6.405,891,6.884,82279,14437,67842,1.847,10.525,66463,22031,44432,2.818,8.502,15816,2.023,17.004,514,527,7700
2017,326,8979,11857,768911,763074,438,3.671,588,4.928,68296,10016,58280,1.313,8.950,56476,15798,40678,2.070,7.401,11820,1.549,14.802,380,387,6662
2017,327,8743,14459,392125,388313,758,5.233,808,5.579,44421,9217,35204,2.374,11.439,36685,10799,25886,2.781,9.447,7736,1.992,18.895,442,446,4725
2017,331,2914,3816,365229,367154,152,3.947,223,5.790,29690,8444,21246,2.300,8.087,33898,9074,24824,2.471,9.233,-4208,-1.146,16.173,145,151,4833
2017,332,47504,51667,1397225,1399901,2580,4.958,3323,6.386,135958,31697,104261,2.264,9.712,141261,45053,96208,3.218,10.091,-5303,-0.379,19.424,2325,2342,24139
2017,333,19544,22036,1036022,1036458,996,4.479,1403,6.309,93648,17898,75750,1.727,9.035,94892,28108,66784,2.712,9.155,-1244,-0.120,18.071,928,932,11307
2017,334,10104,11586,782198,786064,631,5.392,866,7.399,59866,9055,50811,1.152,7.616,67568,19616,47952,2.495,8.596,-7702,-0.980,15.232,608,611,7619
2017,335,4511,5231,340430,340418,294,5.588,355,6.747,27275,5508,21767,1.618,8.012,27182,7406,19776,2.176,7.985,93,0.027,15.970,231,231,3013
2017,336,8957,11046,1513901,1499160,650,5.851,778,7.003,130353,16151,114202,1.077,8.695,101194,24636,76558,1.643,6.750,29159,1.945,13.500,501,510,8713
2017,337,13102,13637,371426,369748,828,6.012,1099,7.980,37997,6366,31631,1.722,10.276,34523,13287,21236,3.594,9.337,3474,0.940,18.674,790,796,7109
2017,339,24200,25533,544320,539399,2167,8.500,2092,8.205,60719,13962,46757,2.588,11.257,50819,17808,33011,3.301,9.421,9900,1.835,18.843,1540,1543,10246
2017,423,152383,225396,3462697,3456799,14749,6.508,17236,7.605,428512,112230,316282,3.247,12.396,415209,145681,269528,4.214,12.011,13303,0.385,24.023,9954,10350,61294
2017,424,88159,121136,2355479,2347327,9158,7.534,10012,8.236,281710,80186,201524,3.416,12.001,265719,95763,169956,4.080,11.320,15991,0.681,22.640,6386,6528,39751
2017,425,29986,32130,280708,277537,3497,10.762,4222,12.994,51920,11522,40398,4.152,18.707,44983,19207,25776,6.921,16.208,6937,2.499,32.416,3162,3185,10349
2017,441,74595,112515,2013557,1990902,7362,6.550,7116,6.331,219697,68692,151005,3.450,11.035,174258,58666,115592,2.947,8.753,45439,2.282,17.505,4921,5039,37345
2017,442,29945,47670,459216,457662,3171,6.625,3555,7.428,55250,16018,39232,3.500,12.072,52322,15799,36523,3.452,11.432,2928,0.640,22.865,2277,2376,8796
2017,443,17845,29075,318963,334655,1774,5.510,8014,24.892,32260,7972,24288,2.382,9.640,64593,40072,24521,11.974,19.301,-32333,-9.662,19.280,2481,2827,12777
2017,444,45990,71592,1303330,1308028,3303,4.597,3837,5.340,97877,21489,76388,1.643,7.483,105079,20730,84349,1.585,8.033,-7202,-0.551,14.966,2399,2502,12253
2017,445,103690,138198,3125491,3134082,12589,9.131,11947,8.665,289667,111700,177967,3.564,9.242,308863,97621,211242,3.115,9.855,-19196,-0.612,18.485,8789,8918,40410
2017,446,39294,92763,1010929,1019191,5443,5.886,4857,5.253,166306,35689,130617,3.502,16.317,182922,26268,156654,2.577,17.948,-16616,-1.630,32.635,3271,3386,17168
2017,447,61741,107466,945590,943607,7621,7.104,7237,6.746,135122,48682,86440,5.159,14.320,130686,37924,92762,4.019,13.850,4436,0.470,27.699,4492,4945,22875
2017,448,51214,136347,1756576,1750172,9233,6.728,11009,8.022,219376,75376,144000,4.307,12.535,208671,61589,147082,3.519,11.923,10705,0.612,23.846,4942,5643,23441
2017,451,27302,41914,536793,549861,3609,8.536,4337,10.258,69988,25108,44880,4.566,12.728,93347,40259,53088,7.322,16.976,-23359,-4.248,25.457,2373,2798,14633
2017,452,7113,51539,2701134,2720774,2558,4.943,2974,5.747,155812,34976,120836,1.286,5.727,191900,86671,105229,3.186,7.053,-36088,-1.326,11.454,810,818,2525
2017,453,72288,99782,755699,764303,9347,9.329,10171,10.151,107069,39428,67641,5.159,14.009,124531,39831,84700,5.211,16.293,-17462,-2.285,28.017,6946,7157,24746
2017,454,58304,65761,756972,731518,9580,14.838,7185,11.129,159969,41672,118297,5.697,21.868,105833,48111,57722,6.577,14.468,54136,7.401,28.935,5250,5292,22655
2017,481,2080,4057,469770,467675,383,9.485,345,8.544,38250,5895,32355,1.260,8.179,34210,4875,29335,1.042,7.315,4040,0.864,14.630,191,207,1096
2017,483,991,1396,59829,60724,185,13.367,161,11.633,5848,1566,4282,2.579,9.630,7564,1947,5617,3.206,12.456,-1716,-2.826,19.261,97,111,491
2017,484,93258,107880,1465257,1463809,15048,13.993,14374,13.366,193305,58091,135214,3.968,13.206,190928,73635,117293,5.030,13.043,2377,0.162,26.086,9967,10076,39232
2017,485,14919,18084,512560,512140,2265,12.527,2259,12.494,50493,15391,35102,3.005,9.859,50130,21782,28348,4.253,9.788,363,0.071,19.577,1724,1737,11389
2017,486,208,3625,49711,50520,242,6.699,217,6.007,5503,2175,3328,4.305,10.893,7065,2047,5018,4.052,13.985,-1562,-3.092,21.786,22,22,123
2017,487,2008,2141,29472,29522,296,13.985,247,11.670,4282,1379,2903,4.671,14.504,4497,1791,2706,6.067,15.233,-215,-0.728,29.009,158,160,690
2017,488,30833,42303,718069,710034,4180,9.934,3728,8.860,111453,27605,83848,3.888,15.697,95252,32680,62572,4.603,13.415,16201,2.282,26.830,2283,2345,11506
2017,492,7228,13327,638466,626847,1050,7.724,1583,11.645,58351,12676,45675,2.022,9.309,34296,12737,21559,2.032,5.471,24055,3.837,10.942,938,945,4994
2017,493,7488,16075,915167,868641,1532,9.643,1157,7.282,186367,80213,106154,9.234,21.455,88328,24982,63346,2.876,10.169,98039,11.286,20.337,367,376,3536
2017,511,19078,26962,973463,967900,2448,9.036,2705,9.985,123390,35106,88284,3.627,12.748,112192,37729,74463,3.898,11.591,11198,1.157,23.183,1520,1572,14137
2017,512,16850,20338,331286,370965,2506,12.329,2481,12.206,49151,20149,29002,5.432,13.250,127826,14652,113174,3.950,34.458,-78675,-21.208,26.499,1585,1591,7671
2017,515,4203,7947,258177,261196,372,4.657,454,5.684,18652,4852,13800,1.858,7.141,24498,6699,17799,2.565,9.379,-5846,-2.238,14.282,257,265,2898
2017,517,9229,57335,1067517,1077198,6484,11.108,8554,14.655,160207,43798,116409,4.066,14.873,182027,61631,120396,5.721,16.898,-21820,-2.026,29.745,1049,1123,6625
2017,518,9648,15837,526286,518400,3214,21.341,1661,11.029,104247,47564,56683,9.175,20.109,88451,33299,55152,6.423,17.062,15796,3.047,34.125,812,860,13409
2017,519,8395,10642,300553,295280,1358,12.738,1396,13.094,48502,10851,37651,3.675,16.426,38214,12900,25314,4.369,12.942,10288,3.484,25.883,965,987,6352
2017,521,12,58,19737,19552,0,0.000,D,D,675,0,675,0.000,3.452,309,D,308,D,1.580,366,1.872,3.161,D,D,D
2017,522,34828,186966,2881395,2877568,10353,5.514,11924,6.351,372082,93524,278558,3.250,12.930,364612,99512,265100,3.458,12.671,7470,0.260,25.342,2290,2719,18123
2017,523,54169,91630,900121,898720,9036,9.884,8610,9.418,109877,39579,70298,4.404,12.226,107565,35492,72073,3.949,11.969,2312,0.257,23.937,4296,4357,15958
2017,524,123974,166712,2559000,2551271,15275,9.047,19534,11.569,408920,183746,225174,7.202,16.028,395806,177696,218110,6.965,15.514,13114,0.514,31.028,7864,8002,30442
2017,525,571,576,3839,3977,164,28.497,163,28.323,1768,1491,277,37.495,44.461,2022,1282,740,32.239,50.849,-254,-6.388,88.922,120,120,428
2017,531,230399,294477,1606989,1578373,39162,13.562,27729,9.603,281988,121884,160104,7.722,17.866,222428,94326,128102,5.976,14.092,59560,3.774,28.184,17669,18050,55865
2017,532,19513,50156,500312,505394,5040,10.071,4816,9.624,70721,20596,50125,4.075,13.993,79508,25671,53837,5.079,15.732,-8787,-1.739,27.987,1691,1790,10157
2017,533,2145,2355,38460,37681,292,12.489,258,11.035,6523,1463,5060,3.883,17.311,5052,1903,3149,5.050,13.407,1471,3.904,26.815,163,164,828
2017,541,682675,784575,8864974,8762036,87940,11.239,83730,10.701,1296902,387355,909547,4.421,14.801,1090571,445785,644786,5.088,12.447,206331,2.355,24.893,56265,56888,244226
2017,551,26485,55298,3493863,3422211,5516,10.066,4512,8.234,569992,166512,403480,4.866,16.656,428506,137154,291352,4.008,12.521,141486,4.134,25.043,780,811,15889
2017,561,273456,338274,10799171,10680087,39047,11.585,36619,10.864,1968967,577767,1391200,5.410,18.436,1732775,560711,1172064,5.250,16.224,236192,2.212,32.449,22884,23215,240550
2017,562,16776,23662,406761,398872,1681,7.123,1556,6.593,54704,13576,41128,3.404,13.715,38664,14739,23925,3.695,9.693,16040,4.021,19.387,1075,1101,7837
2017,611,82818,94213,3689320,3678625,9665,10.323,8495,9.073,301881,63988,237893,1.739,8.206,280753,85060,195693,2.312,7.632,21128,0.574,15.264,5573,6023,52136
2017,621,443078,577867,7391880,7271523,48245,8.380,43982,7.639,1123733,328127,795606,4.512,15.454,885626,334147,551479,4.595,12.179,238107,3.275,24.359,27521,28458,171109
2017,622,2921,6548,5930912,5841327,119,1.807,194,2.946,371962,32848,339114,0.562,6.368,192494,36985,155509,0.633,3.295,179468,3.072,6.591,69,69,14911
2017,623,37150,86357,3483538,3495611,5990,6.937,5981,6.926,379142,131141,248001,3.752,10.846,405054,162636,242418,4.653,11.588,-25912,-0.741,21.692,2417,2640,75262
2017,624,128503,172781,3303017,3251606,17299,10.083,14880,8.673,504368,125872,378496,3.871,15.511,400947,108702,292245,3.343,12.331,103421,3.181,24.661,9579,9804,61985
2017,711,36581,37587,504432,500755,5879,15.874,4777,12.898,82680,22809,59871,4.555,16.511,74857,25718,49139,5.136,14.949,7823,1.562,29.898,3031,3033,12430
2017,712,6635,7122,155074,153217,326,4.590,287,4.041,13136,1779,11357,1.161,8.573,9454,1765,7689,1.152,6.170,3682,2.403,12.341,173,173,1155
2017,713,58081,69007,1716889,1693575,8768,12.916,6520,9.605,231518,87217,144301,5.150,13.670,185050,61674,123376,3.642,10.927,46468,2.744,21.853,4750,4790,42509
2017,721,49058,61121,2102774,2092406,5717,9.414,4933,8.123,238077,98330,139747,4.699,11.378,218113,89758,128355,4.290,10.424,19964,0.954,20.848,3312,3391,46844
2017,722,427113,596944,11918056,11774175,65594,11.092,54481,9.212,1982757,923748,1059009,7.846,16.840,1705473,647945,1057528,5.503,14.485,277284,2.355,28.970,38051,39501,400196
2017,811,180783,199903,1271944,1260574,18036,9.044,17094,8.571,200140,77781,122359,6.170,15.877,176523,65206,111317,5.173,14.003,23617,1.874,28.007,12463,12688,45660
2017,812,173483,211506,1465029,1453297,24756,11.820,20612,9.842,245031,101115,143916,6.958,16.860,220735,87289,133446,6.006,15.189,24296,1.672,30.377,15048,15381,60195
2017,813,286027,294965,2769515,2764536,14693,4.986,14181,4.812,251420,45458,205962,1.644,9.094,241567,50303,191264,1.820,8.738,9853,0.356,17.476,9381,9432,32943
2018,113,7584,7697,53568,53602,698,9.008,801,10.337,7472,1824,5648,3.403,13.940,7537,2703,4834,5.043,14.061,-65,-0.121,27.880,566,566,1761
2018,114,1609,1625,7095,7135,241,14.758,257,15.738,1305,490,815,6.868,18.290,1362,793,569,11.114,19.089,-57,-0.799,36.580,154,154,516
2018,115,9164,9694,101647,101064,1149,11.962,972,10.119,15421,6359,9062,6.292,15.259,14205,4505,9700,4.458,14.055,1216,1.203,28.111,711,711,3092
2018,211,4448,5732,109365,110741,373,6.407,552,9.482,10748,3290,7458,2.971,9.706,13594,3928,9666,3.547,12.276,-2846,-2.570,19.411,378,391,1585
2018,212,3001,5503,171039,171798,290,5.247,338,6.115,18785,3220,15565,1.874,10.934,19984,4737,15247,2.757,11.632,-1199,-0.698,21.869,175,180,1716
2018,213,9428,12013,325463,309820,1524,12.648,1597,13.254,78336,15456,62880,4.989,25.284,46160,22957,23203,7.410,14.899,32176,10.385,29.798,883,917,7762
2018,221,5561,18379,647167,646314,1956,10.753,1579,8.680,78482,40920,37562,6.331,12.143,76438,37979,38459,5.876,11.827,2044,0.316,23.654,218,228,1085
2018,236,180169,183175,1396343,1359050,29672,16.501,22953,12.765,278203,94330,183873,6.941,20.470,203443,70852,132591,5.213,14.970,74760,5.501,29.939,15682,15699,48903
2018,237,31314,34140,1006476,987186,2637,7.725,2631,7.707,164066,33155,130911,3.359,16.620,125501,22100,103401,2.239,12.713,38565,3.907,25.426,1768,1787,12499
2018,238,400781,408850,4403068,4318046,46736,11.544,38720,9.564,745634,194244,551390,4.498,17.268,575585,157543,418042,3.648,13.330,170049,3.938,26.660,26174,26195,106865
2018,311,21581,26040,1568125,1552651,2116,8.168,1845,7.122,140161,26997,113164,1.739,9.027,108924,26263,82661,1.691,7.015,31237,2.012,14.031,1382,1387,12933
2018,312,8269,9040,238131,228768,1340,15.570,473,5.496,37541,11947,25594,5.222,16.410,18684,5441,13243,2.378,8.167,18857,8.243,16.334,350,352,2707
2018,313,1617,1836,95343,95715,125,6.773,144,7.803,7814,1212,6602,1.266,8.164,8694,2004,6690,2.094,9.083,-880,-0.919,16.328,108,108,1369
2018,314,5121,5324,105776,106683,394,7.382,420,7.870,10053,2721,7332,2.551,9.423,12119,2689,9430,2.521,11.360,-2066,-1.937,18.847,316,316,1592
2018,315,4745,4814,84153,87912,679,13.881,834,17.050,11543,5058,6485,5.753,13.130,19297,8519,10778,9.690,21.950,-7754,-8.820,26.260,726,726,7352
2018,316,1034,1066,25970,26653,88,8.175,109,10.125,2122,726,1396,2.724,7.962,3508,614,2894,2.304,13.162,-1386,-5.200,15.923,89,89,423
2018,321,11524,13594,415059,410908,954,7.023,933,6.869,44498,11243,33255,2.736,10.829,36514,10872,25642,2.646,8.886,7984,1.943,17.772,655,658,5891
2018,322,2346,3896,341625,341668,120,3.053,189,4.809,22382,3624,18758,1.061,6.551,22267,5638,16629,1.650,6.517,115,0.034,13.034,130,130,3074
2018,323,21966,23382,433571,443140,1320,5.576,1898,8.018,36984,8594,28390,1.939,8.346,55534,18578,36956,4.192,12.532,-18550,-4.186,16.692,1456,1463,10152
2018,324,889,2056,106736,105966,61,2.945,92,4.441,6888,978,5910,0.923,6.500,5291,972,4319,0.917,4.993,1597,1.507,9.986,45,45,303
2018,325,9226,12958,798962,794470,787,6.073,791,6.103,78357,13697,64660,1.724,9.863,69350,23557,45793,2.965,8.729,9007,1.134,17.458,489,500,8166
2018,326,8780,11710,784717,777715,451,3.835,553,4.702,68633,10686,57947,1.374,8.825,54951,11138,43813,1.432,7.066,13682,1.759,14.131,387,388,6078
2018,327,8665,14450,400311,396727,787,5.439,825,5.702,43626,11799,31827,2.974,10.996,36296,8221,28075,2.072,9.149,7330,1.848,18.298,454,465,3998
2018,331,3004,3912,373716,370417,173,4.410,194,4.946,30416,4268,26148,1.152,8.211,23563,3868,19695,1.044,6.361,6853,1.850,12.722,135,137,1826
2018,332,48312,52549,1437304,1420219,2769,5.256,3036,5.763,154075,35037,119038,2.467,10.849,120291,33335,86956,2.347,8.470,33784,2.379,16.940,2266,2286,19493
2018,333,19478,22158,1059936,1048077,1168,5.275,1139,5.144,98686,19093,79593,1.822,9.416,75002,16269,58733,1.552,7.156,23684,2.260,14.312,813,815,8183
2018,334,9772,11383,774935,779197,749,6.548,861,7.527,60578,12516,48062,1.606,7.774,68575,15765,52810,2.023,8.801,-7997,-1.026,15.549,620,624,6094
2018,335,4481,5274,345019,342877,347,6.604,307,5.843,29123,6635,22488,1.935,8.494,24752,6640,18112,1.937,7.219,4371,1.275,14.438,219,220,1906
2018,336,8678,11023,1549794,1531095,878,8.031,698,6.384,129547,22151,107396,1.447,8.461,94771,14771,80000,0.965,6.190,34776,2.271,12.380,501,503,7528
2018,337,13163,13707,376487,374546,840,6.092,1004,7.281,35285,7456,27829,1.991,9.421,31359,7855,23504,2.097,8.373,3926,1.048,16.745,769,771,5223
2018,339,21831,23613,551449,543110,2153,9.101,2239,9.465,65058,24542,40516,4.519,11.979,49341,15596,33745,2.872,9.085,15717,2.894,18.170,1783,1786,10256
2018,423,148846,221670,3476424,3460915,14087,6.321,16482,7.395,394791,85707,309084,2.476,11.407,363773,118873,244900,3.435,10.511,31018,0.896,21.022,9713,10055,54526
2018,424,86329,118491,2365074,2362696,7803,6.530,9798,8.200,258796,64241,194555,2.719,10.953,253095,85776,167319,3.630,10.712,5701,0.241,21.424,6377,6509,38276
2018,425,31533,33734,284700,286423,3490,10.304,3764,11.113,28949,11934,17015,4.167,10.107,32496,12100,20396,4.225,11.345,-3547,-1.238,20.214,2815,2827,8771
2018,441,73821,112159,2007926,2012700,6668,5.935,7042,6.268,189780,62840,126940,3.122,9.429,198066,56087,141979,2.787,9.841,-8286,-0.412,18.858,5046,5237,40139
2018,442,29487,47317,470002,465373,2985,6.281,3400,7.154,70621,20614,50007,4.430,15.175,63034,15074,47960,3.239,13.545,7587,1.630,27.090,2201,2291,8743
2018,443,16622,26527,309707,313005,1449,5.272,3361,12.229,36248,6971,29277,2.227,11.581,43235,20150,23085,6.438,13.813,-6987,-2.232,23.161,1934,2378,12914
2018,444,44958,71190,1359770,1331057,3281,4.595,3708,5.193,132057,21232,110825,1.595,9.921,75422,19075,56347,1.433,5.666,56635,4.255,11.333,2441,2530,12233
2018,445,104226,138756,3086300,3106852,12487,9.019,11869,8.573,258036,109914,148122,3.538,8.305,302946,89169,213777,2.870,9.751,-44910,-1.446,16.611,8718,8995,49343
2018,446,39236,89485,1039286,1025041,5259,5.777,8343,9.165,215101,35194,179907,3.433,20.985,186440,113339,73101,11.057,18.189,28661,2.796,36.377,3094,3333,15834
2018,447,61497,107905,973929,959948,7473,6.936,7133,6.621,148704,50308,98396,5.241,15.491,117997,39035,78962,4.066,12.292,30707,3.199,24.584,4496,4776,22781
2018,448,50277,133158,1699085,1725748,8379,6.217,11632,8.630,202852,66951,135901,3.880,11.754,255370,69734,185636,4.041,14.798,-52518,-3.043,23.509,4982,5677,23924
2018,451,26804,41064,526150,531702,2845,6.853,3748,9.028,56274,15704,40570,2.954,10.584,68495,17925,50570,3.371,12.882,-12221,-2.298,21.167,2382,2795,11427
2018,452,6995,52203,2668442,2686068,2106,4.055,1559,3.002,100331,16647,83684,0.620,3.735,134564,38355,96209,1.428,5.010,-34233,-1.274,7.470,784,855,4312
2018,453,71728,98920,759780,757403,8653,8.710,9503,9.566,110787,38943,71844,5.142,14.627,106766,37648,69118,4.971,14.096,4021,0.531,28.193,6708,6960,24072
2018,454,58334,65572,769063,764010,8648,13.256,7977,12.228,104686,38833,65853,5.083,13.702,95911,39699,56212,5.196,12.554,8775,1.149,25.107,5907,5991,22972
2018,481,2081,4031,478476,474116,297,7.329,340,8.390,30343,2645,27698,0.558,6.400,22052,3653,18399,0.770,4.651,8291,1.749,9.302,181,189,1736
2018,483,1005,1404,61508,60905,149,10.620,147,10.478,6890,1213,5677,1.992,11.313,5613,2197,3416,3.607,9.216,1277,2.097,18.432,84,85,703
2018,484,97461,112544,1509602,1487516,17602,15.969,12970,11.767,218812,76323,142489,5.131,14.710,173172,52579,120593,3.535,11.642,45640,3.068,23.283,9362,9398,33964
2018,485,14890,18049,511805,511775,2308,12.771,2353,13.021,62627,20029,42598,3.914,12.237,63042,25155,37887,4.915,12.318,-415,-0.081,24.474,1710,1741,14477
2018,486,221,3404,47357,48073,132,3.773,322,9.203,4316,1135,3181,2.361,8.978,5826,2673,3153,5.560,12.119,-1510,-3.141,17.956,17,17,175
2018,487,2070,2203,29668,29591,307,14.099,256,11.757,4134,1152,2982,3.893,13.970,3992,1596,2396,5.394,13.491,142,0.480,26.981,174,175,1098
2018,488,30916,42056,741072,729296,3684,8.738,3893,9.234,110021,27095,82926,3.715,15.086,86179,30690,55489,4.208,11.817,23842,3.269,23.633,2194,2228,11955
2018,492,7092,13369,675669,656973,1220,9.140,1177,8.818,85751,16562,69189,2.521,13.052,48200,12714,35486,1.935,7.337,37551,5.716,14.673,840,864,7418
2018,493,7613,16209,965815,939752,1339,8.306,1164,7.220,127134,43511,83623,4.630,13.528,75291,22865,52426,2.433,8.012,51843,5.517,16.024,378,399,4213
2018,511,19406,26732,969571,966861,2787,10.380,3021,11.252,138465,42027,96438,4.347,14.321,133151,43007,90144,4.448,13.771,5314,0.550,27.543,1608,1638,12696
2018,512,16882,20336,326915,328178,2518,12.386,2506,12.327,40368,14620,25748,4.455,12.301,42373,13407,28966,4.085,12.912,-2005,-0.611,24.601,1627,1636,8150
2018,515,4074,7732,250189,254296,273,3.483,487,6.213,14929,3428,11501,1.348,5.871,23574,5181,18393,2.037,9.270,-8645,-3.400,11.741,266,275,1352
2018,517,9904,59981,1127627,1118555,6133,10.373,4417,7.471,160595,64042,96553,5.725,14.357,142668,41314,101354,3.694,12.755,17927,1.603,25.509,1059,1306,8528
2018,518,9543,16381,553336,541572,2189,13.584,1656,10.276,93584,26032,67552,4.807,17.280,70021,28853,41168,5.328,12.929,23563,4.351,25.858,859,883,10213
2018,519,8615,10726,313982,307594,1454,13.604,1378,12.893,55653,21049,34604,6.843,18.093,41995,13221,28774,4.298,13.653,13658,4.440,27.306,840,928,8796
2018,521,12,58,19785,19761,0,0.000,0,0.000,347,0,347,0.000,1.756,301,0,301,0.000,1.523,46,0.233,3.046,0,0,0
2018,522,34142,184710,2862563,2871923,9289,5.000,11426,6.150,311750,74671,237079,2.600,10.855,333275,88745,244530,3.090,11.605,-21525,-0.749,21.710,2321,3090,22893
2018,523,55076,93064,928834,915630,10271,11.121,8851,9.584,143834,56137,87697,6.131,15.709,117823,36186,81637,3.952,12.868,26011,2.841,25.736,4249,4296,15610
2018,524,123526,168183,2626088,2592775,17678,10.567,15914,9.512,419583,193890,225693,7.478,16.183,350475,111352,239123,4.295,13.517,69108,2.665,27.035,8305,8406,31157
2018,525,775,797,5643,5072,260,35.183,144,19.486,2868,2477,391,48.842,56.551,1819,1455,364,28.690,35.867,1049,20.684,71.734,117,117,1344
2018,531,237831,302812,1645461,1626577,38075,12.749,29755,9.963,280651,123934,156717,7.619,17.254,243351,106036,137315,6.519,14.961,37300,2.293,29.922,17844,18185,54064
2018,532,19412,49603,515609,507782,3525,7.065,4103,8.224,76039,17718,58321,3.489,14.975,61039,20936,40103,4.123,12.021,15000,2.954,24.041,1683,1745,9022
2018,533,2156,2336,38521,38398,276,11.891,246,10.599,4568,1516,3052,3.948,11.896,4361,1632,2729,4.250,11.357,207,0.539,22.715,182,182,894
2018,541,686673,786087,9059402,8958911,87258,11.114,85269,10.861,1292193,383081,909112,4.276,14.424,1091729,424020,667709,4.733,12.186,200464,2.238,24.372,56769,57484,230242
2018,551,25641,53569,3494326,3486391,2466,4.544,3871,7.133,457689,87378,370311,2.506,13.128,440459,139256,301203,3.994,12.634,17230,0.494,25.267,739,763,12086
2018,561,276431,335178,11068506,10938866,37978,11.281,40920,12.155,1791670,452763,1338907,4.139,16.379,1522346,462380,1059966,4.227,13.917,269324,2.462,27.834,22969,23168,206657
2018,562,17063,23981,425045,416497,1802,7.553,1559,6.534,56741,17891,38850,4.296,13.623,39326,13160,26166,3.160,9.442,17415,4.181,18.884,1046,1058,6984
2018,611,84520,95852,3725178,3703193,9465,9.953,7952,8.362,295065,61502,233563,1.661,7.968,249318,57532,191786,1.554,6.733,45747,1.235,13.465,5536,5603,37456
2018,621,443285,582303,7573269,7487099,48229,8.313,43922,7.571,1098782,350265,748517,4.678,14.676,923913,305821,618092,4.085,12.340,174869,2.336,24.680,27913,28564,158196
2018,622,3032,6828,6016950,6003812,342,5.094,114,1.698,253097,64724,188373,1.078,4.216,228741,26600,202141,0.443,3.810,24356,0.406,7.620,33,33,7834
2018,623,37663,87397,3519347,3513969,5570,6.398,4889,5.616,380512,141983,238529,4.041,10.829,370315,125397,244918,3.569,10.538,10197,0.290,21.077,2349,2482,57807
2018,624,122381,166623,3366885,3319952,15396,9.278,14042,8.462,484113,132318,351795,3.986,14.582,387005,105935,281070,3.191,11.657,97108,2.925,23.314,9362,9500,59510
2018,711,37792,38799,526179,516195,5972,15.610,4890,12.782,82293,23218,59075,4.498,15.942,61968,19976,41992,3.870,12.005,20325,3.937,24.010,3176,3180,13032
2018,712,6712,7204,157780,156534,298,4.154,237,3.304,12491,1276,11215,0.815,7.980,9831,1132,8699,0.723,6.280,2660,1.699,12.561,145,145,844
2018,713,59739,70799,1750218,1733842,8471,12.114,6722,9.613,226563,92192,134371,5.317,13.067,193415,58499,134916,3.374,11.155,33148,1.912,22.311,4856,4957,41757
2018,721,49615,61902,2118646,2115408,5663,9.206,4881,7.935,241399,109382,132017,5.171,11.411,234624,88095,146529,4.164,11.091,6775,0.320,22.182,3388,3442,52879
2018,722,434339,604855,12202458,12060831,61680,10.265,53726,8.941,1870372,811892,1058480,6.732,15.508,1587429,606548,980881,5.029,13.162,282943,2.346,26.324,39722,41220,418822
2018,811,180555,199804,1299539,1286421,16970,8.491,17077,8.545,199307,68566,130741,5.330,15.493,173174,65029,108145,5.055,13.462,26133,2.031,26.923,12515,12768,43506
2018,812,177585,213977,1502055,1483505,24768,11.645,22182,10.430,256508,108808,147700,7.335,17.291,218237,89931,128306,6.062,14.711,38271,2.580,29.422,15246,15575,61380
2018,813,286090,295400,2790406,2781236,14722,4.988,14164,4.799,255518,50400,205118,1.812,9.187,236800,50244,186556,1.807,8.514,18718,0.673,17.028,9439,9474,31548
2019,113,7459,7573,52168,52953,674,8.829,796,10.427,6445,1844,4601,3.482,12.171,7939,2383,5556,4.500,14.993,-1494,-2.821,24.342,595,595,1794
2019,114,1670,1689,7296,7232,283,16.941,246,14.726,1227,650,577,8.988,16.967,1100,503,597,6.956,15.211,127,1.756,30.422,162,162,347
2019,115,9356,9904,104911,103450,1198,12.216,1003,10.228,17186,5954,11232,5.755,16.613,14342,4079,10263,3.943,13.864,2844,2.749,27.728,751,751,3202
2019,211,4370,5623,108161,107548,426,7.521,508,8.969,13263,4390,8873,4.082,12.332,12153,3642,8511,3.386,11.300,1110,1.032,22.600,310,316,1381
2019,212,2987,5555,177466,174088,389,7.048,318,5.761,22073,5429,16644,3.119,12.679,15146,3726,11420,2.140,8.700,6927,3.979,17.400,163,164,1128
2019,213,9438,11929,341691,333448,1370,11.500,1338,11.231,58668,15732,42936,4.718,17.594,42187,14523,27664,4.355,12.652,16481,4.943,25.304,895,920,8099
2019,221,5660,18492,641613,644137,944,5.118,847,4.592,39064,13853,25211,2.151,6.065,44520,13678,30842,2.123,6.912,-5456,-0.847,12.129,224,224,1456
2019,236,186304,189497,1455389,1425040,30863,16.574,24306,13.052,281299,104848,176451,7.358,19.740,220926,74807,146119,5.249,15.503,60373,4.237,31.006,17302,17306,54330
2019,237,31446,34250,1038906,1023795,2689,7.858,2625,7.671,156762,22216,134546,2.170,15.312,128146,22537,105609,2.201,12.517,28616,2.795,25.034,1781,1793,12225
2019,238,409377,417953,4550072,4477850,48428,11.709,39716,9.603,736245,193529,542716,4.322,16.442,591928,160899,431029,3.593,13.219,144317,3.223,26.438,27882,27946,115124
2019,311,21640,26156,1589585,1576374,2167,8.315,1975,7.579,137402,28954,108448,1.837,8.716,110999,28535,82464,1.810,7.041,26403,1.675,14.083,1507,1518,14033
2019,312,9016,9832,252694,244787,1345,14.240,572,6.056,36116,9581,26535,3.914,14.754,20358,5154,15204,2.106,8.317,15758,6.437,16.633,417,419,3068
2019,313,1583,1796,93050,93924,107,5.926,126,6.979,6544,1075,5469,1.145,6.967,8241,2190,6051,2.332,8.774,-1697,-1.807,13.935,92,95,1127
2019,314,5005,5203,105987,106103,345,6.550,473,8.980,10501,1831,8670,1.726,9.897,10717,2881,7836,2.715,10.101,-216,-0.204,19.794,351,351,1984
2019,315,4685,4760,80795,82550,653,13.596,739,15.386,10914,3854,7060,4.669,13.221,14484,5733,8751,6.945,17.546,-3570,-4.325,26.442,644,646,4898
2019,316,1043,1077,27134,26970,106,9.842,106,9.842,2818,682,2136,2.529,10.449,2477,882,1595,3.270,9.184,341,1.264,18.369,81,83,793
2019,321,11341,13471,416704,415945,897,6.635,995,7.359,40484,10515,29969,2.528,9.733,38845,9833,29012,2.364,9.339,1639,0.394,18.678,766,769,5902
2019,322,2280,3846,346872,344381,137,3.540,185,4.780,27791,5975,21816,1.735,8.070,22941,6483,16458,1.883,6.662,4850,1.408,13.323,123,128,3132
2019,323,21486,22914,428795,431436,1330,5.741,1839,7.938,34562,10025,24537,2.324,8.011,39705,13933,25772,3.229,9.203,-5143,-1.192,16.022,1482,1488,8183
2019,324,886,2060,108082,107522,100,4.865,91,4.427,7281,1639,5642,1.524,6.772,6119,943,5176,0.877,5.691,1162,1.081,11.382,28,28,173
2019,325,9336,13116,817147,807769,871,6.673,743,5.693,77225,19073,58152,2.361,9.560,57980,14385,43595,1.781,7.178,19245,2.382,14.356,486,507,5759
2019,326,8661,11620,796875,789700,454,3.892,546,4.680,67758,11137,56621,1.410,8.580,53911,12322,41589,1.560,6.827,13847,1.753,13.654,369,374,6278
2019,327,8539,14466,402715,398740,840,5.813,810,5.605,42261,9775,32486,2.451,10.599,34299,9822,24477,2.463,8.602,7962,1.997,17.204,468,485,4428
2019,331,2952,3870,386096,379709,194,4.998,217,5.591,32774,5799,26975,1.527,8.631,20328,5481,14847,1.443,5.354,12446,3.278,10.707,169,170,3197
2019,332,47809,52052,1466781,1450563,2512,4.802,3029,5.790,144395,27068,117327,1.866,9.954,112104,32699,79405,2.254,7.728,32291,2.226,15.457,2291,2297,18789
2019,333,19226,21833,1080590,1068940,957,4.354,1251,5.692,95998,17140,78858,1.603,8.981,72382,21796,50586,2.039,6.771,23616,2.209,13.543,855,857,8702
2019,334,9618,11229,790997,782084,663,5.871,789,6.987,72069,14670,57399,1.876,9.215,53714,12068,41646,1.543,6.868,18355,2.347,13.736,554,555,5623
2019,335,4432,5179,350195,347357,291,5.569,384,7.349,27217,4477,22740,1.289,7.835,21595,7997,13598,2.302,6.217,5622,1.619,12.434,251,251,2955
2019,336,8624,11003,1602526,1581863,659,5.970,729,6.604,130153,20861,109292,1.319,8.228,88129,17645,70484,1.115,5.571,42024,2.657,11.142,459,463,6340
2019,337,12944,13489,368640,372152,824,6.050,1085,7.967,28847,6166,22681,1.657,7.751,35575,10084,25491,2.710,9.559,-6728,-1.808,15.503,833,841,5927
2019,339,21514,23157,552005,552074,1709,7.313,2131,9.119,52314,12651,39663,2.292,9.476,52233,16887,35346,3.059,9.461,81,0.015,18.922,1571,1578,8254
2019,423,146686,221187,3531770,3508859,13689,6.179,14425,6.511,374067,100114,273953,2.853,10.661,327790,106063,221727,3.023,9.342,46277,1.319,18.684,9547,9770,54210
2019,424,85441,117560,2363254,2361425,8059,6.821,9244,7.824,234656,62629,172027,2.652,9.937,230299,69317,160982,2.935,9.753,4357,0.185,19.505,6352,6492,35914
2019,425,30407,32593,272857,278240,3215,9.720,4182,12.643,30223,10243,19980,3.681,10.862,41565,12995,28570,4.670,14.939,-11342,-4.076,21.724,3316,3331,10232
2019,441,73097,112325,2022825,2015959,6950,6.192,6784,6.044,181008,65212,115796,3.235,8.979,167245,55014,112231,2.729,8.296,13763,0.683,16.592,5211,5324,44517
2019,442,28870,46719,471827,470546,3014,6.413,3574,7.604,53767,18683,35084,3.970,11.427,50802,19005,31797,4.039,10.796,2965,0.630,21.593,2260,2375,9128
2019,443,15147,25047,294899,300596,1410,5.507,2522,9.850,23889,6295,17594,2.094,7.947,34696,11449,23247,3.809,11.542,-10807,-3.595,15.894,1749,1855,7064
2019,444,44142,70558,1338064,1347955,3301,4.664,3726,5.265,84834,21028,63806,1.560,6.294,103522,23580,79942,1.749,7.680,-18688,-1.386,12.587,2435,2534,12609
2019,445,104589,138917,3146169,3115120,11768,8.475,11631,8.377,293400,89331,204069,2.868,9.419,233732,77842,155890,2.499,7.503,59668,1.915,15.006,8872,9023,44097
2019,446,39558,90207,1025706,1032215,6006,6.686,5256,5.851,97122,50086,47036,4.852,9.409,112628,30545,82083,2.959,10.911,-15506,-1.502,18.818,3236,3425,15735
2019,447,61018,107911,992762,984838,6479,6.001,6585,6.099,128305,42613,85692,4.327,13.028,112690,33532,79158,3.405,11.442,15615,1.586,22.885,4619,4974,23031
2019,448,49855,131635,1665924,1682126,7433,5.612,9040,6.826,160417,53506,106911,3.181,9.537,193790,61860,131930,3.677,11.521,-33373,-1.984,19.073,4692,5164,18450
2019,451,26199,39936,478314,502267,2752,6.794,3893,9.611,47458,15330,32128,3.052,9.449,99237,53427,45810,10.637,19.758,-51779,-10.309,18.898,2372,2448,8532
2019,452,6974,53471,2733570,2702125,3034,5.739,1816,3.435,160479,35133,125346,1.300,5.939,103444,37601,65843,1.392,3.828,57035,2.111,7.656,778,1049,24114
2019,453,71947,99306,769069,764258,8968,9.048,8596,8.672,106516,39460,67056,5.163,13.937,97140,32343,64797,4.232,12.710,9376,1.227,25.421,6583,6756,23668
2019,454,58999,66621,801050,785302,8771,13.292,7500,11.366,138631,46449,92182,5.915,17.653,106535,40403,66132,5.145,13.566,32096,4.087,27.132,5724,5742,21380
2019,481,2102,4113,501292,489844,394,9.676,312,7.662,44143,4465,39678,0.912,9.012,20659,1909,18750,0.390,4.217,23484,4.794,8.435,196,201,873
2019,483,1035,1413,62711,62212,181,12.883,165,11.744,6432,1033,5399,1.660,10.339,5550,1402,4148,2.254,8.921,882,1.418,17.842,85,85,320
2019,484,102654,118022,1580640,1546186,19301,16.737,13895,12.049,231594,78155,153439,5.055,14.978,164337,55003,109334,3.557,10.629,67257,4.350,21.257,10202,10298,36824
2019,485,14974,18182,512578,512423,2277,12.571,2140,11.814,55612,20158,35454,3.934,10.853,55476,18119,37357,3.536,10.826,136,0.027,21.652,1685,1700,12581
2019,486,219,3366,47174,47260,88,2.600,126,3.722,4212,1322,2890,2.797,8.912,4358,1618,2740,3.424,9.221,-146,-0.309,17.825,23,23,209
2019,487,2155,2286,29604,29881,309,13.709,245,10.870,3891,1130,2761,3.782,13.022,4417,1066,3351,3.568,14.782,-526,-1.760,26.044,171,174,865
2019,488,31296,42790,796825,768781,4059,9.558,3412,8.035,122824,35726,87098,4.647,15.976,66530,22416,44114,2.916,8.654,56294,7.323,17.308,2240,2317,13374
2019,492,7074,13414,855589,765338,1169,8.730,1123,8.386,201477,28006,173471,3.659,26.325,25431,10666,14765,1.394,3.323,176046,23.002,6.646,856,873,7990
2019,493,7765,16762,1098509,1034872,1458,8.830,958,5.802,213740,39162,174578,3.784,20.654,84175,21686,62489,2.096,8.134,129565,12.520,16.268,391,395,5745
2019,511,19565,27046,969604,970680,2938,10.905,2730,10.133,108647,28072,80575,2.892,11.193,110973,33784,77189,3.480,11.433,-2326,-0.240,22.386,1803,1839,14067
2019,512,17578,21046,324333,325501,3253,15.715,2561,12.372,45392,19338,26054,5.941,13.945,47958,12351,35607,3.794,14.734,-2566,-0.788,27.891,1628,1644,7465
2019,515,3990,7913,264781,257957,710,9.067,545,6.960,41863,14505,27358,5.623,16.229,28549,8392,20157,3.253,11.067,13314,5.161,22.135,251,278,4279
2019,517,10261,60800,1076842,1102541,6893,11.416,6056,10.030,145827,56753,89074,5.147,13.226,198282,40899,157383,3.710,17.984,-52455,-4.758,26.453,1230,1373,7193
2019,518,9435,16197,554504,553022,1371,8.412,1575,9.663,77819,23330,54489,4.219,14.072,74462,31512,42950,5.698,13.465,3357,0.607,26.929,837,862,8436
2019,519,8814,10967,336065,324395,1510,13.965,1202,11.116,63481,18940,44541,5.839,19.569,39980,10163,29817,3.133,12.324,23501,7.245,24.649,844,850,5085
2019,521,14,59,19991,19888,D,D,D,D,380,D,356,D,1.911,178,D,177,D,0.895,202,1.016,1.790,0,0,0
2019,522,33466,184242,2863988,2867602,10536,5.712,10967,5.946,301448,94484,206964,3.295,10.512,310592,87116,223476,3.038,10.831,-9144,-0.319,21.024,2346,2755,16243
2019,523,55461,93376,932209,932510,8426,9.052,7841,8.424,98765,30348,68417,3.254,10.591,99819,33974,65845,3.643,10.704,-1054,-0.113,21.183,4388,4425,15396
2019,524,122916,167687,2706317,2668658,16831,10.030,17080,10.178,396032,156619,239413,5.869,14.840,317056,118205,198851,4.429,11.881,78976,2.959,23.761,8586,8660,31782
2019,525,1043,1098,7665,7882,276,26.025,201,18.953,2348,1056,1292,13.398,29.789,2801,1790,1011,22.710,35.537,-453,-5.747,59.579,164,164,1655
2019,531,243804,310560,1674902,1658632,37956,12.376,30207,9.850,258163,120150,138013,7.244,15.565,227790,93383,134407,5.630,13.734,30373,1.831,27.467,19045,19378,56172
2019,532,19500,48974,528785,522110,3329,6.752,3984,8.081,70540,18772,51768,3.595,13.511,57581,24045,33536,4.605,11.029,12959,2.482,22.057,1644,1723,9719
2019,533,2170,2344,35481,37128,258,11.009,257,10.967,4535,1350,3185,3.636,12.215,7555,1350,6205,3.636,20.349,-3020,-8.134,24.429,179,182,1065
2019,541,693741,795291,9238083,9152587,91255,11.539,82367,10.415,1246170,386303,859867,4.221,13.615,1080769,387617,693152,4.235,11.808,165401,1.807,23.617,58418,58876,229646
2019,551,25235,51599,3499834,3505788,2105,4.005,4029,7.665,378695,66456,312239,1.896,10.802,394270,96153,298117,2.743,11.246,-15575,-0.444,21.604,698,731,14175
2019,561,280398,342061,11274473,11123892,42267,12.484,35303,10.427,1758551,493082,1265469,4.433,15.809,1461973,436948,1025025,3.928,13.143,296578,2.666,26.285,23528,23738,189713
2019,562,17259,24211,437737,431023,1735,7.192,1563,6.479,49310,11765,37545,2.730,11.440,36147,14054,22093,3.261,8.386,13163,3.054,16.773,1129,1150,9079
2019,611,86243,97470,3804405,3773272,9906,10.241,8423,8.708,296593,72414,224179,1.919,7.860,234781,64103,170678,1.699,6.222,61812,1.638,12.444,5835,5968,41996
2019,621,444093,590892,7814882,7695043,50831,8.665,42344,7.218,1090986,395572,695414,5.141,14.178,850249,288420,561829,3.748,11.049,240737,3.128,22.099,29021,29780,167185
2019,622,2972,6826,6028039,6012690,194,2.847,170,2.495,226010,22867,203143,0.380,3.759,202344,74826,127518,1.244,3.365,23666,0.394,6.731,46,51,15007
2019,623,38081,89520,3534722,3526762,6904,7.804,4809,5.436,353796,146676,207120,4.159,10.032,338395,111267,227128,3.155,9.595,15401,0.437,19.190,2367,2453,56925
2019,624,125283,170890,3425816,3383672,16959,10.066,12135,7.203,434344,127227,307117,3.760,12.836,350153,94208,255945,2.784,10.348,84191,2.488,20.697,8059,8309,57331
2019,711,39265,40380,544301,535901,6596,16.658,5030,12.703,78381,24844,53537,4.636,14.626,61548,17309,44239,3.230,11.485,16833,3.141,22.970,3369,3374,12326
2019,712,6810,7297,160040,158904,365,5.037,265,3.657,11072,1874,9198,1.179,6.968,8869,1273,7596,0.801,5.581,2203,1.386,11.163,172,172,982
2019,713,61204,72874,1768493,1747836,8695,12.092,6763,9.405,227783,87080,140703,4.982,13.032,186436,60312,126124,3.451,10.667,41347,2.366,21.333,5159,5235,46788
2019,721,50021,62482,2160512,2140416,5526,8.882,4998,8.033,239863,98602,141261,4.607,11.206,198661,80496,118165,3.761,9.281,41202,1.925,18.563,3505,3569,48650
2019,722,440905,615113,12332259,12264568,63588,10.427,53030,8.696,1737794,832169,905625,6.785,14.169,1597446,582368,1015078,4.748,13.025,140348,1.144,26.050,41135,42171,417542
2019,811,180195,199940,1309800,1305505,17318,8.663,17271,8.639,178134,67520,110614,5.172,13.645,170128,67215,102913,5.149,13.032,8006,0.613,26.063,13092,13287,48022
2019,812,182621,219364,1540669,1520718,25737,11.881,20259,9.352,237386,103821,133565,6.827,15.610,197578,79033,118545,5.197,12.992,39808,2.618,25.985,15450,15700,59680
2019,813,285582,295031,2775834,2782537,14262,4.833,14373,4.871,232256,47169,185087,1.695,8.347,245705,49719,195986,1.787,8.830,-13449,-0.483,16.694,9886,9902,32737
2020,113,7263,7376,50695,51343,632,8.472,799,10.711,6009,1768,4241,3.444,11.704,7319,2225,5094,4.334,14.255,-1310,-2.551,23.407,554,554,1620
2020,114,1605,1619,7032,7111,226,13.776,269,16.397,1124,591,533,8.311,15.806,1283,657,626,9.239,18.042,-159,-2.236,31.613,151,151,412
2020,115,9229,9795,108774,106470,1173,12.035,1076,11.040,19239,6155,13084,5.781,18.070,14449,4891,9558,4.594,13.571,4790,4.499,27.142,765,765,3284
2020,211,4164,5344,100927,104398,364,6.636,647,11.795,10418,3617,6801,3.465,9.979,17335,5330,12005,5.105,16.605,-6917,-6.626,19.958,394,421,2367
2020,212,2991,5547,171127,173200,376,6.767,394,7.091,17446,4795,12651,2.768,10.073,21719,6082,15637,3.512,12.540,-4273,-2.467,20.146,171,175,2032
2020,213,9051,11431,307385,324166,1139,9.757,1625,13.920,44740,14807,29933,4.568,13.802,78627,26084,52543,8.047,24.255,-33887,-10.454,27.603,1013,1050,8866
2020,221,5707,18683,636945,639459,927,4.984,757,4.070,38884,10014,28870,1.566,6.081,43739,9675,34064,1.513,6.840,-4855,-0.759,12.162,242,245,2359
2020,236,189553,192948,1499487,1476962,30332,15.868,26739,13.988,270592,97009,173583,6.568,18.321,224979,80044,144935,5.420,15.233,45613,3.088,30.465,18277,18292,55084
2020,237,31362,34312,1047350,1043543,2695,7.852,2713,7.905,147423,30300,117123,2.904,14.127,139604,26749,112855,2.563,13.378,7819,0.749,26.756,1855,1868,14287
2020,238,412423,421491,4638578,4594784,47391,11.286,44196,10.526,706552,186267,520285,4.054,15.377,620237,178672,441565,3.889,13.499,86315,1.879,26.997,29914,29982,123032
2020,311,22046,26625,1612793,1600638,2336,8.814,2092,7.893,142094,33785,108309,2.111,8.877,118602,26072,92530,1.629,7.410,23492,1.468,14.819,1548,1554,14328
2020,312,9433,10271,264171,258639,1223,12.210,714,7.128,39207,9173,30034,3.547,15.159,28628,6875,21753,2.658,11.069,10579,4.090,22.137,505,506,3532
2020,313,1582,1787,86722,89617,152,8.518,147,8.238,7456,2658,4798,2.966,8.320,13171,3201,9970,3.572,14.697,-5715,-6.377,16.640,108,108,1344
2020,314,4760,4962,107517,106627,309,6.124,477,9.453,13667,2348,11319,2.202,12.818,11702,2162,9540,2.028,10.975,1965,1.843,21.949,357,357,1486
2020,315,4352,4429,74235,77438,620,13.586,889,19.481,9450,3608,5842,4.659,12.203,15881,6745,9136,8.710,20.508,-6431,-8.305,24.407,733,733,5096
2020,316,985,1019,26034,26522,75,7.239,109,10.521,1884,544,1340,2.051,7.104,2874,621,2253,2.341,10.836,-990,-3.733,14.207,83,83,332
2020,321,10821,13012,413299,414559,827,6.311,1012,7.723,39632,10444,29188,2.519,9.560,41771,12195,29576,2.942,10.076,-2139,-0.516,19.120,709,727,6295
2020,322,2228,3799,341194,344323,129,3.372,183,4.783,24817,3732,21085,1.084,7.207,30667,7137,23530,2.073,8.906,-5850,-1.699,14.415,112,116,2939
2020,323,20748,22119,415221,422134,1197,5.308,2064,9.152,33041,6797,26244,1.610,7.827,46855,16894,29961,4.002,11.100,-13814,-3.272,15.654,1548,1555,8521
2020,324,848,2095,113343,110795,129,6.227,82,3.958,12240,1726,10514,1.558,11.047,7025,1122,5903,1.013,6.341,5215,4.707,12.681,37,41,251
2020,325,9470,13268,833532,826518,948,7.175,837,6.335,84143,17260,66883,2.088,10.180,70352,13616,56736,1.647,8.512,13791,1.669,17.024,524,527,6513
2020,326,8512,11496,794354,796441,467,4.039,602,5.206,61569,11718,49851,1.471,7.731,65641,14155,51486,1.777,8.242,-4072,-0.511,15.461,388,395,5896
2020,327,8379,14464,397200,399659,764,5.281,771,5.329,39089,9231,29858,2.310,9.781,43640,10436,33204,2.611,10.919,-4551,-1.139,19.561,435,440,4319
2020,331,2830,3758,372182,379988,136,3.596,184,4.865,18036,2274,15762,0.598,4.746,34030,6238,27792,1.642,8.956,-15994,-4.209,9.493,127,127,3258
2020,332,46824,51138,1429860,1447488,2404,4.656,3394,6.573,107425,23380,84045,1.615,7.421,143081,33856,109225,2.339,9.885,-35656,-2.463,14.843,2459,2470,19903
2020,333,18794,21420,1052144,1065741,978,4.524,1372,6.347,73910,21402,52508,2.008,6.935,101003,22788,78215,2.138,9.477,-27093,-2.542,13.870,952,960,10221
2020,334,9507,11080,796830,794491,638,5.716,802,7.185,63052,10745,52307,1.352,7.936,58404,15070,43334,1.897,7.351,4648,0.585,14.702,533,536,7002
2020,335,4346,5076,342696,345082,276,5.388,369,7.204,26438,5723,20715,1.658,7.661,30885,8136,22749,2.358,8.950,-4447,-1.289,15.323,245,245,2448
2020,336,8477,10743,1578023,1590315,607,5.588,847,7.797,101226,22456,78770,1.412,6.365,127684,20491,107193,1.288,8.029,-26458,-1.664,12.730,499,512,8618
2020,337,12857,13404,361450,365556,848,6.242,1210,8.907,27047,6436,20611,1.761,7.399,34994,10889,24105,2.979,9.573,-7947,-2.174,14.798,862,873,7126
2020,339,20833,22404,547602,548035,1567,6.882,2301,10.105,51902,11218,40684,2.047,9.471,52700,17846,34854,3.256,9.616,-798,-0.146,18.941,1603,1605,8260
2020,423,143163,218039,3543658,3541475,12426,5.654,15908,7.238,342722,92432,250290,2.610,9.677,338987,110726,228261,3.127,9.572,3735,0.105,19.144,9989,10332,54168
2020,424,83725,115896,2322337,2343958,8153,6.978,10050,8.601,237268,62494,174774,2.666,10.123,282533,103204,179329,4.403,12.054,-45265,-1.931,20.245,6475,6599,36465
2020,425,29025,31195,265930,268175,3077,9.735,3903,12.348,33123,12698,20425,4.735,12.351,37607,16246,21361,6.058,14.023,-4484,-1.672,24.703,2831,2838,7383
2020,441,71574,111465,2043496,2033371,6747,6.030,7596,6.789,195573,65185,130388,3.206,9.618,175423,58126,117297,2.859,8.627,20150,0.991,17.254,5285,5402,42879
2020,442,27995,45386,462361,467720,3468,7.529,4820,10.464,41930,14833,27097,3.171,8.965,51753,18156,33597,3.882,11.065,-9823,-2.100,17.930,2241,2422,8781
2020,443,13427,23238,269771,280898,1038,4.353,2252,9.444,18113,5655,12458,2.013,6.448,40202,10389,29813,3.698,14.312,-22089,-7.864,12.896,1552,1622,6218
2020,444,42767,69636,1344976,1340368,3103,4.430,3906,5.577,82759,22853,59906,1.705,6.174,72233,18245,53988,1.361,5.389,10526,0.785,10.778,2557,2650,12185
2020,445,104298,138902,3183039,3163375,12131,8.741,11904,8.577,296214,117906,178308,3.727,9.364,254987,80373,174614,2.541,8.061,41227,1.303,16.121,8535,8695,42765
2020,446,39606,90296,1022451,1023999,8076,8.953,7895,8.752,95254,48175,47079,4.705,9.302,99981,45968,54013,4.489,9.764,-4727,-0.462,18.604,3510,3770,17932
2020,447,60576,107575,995877,995382,6943,6.436,7547,6.996,124857,45175,79682,4.538,12.544,124953,41440,83513,4.163,12.553,-96,-0.010,25.087,4626,4914,22129
2020,448,48360,127415,1615911,1642661,6752,5.212,11037,8.519,183597,42838,140759,2.608,11.177,238353,78093,160260,4.754,14.510,-54756,-3.333,22.354,4848,6314,36385
2020,451,25392,38809,467048,472892,2597,6.592,3766,9.560,51812,17276,34536,3.653,10.956,63343,22844,40499,4.831,13.395,-11531,-2.438,21.913,2273,2357,8494
2020,452,6856,53946,2764019,2746282,2916,5.431,2415,4.498,176753,26576,150177,0.968,6.436,137523,53306,84217,1.941,5.008,39230,1.428,10.015,772,801,2508
2020,453,71110,98306,767224,768734,9107,9.211,10242,10.359,110034,40742,69292,5.300,14.314,113054,42730,70324,5.558,14.707,-3020,-0.393,28.627,6963,7516,27419
2020,454,58972,67011,877701,835458,9156,13.726,8545,12.810,187762,117379,70383,14.050,22.474,98181,45750,52431,5.476,11.752,89581,10.722,23.504,6286,6371,25397
2020,481,2132,4120,525275,519587,298,7.224,308,7.467,36997,3206,33791,0.617,7.120,25157,6217,18940,1.197,4.842,11840,2.279,9.683,166,196,1059
2020,483,1084,1467,65124,63939,178,12.314,135,9.339,8624,1188,7436,1.858,13.488,6269,2757,3512,4.312,9.805,2355,3.683,19.609,78,78,332
2020,484,103344,119123,1626277,1605435,18752,15.808,17758,14.970,247302,112698,134604,7.020,15.404,204537,75368,129169,4.695,12.740,42765,2.664,25.481,11968,12055,45245
2020,485,14600,17647,511493,511880,2224,12.404,2789,15.555,57715,18225,39490,3.560,11.275,58121,24177,33944,4.723,11.354,-406,-0.079,22.550,1923,1929,13359
2020,486,212,3346,45985,46754,313,9.320,338,10.064,6721,1956,4765,4.184,14.375,8293,2381,5912,5.093,17.738,-1572,-3.362,28.751,20,23,154
2020,487,2134,2263,28238,29043,294,12.929,316,13.896,3263,1105,2158,3.805,11.235,4872,1206,3666,4.152,16.775,-1609,-5.540,22.470,214,214,581
2020,488,31601,43155,802898,800605,4345,10.107,4011,9.331,116984,52870,64114,6.604,14.612,112446,33203,79243,4.147,14.045,4538,0.567,28.090,2440,2506,16510
2020,492,7543,13723,959551,907733,1612,11.899,1261,9.308,148337,54706,93631,6.027,16.341,43541,17466,26075,1.924,4.797,104796,11.545,9.593,793,813,8621
2020,493,7821,16938,1141470,1120083,1738,10.325,1528,9.077,165914,80916,84998,7.224,14.813,122973,60862,62111,5.434,10.979,42941,3.834,21.958,425,434,5195
2020,511,19482,27130,1000867,993986,2879,10.625,2810,10.371,132665,42575,90090,4.283,13.347,119035,33017,86018,3.322,11.976,13630,1.371,23.951,1940,1975,19739
2020,512,18164,21584,317401,321768,3391,15.910,2850,13.372,44083,16842,27241,5.234,13.700,52050,21836,30214,6.786,16.176,-7967,-2.476,27.400,1742,1780,11416
2020,515,3924,7921,274561,270342,694,8.750,715,9.015,46234,23045,23189,8.524,17.102,37980,20196,17784,7.471,14.049,8254,3.053,28.098,224,239,1755
2020,517,10454,61312,1023880,1049485,4603,7.528,4275,6.991,100627,28130,72497,2.680,9.588,151502,35211,116291,3.355,14.436,-50875,-4.848,19.176,1226,1435,7418
2020,518,9430,16124,557049,555523,1363,8.428,1458,9.016,68567,17504,51063,3.151,12.343,65084,22703,42381,4.087,11.716,3483,0.627,23.432,863,883,8892
2020,519,9083,11211,329238,318303,1578,14.223,1345,12.123,52016,15376,36640,4.831,16.342,29481,11708,17773,3.678,9.262,22535,7.080,18.524,846,862,6061
2020,521,14,61,20231,20101,3,5.042,0,0.000,357,16,341,0.080,1.776,105,0,105,0.000,0.522,252,1.254,1.045,0,0,0
2020,522,33710,182475,2921462,2892971,9993,5.451,11722,6.394,333811,88594,245217,3.062,11.539,274245,73639,200606,2.545,9.480,59566,2.059,18.959,2021,2688,16331
2020,523,56472,94319,937873,935582,8802,9.377,7891,8.407,111904,30148,81756,3.222,11.961,107510,33011,74499,3.528,11.491,4394,0.470,22.982,4349,4410,14192
2020,524,122042,166879,2752009,2731711,14173,8.474,14931,8.927,340737,103657,237080,3.795,12.473,299563,99892,199671,3.657,10.966,41174,1.507,21.932,8423,8543,35156
2020,525,1172,1227,7768,7373,368,32.352,189,16.615,1895,1137,758,15.421,25.702,1118,729,389,9.887,15.163,777,10.538,30.327,147,147,548
2020,531,249528,318235,1721814,1701035,40195,12.786,32483,10.332,272790,123428,149362,7.256,16.037,231820,98860,132960,5.812,13.628,40970,2.409,27.256,20243,20521,57317
2020,532,19303,47857,520315,524299,3059,6.317,4197,8.667,60316,14566,45750,2.778,11.504,68135,23456,44679,4.474,12.995,-7819,-1.491,23.008,1636,1686,7745
2020,533,2089,2228,36398,35747,245,10.786,332,14.616,5738,914,4824,2.557,16.052,4526,1665,2861,4.658,12.661,1212,3.390,25.322,231,236,1241
2020,541,701286,805495,9501619,9380348,95791,11.967,85704,10.707,1366804,455226,911578,4.853,14.571,1123686,423887,699799,4.519,11.979,243118,2.592,23.958,58901,59424,236936
2020,551,25062,50968,3537057,3513104,2787,5.439,3331,6.501,466491,124750,341741,3.551,13.279,417010,113579,303431,3.233,11.870,49481,1.408,23.740,681,728,13744
2020,561,281674,347549,11206585,11256044,44241,12.832,38663,11.214,1746620,596429,1150191,5.299,15.517,1857667,511658,1346009,4.546,16.504,-111047,-0.987,31.034,24825,24976,211179
2020,562,17366,24465,448539,443051,1970,8.087,1762,7.233,53019,18793,34226,4.242,11.967,42405,14389,28016,3.248,9.571,10614,2.396,19.142,1170,1183,8548
2020,611,87574,99361,3756643,3750972,10505,10.670,8699,8.835,278785,76520,202265,2.040,7.432,267499,59886,207613,1.597,7.131,11286,0.301,14.263,6026,6096,39944
2020,621,443928,596721,8030600,7933134,52297,8.807,46515,7.833,1124327,402693,721634,5.076,14.173,930812,312995,617817,3.945,11.733,193515,2.439,23.466,29549,30336,166932
2020,622,2943,6938,6136086,6097380,231,3.351,142,2.060,256577,22277,234300,0.365,4.208,177732,30775,146957,0.505,2.915,78845,1.293,5.830,41,46,8226
2020,623,38285,90416,3542021,3539642,5921,6.578,5114,5.681,354747,145264,209483,4.104,10.022,349744,129099,220645,3.647,9.881,5003,0.141,19.762,2675,2885,76830
2020,624,127178,173367,3496351,3457809,17067,9.947,13501,7.868,446536,125228,321308,3.622,12.914,368959,110625,258334,3.199,10.670,77577,2.244,21.341,8623,8779,63322
2020,711,40539,41700,539114,541773,6996,17.027,5773,14.050,73405,22267,51138,4.110,13.549,78864,22289,56575,4.114,14.557,-5459,-1.008,27.098,3737,3746,14436
2020,712,6836,7302,160494,160303,370,5.066,374,5.120,10880,1435,9445,0.895,6.787,10434,1921,8513,1.198,6.509,446,0.278,13.018,195,195,1138
2020,713,62045,74377,1775218,1771970,9166,12.446,7702,10.458,241130,102367,138763,5.777,13.608,234076,67182,166894,3.791,13.210,7054,0.398,26.420,5615,5707,48694
2020,721,50414,63280,2158745,2159791,5836,9.275,5115,8.129,232963,115727,117236,5.358,10.786,233043,82842,150201,3.836,10.790,-80,-0.004,21.573,3546,3626,45533
2020,722,440472,617361,12228342,12275597,61504,9.981,59214,9.609,1697966,768075,929891,6.257,13.832,1795452,604581,1190871,4.925,14.626,-97486,-0.794,27.664,42859,44362,424476
2020,811,178038,198405,1309327,1310383,17019,8.541,18743,9.406,171374,64854,106520,4.949,13.078,173970,66633,107337,5.085,13.276,-2596,-0.198,26.156,13333,13473,47232
2020,812,184501,221591,1550779,1546450,29084,13.192,26825,12.168,278987,131741,147246,8.519,18.040,267682,116115,151567,7.508,17.309,11305,0.731,34.619,16979,17230,67520
2020,813,283393,293077,2758048,2768506,14307,4.865,16317,5.548,235323,48437,186886,1.750,8.500,256660,63018,193642,2.276,9.271,-21337,-0.771,17.000,10326,10340,39527
2021,113,7297,7404,49717,50237,667,9.012,662,8.944,6128,1852,4276,3.687,12.198,7072,1819,5253,3.621,14.077,-944,-1.879,24.396,503,503,1384
2021,114,1736,1746,6883,6965,351,20.788,236,13.977,1327,758,569,10.884,19.054,1507,681,826,9.778,21.638,-180,-2.585,38.108,155,155,406
2021,115,9552,10153,107935,108361,1368,13.722,1001,10.041,17973,7654,10319,7.063,16.586,18766,4995,13771,4.610,17.318,-793,-0.732,33.173,751,751,3831
2021,211,3806,4904,87277,93782,297,5.840,660,12.978,9483,3092,6391,3.297,10.112,22579,8794,13785,9.377,24.076,-13096,-13.964,20.223,401,409,2613
2021,212,3003,5526,160592,164273,354,6.385,390,7.035,15121,5895,9226,3.589,9.205,22242,7357,14885,4.479,13.540,-7121,-4.335,18.410,190,215,3444
2021,213,8379,10658,226328,266817,879,7.950,1675,15.150,17313,7564,9749,2.835,6.489,98061,14128,83933,5.295,36.752,-80748,-30.263,12.977,1054,1104,8259
2021,221,5902,19126,631819,633737,1258,6.638,907,4.786,41358,10599,30759,1.672,6.526,44931,11216,33715,1.770,7.090,-3573,-0.564,13.052,274,278,1766
2021,236,198754,202345,1500556,1498876,34657,17.499,26062,13.159,259387,106700,152687,7.119,17.305,255957,74556,181401,4.974,17.077,3430,0.229,34.153,18233,18249,50981
2021,237,31184,34285,987069,1014683,2867,8.387,2665,7.796,109316,22735,86581,2.241,10.773,163783,23679,140104,2.334,16.141,-54467,-5.368,21.547,1851,1860,12999
2021,238,421022,430617,4598149,4618657,52034,12.229,41823,9.829,668830,205715,463115,4.454,14.481,708068,164464,543604,3.561,15.331,-39238,-0.850,28.962,29063,29117,108227
2021,311,22517,27183,1605346,1609566,2835,10.555,2190,8.153,137434,32265,105169,2.005,8.539,145799,25682,120117,1.596,9.058,-8365,-0.520,17.077,1590,1615,14620
2021,312,9760,10663,247037,255399,1192,11.387,802,7.661,27932,9412,18520,3.685,10.937,44257,6176,38081,2.418,17.329,-16325,-6.392,21.873,543,549,4082
2021,313,1494,1707,82650,84142,129,7.463,172,9.951,8846,2377,6469,2.825,10.513,11896,2861,9035,3.400,14.138,-3050,-3.625,21.026,125,125,1523
2021,314,4626,4826,104196,106293,348,7.110,485,9.909,11192,1827,9365,1.719,10.529,15241,2607,12634,2.453,14.339,-4049,-3.809,21.059,337,337,1408
2021,315,4099,4185,65299,69299,555,12.902,788,18.319,8869,2988,5881,4.312,12.798,16717,4070,12647,5.873,24.123,-7848,-11.325,25.597,552,552,3066
2021,316,965,995,24225,25018,98,9.766,115,11.460,2674,641,2033,2.562,10.688,4249,1217,3032,4.864,16.984,-1575,-6.295,21.377,82,82,444
2021,321,10813,13054,421499,418119,893,6.847,870,6.671,43207,12407,30800,2.967,10.334,36560,8960,27600,2.143,8.744,6647,1.590,17.488,572,578,4341
2021,322,2187,3757,339495,341053,112,2.961,163,4.309,23081,2196,20885,0.644,6.768,26262,5253,21009,1.540,7.700,-3181,-0.933,13.535,99,102,2227
2021,323,19540,20844,369361,392437,1226,5.712,2468,11.498,25949,7211,18738,1.837,6.612,71540,17771,53769,4.528,18.230,-45591,-11.617,13.225,1649,1666,7729
2021,324,814,2022,100211,105925,65,3.175,116,5.665,3888,768,3120,0.725,3.671,15625,1800,13825,1.699,14.751,-11737,-11.080,7.341,32,34,485
2021,325,9610,13461,852042,843791,1082,8.107,852,6.384,92361,22868,69493,2.710,10.946,75457,18711,56746,2.217,8.943,16904,2.003,17.885,545,551,6149
2021,326,8176,11176,785117,786547,452,4.015,616,5.472,72437,11572,60865,1.471,9.210,75052,17832,57220,2.267,9.542,-2615,-0.332,18.419,369,377,5959
2021,327,8182,14403,400136,403201,834,5.782,875,6.066,39219,11409,27810,2.830,9.727,45686,10778,34908,2.673,11.331,-6467,-1.604,19.454,455,464,3732
2021,331,2717,3624,337731,353934,134,3.660,208,5.682,19039,1956,17083,0.553,5.379,51471,10210,41261,2.885,14.543,-32432,-9.163,10.759,134,137,2338
2021,332,46338,50775,1360558,1398039,2744,5.371,3370,6.596,105166,30816,74350,2.204,7.522,179488,35816,143672,2.562,12.839,-74322,-5.316,15.045,2350,2374,17693
2021,333,18316,20990,1011971,1030889,1042,4.920,1423,6.718,74751,17302,57449,1.678,7.251,113232,21443,91789,2.080,10.984,-38481,-3.733,14.502,976,983,8817
2021,334,9301,10850,780716,790052,629,5.778,701,6.439,56216,13682,42534,1.732,7.115,74709,17210,57499,2.178,9.456,-18493,-2.341,14.231,479,481,5763
2021,335,4249,4990,337796,339229,296,5.902,347,6.919,30038,6306,23732,1.859,8.855,32874,7482,25392,2.206,9.691,-2836,-0.836,17.710,233,239,2743
2021,336,8395,10689,1549637,1559764,727,6.821,664,6.230,122549,22135,100414,1.419,7.857,142652,16902,125750,1.084,9.146,-20103,-1.289,15.714,414,419,5768
2021,337,12744,13303,350942,356448,1033,7.729,1157,8.657,34515,11364,23151,3.188,9.683,45448,11682,33766,3.277,12.750,-10933,-3.067,19.366,808,813,6481
2021,339,20359,21901,532622,540879,1825,8.250,2264,10.235,48702,13304,35398,2.460,9.004,65542,14666,50876,2.712,12.118,-16840,-3.113,18.008,1557,1568,9232
2021,423,141632,217336,3450906,3504755,14283,6.550,15729,7.213,340979,105953,235026,3.023,9.729,447844,129376,318468,3.691,12.778,-106865,-3.049,19.458,9264,9619,53844
2021,424,82421,114182,2223558,2271515,8540,7.413,10582,9.186,216205,62003,154202,2.730,9.518,311316,75897,235419,3.341,13.705,-95111,-4.187,19.036,6470,6724,36407
2021,425,28711,30973,240520,252570,3584,11.573,3575,11.544,24355,11299,13056,4.474,9.643,49239,9247,39992,3.661,19.495,-24884,-9.852,19.286,2596,2616,6442
2021,441,71599,113766,1966321,2004509,9280,8.243,6911,6.139,174294,80984,93310,4.040,8.695,250514,56700,193814,2.829,12.498,-76220,-3.802,17.390,4690,4815,37431
2021,442,27412,43367,429362,445389,3060,6.908,4924,11.115,44795,14643,30152,3.288,10.058,75527,36517,39010,8.199,16.958,-30732,-6.900,20.115,2030,3269,26133
2021,443,12774,22034,222988,246981,1229,5.437,2366,10.468,14745,5110,9635,2.069,5.970,63758,11458,52300,4.639,25.815,-49013,-19.845,11.940,1135,1238,4209
2021,444,42381,69375,1377574,1360686,3457,4.978,3589,5.168,109932,21935,87997,1.612,8.079,77749,16977,60772,1.248,5.714,32183,2.365,11.428,2209,2295,10740
2021,445,106457,140400,3328301,3256163,13185,9.436,11857,8.485,381528,104442,277086,3.208,11.717,235883,80321,155562,2.467,7.244,145645,4.473,14.488,7870,8266,42442
2021,446,39460,88822,993428,1008317,5843,6.529,7175,8.018,88600,32996,55604,3.272,8.787,117862,31622,86240,3.136,11.689,-29262,-2.902,17.574,3370,3915,16742
2021,447,60048,106806,981688,986757,6544,6.122,6730,6.296,117752,43378,74374,4.396,11.933,128006,38728,89278,3.925,12.972,-10254,-1.039,23.866,4009,4205,19839
2021,448,46640,116411,1360972,1487389,7975,6.544,18884,15.496,138742,46298,92444,3.113,9.328,396724,128449,268275,8.636,26.673,-257982,-17.345,18.656,5280,7409,32700
2021,451,24975,38139,457402,462083,3154,8.200,3805,9.892,67263,23042,44221,4.987,14.556,76606,23492,53114,5.084,16.578,-9343,-2.022,29.113,2152,2575,16897
2021,452,7283,55056,2767816,2766070,2711,4.963,1838,3.365,183581,25136,158445,0.909,6.637,179972,25160,154812,0.910,6.506,3609,0.130,13.013,649,1318,5376
2021,453,70023,96322,728978,747825,10157,10.458,11751,12.100,108207,45048,63159,6.024,14.470,146839,49570,97269,6.629,19.635,-38632,-5.166,28.939,7138,7889,28356
2021,454,64388,72316,936456,905901,13755,19.729,8563,12.282,157151,59257,97894,6.541,17.347,98335,35665,62670,3.937,10.855,58816,6.493,21.710,6035,6109,21925
2021,481,2199,4161,465312,495780,381,9.170,369,8.881,20708,5905,14803,1.191,4.177,81741,7060,74681,1.424,16.487,-61033,-12.311,8.354,174,194,707
2021,483,1106,1487,57013,60947,172,11.653,150,10.163,3866,986,2880,1.618,6.343,12062,1417,10645,2.325,19.791,-8196,-13.448,12.687,81,81,479
2021,484,115444,131878,1666432,1642635,27566,21.955,14918,11.882,276486,131790,144696,8.023,16.832,228332,65047,163285,3.960,13.900,48154,2.932,27.801,10339,10460,38635
2021,485,12671,15676,395162,453935,2178,13.070,4154,24.928,25496,13409,12087,2.954,5.617,143016,24096,118920,5.308,31.506,-117520,-25.889,11.233,2544,2573,13983
2021,486,228,3389,45542,45921,256,7.607,209,6.210,4405,1974,2431,4.299,9.593,5209,1343,3866,2.925,11.343,-804,-1.751,19.185,12,12,73
2021,487,2058,2185,17825,23694,372,16.682,462,20.717,2352,1251,1101,5.280,9.927,14206,3293,10913,13.898,59.956,-11854,-50.030,19.853,257,257,789
2021,488,32214,44130,768188,787667,5137,11.781,4087,9.373,99623,42603,57020,5.409,12.648,137510,31903,105607,4.050,17.458,-37887,-4.810,25.296,2444,2486,14215
2021,492,8632,14825,1092783,1026263,2281,15.959,1216,8.508,202246,83525,118721,8.139,19.707,63251,22766,40485,2.218,6.163,138995,13.544,12.326,716,771,11069
2021,493,8096,17602,1197999,1169190,1899,10.986,1265,7.318,168350,58674,109676,5.018,14.399,108969,33134,75835,2.834,9.320,59381,5.079,18.640,447,487,7786
2021,511,19941,27606,1003549,1000597,3615,13.126,3486,12.657,140723,38384,102339,3.836,14.064,135428,44478,90950,4.445,13.535,5295,0.529,27.069,1914,2065,17963
2021,512,18642,21903,241509,278483,3934,18.100,3597,16.550,39216,14460,24756,5.192,14.082,113980,23020,90960,8.266,40.929,-74764,-26.847,28.164,2028,2057,9560
2021,515,3872,8028,271504,273138,1014,12.715,908,11.386,39352,16503,22849,6.042,14.407,43241,14710,28531,5.386,15.831,-3889,-1.424,28.815,234,251,1347
2021,517,10771,58675,942710,980718,4313,7.186,7003,11.668,99413,30997,68416,3.161,10.137,172180,44058,128122,4.492,17.557,-72767,-7.420,20.274,1058,1171,6088
2021,518,9647,15583,548968,553599,2268,14.262,2906,18.274,99500,34578,64922,6.246,17.973,107693,40220,67473,7.265,19.453,-8193,-1.480,35.947,835,864,9369
2021,519,9544,11700,318636,324205,1797,15.741,1229,10.766,30651,10713,19938,3.304,9.454,41882,10319,31563,3.183,12.918,-11231,-3.464,18.908,840,842,4898
2021,521,16,67,20728,20480,6,9.375,0,0.000,682,15,667,0.073,3.330,179,0,179,0.000,0.874,503,2.456,1.748,0,0,0
2021,522,34623,180804,2963853,2944155,12726,7.005,14447,7.953,426589,130002,296587,4.416,14.489,385989,124232,261757,4.220,13.110,40600,1.379,26.221,2127,2566,13776
2021,523,57626,97306,941104,934712,11488,12.021,8003,8.375,136643,59601,77042,6.376,14.619,123048,48438,74610,5.182,13.164,13595,1.454,26.329,4454,4505,16590
2021,524,123017,166490,2748963,2751443,16094,9.654,16537,9.920,326205,95214,230991,3.461,11.856,331279,117146,214133,4.258,12.040,-5074,-0.184,23.712,8567,8705,34011
2021,525,1346,1404,8005,7884,391,29.825,205,15.637,1700,1195,505,15.157,21.563,1456,530,926,6.722,18.468,244,3.095,36.936,176,177,435
2021,531,262105,330615,1713295,1718272,48892,15.078,36174,11.156,273718,136122,137596,7.922,15.930,285961,102728,183233,5.979,16.642,-12243,-0.713,31.860,21531,21796,58886
2021,532,18616,46196,435068,477792,3868,8.227,5508,11.715,44741,19223,25518,4.023,9.364,131003,29781,101222,6.233,27.418,-86262,-18.054,18.728,1932,2018,9900
2021,533,2006,2144,37138,36711,224,10.344,267,12.330,5969,1473,4496,4.012,16.260,5120,1311,3809,3.571,13.947,849,2.313,27.894,189,189,907
2021,541,716547,820662,9494946,9492468,105957,13.030,91023,11.193,1352622,465705,886917,4.906,14.249,1347027,462878,884149,4.876,14.190,5595,0.059,28.381,62438,63022,241017
2021,551,24765,50180,3462885,3508467,3821,7.574,4363,8.648,455134,102001,353133,2.907,12.972,543659,131231,412428,3.740,15.496,-88525,-2.523,25.945,818,951,18439
2021,561,286098,355450,11076146,11165260,50792,14.436,43592,12.389,1775901,531381,1244520,4.759,15.906,1948449,420212,1528237,3.764,17.451,-172548,-1.545,31.811,26334,26546,182758
2021,562,18092,25460,456296,454427,2528,10.099,1674,6.687,56000,22256,33744,4.898,12.323,51848,12920,38928,2.843,11.410,4152,0.914,22.819,1178,1191,8199
2021,611,86933,98563,3432239,3595677,10896,11.003,11823,11.939,219233,67564,151669,1.879,6.097,545701,75898,469803,2.111,15.177,-326468,-9.079,12.194,7719,7894,45580
2021,621,447882,608406,8144671,8077296,60809,10.095,48682,8.082,1190492,447596,742896,5.541,14.739,1057093,318751,738342,3.946,13.087,133399,1.652,26.174,31377,32336,163959
2021,622,2932,7239,6084080,6138586,338,4.721,178,2.486,191707,28321,163386,0.461,3.123,300913,35211,265702,0.574,4.902,-109206,-1.779,6.246,45,48,12676
2021,623,39418,92475,3254766,3395835,6428,7.027,4420,4.832,253578,119829,133749,3.529,7.467,536064,104751,431313,3.085,15.786,-282486,-8.319,14.935,2236,2504,54600
2021,624,128459,175008,3217153,3359929,18115,10.415,15960,9.176,362062,135807,226255,4.042,10.776,647127,122229,524898,3.638,19.260,-285065,-8.484,21.552,9713,9999,62318
2021,711,39990,41145,341607,441252,7941,19.120,8716,20.986,43824,20084,23740,4.552,9.932,243865,35895,207970,8.135,55.267,-200041,-45.335,19.863,4850,4869,19445
2021,712,6797,7268,120462,140518,412,5.643,479,6.560,4929,1698,3231,1.208,3.508,44868,1871,42997,1.332,31.931,-39939,-28.423,7.015,270,270,1104
2021,713,60264,72309,1371104,1573942,8156,11.101,10483,14.268,150169,65970,84199,4.191,9.541,554079,98156,455923,6.236,35.203,-403910,-25.662,19.082,6900,7037,55242
2021,721,50809,63728,1514906,1838525,5336,8.387,5129,8.061,103355,55928,47427,3.042,5.622,745496,74838,670658,4.071,40.549,-642141,-34.927,11.243,3349,3447,41085
2021,722,432967,610255,10650959,11441901,64361,10.483,71767,11.689,1425122,716930,708192,6.266,12.455,3014094,784800,2229294,6.859,26.343,-1588972,-13.887,24.911,44187,45782,434857
2021,811,178781,199924,1287397,1298864,20000,10.038,18652,9.361,178803,78614,100189,6.053,13.766,201764,64679,137085,4.980,15.534,-22961,-1.768,27.532,13209,13451,46165
2021,812,184593,220627,1351887,1451214,32584,14.743,33342,15.086,207309,114084,93225,7.861,14.285,407451,122781,284670,8.461,28.077,-200142,-13.791,28.570,20389,21752,74029
2021,813,280220,289295,2488377,2621938,15517,5.332,18972,6.519,185879,54018,131861,2.060,7.089,452496,71604,380892,2.731,17.258,-266617,-10.169,14.179,11655,11673,40823
2022,113,7177,7310,49600,49628,707,9.621,784,10.669,6937,1991,4946,4.012,13.978,7086,2435,4651,4.907,14.278,-149,-0.300,27.956,648,648,1897
2022,114,1749,1760,7185,6999,308,17.605,287,16.405,1453,749,704,10.702,20.760,1111,555,556,7.930,15.874,342,4.886,31.747,238,238,452
2022,115,9619,10195,110025,108120,1297,12.814,1150,11.362,22417,7296,15121,6.748,20.734,18617,5940,12677,5.494,17.219,3800,3.515,34.438,911,943,3667
2022,211,3681,4723,84655,86037,366,7.611,538,11.187,10790,3367,7423,3.913,12.541,13515,5815,7700,6.759,15.708,-2725,-3.167,25.082,372,389,3205
2022,212,3197,5705,166785,165801,382,6.673,421,7.354,18645,4468,14177,2.695,11.245,16851,5334,11517,3.217,10.163,1794,1.082,20.327,191,205,2047
2022,213,8462,10582,254520,240628,1298,12.211,1394,13.114,58382,12413,45969,5.159,24.262,30318,14346,15972,5.962,12.600,28064,11.663,25.199,901,934,6671
2022,221,6084,19541,645391,639580,1518,7.835,1186,6.121,70312,19294,51018,3.017,10.993,58946,16594,42352,2.595,9.216,11366,1.777,18.433,308,332,1901
2022,236,205654,209528,1582073,1537751,36045,17.585,26951,13.148,310107,106967,203140,6.956,20.166,220739,81594,139145,5.306,14.355,89368,5.812,28.709,22467,22494,64241
2022,237,31247,34250,1011250,1000453,2907,8.478,2981,8.694,158896,29987,128909,2.997,15.882,137468,35961,101507,3.594,13.741,21428,2.142,27.481,2138,2162,18894
2022,238,433540,443911,4764960,4679091,55698,12.718,43745,9.989,795654,221111,574543,4.726,17.004,623637,196388,427249,4.197,13.328,172017,3.676,26.656,35760,35840,146723
2022,311,23366,28142,1648990,1629039,3102,11.201,2207,7.969,174298,33461,140837,2.054,10.699,135490,29532,105958,1.813,8.317,38808,2.382,16.634,1749,1761,15992
2022,312,10441,11413,279800,263611,1398,12.666,647,5.862,50624,10499,40125,3.983,19.204,18133,5692,12441,2.159,6.879,32491,12.325,13.757,526,529,3986
2022,313,1489,1703,83702,83209,135,7.925,136,7.984,8682,1844,6838,2.216,10.434,7673,1529,6144,1.838,9.221,1009,1.213,18.443,106,106,762
2022,314,4603,4805,105772,104502,408,8.480,421,8.750,12166,2379,9787,2.277,11.642,9652,2622,7030,2.509,9.236,2514,2.406,18.472,331,332,1640
2022,315,4365,4460,70365,68283,760,17.459,546,12.543,13152,3546,9606,5.193,19.261,9063,2880,6183,4.218,13.273,4089,5.988,26.545,493,497,2376
2022,316,991,1019,25202,24658,98,9.679,85,8.395,3158,451,2707,1.829,12.807,2063,582,1481,2.360,8.366,1095,4.441,16.733,71,71,321
2022,321,10865,13062,444242,432079,1038,7.949,1032,7.903,60699,10297,50402,2.383,14.048,36853,15257,21596,3.531,8.529,23846,5.519,17.058,708,716,6969
2022,322,2151,3729,354794,348968,131,3.493,174,4.639,32191,3958,28233,1.134,9.225,20559,5949,14610,1.705,5.891,11632,3.333,11.783,97,99,2440
2022,323,19850,21150,388144,382176,1769,8.363,1773,8.382,51377,10505,40872,2.749,13.443,39182,15969,23213,4.178,10.252,12195,3.191,20.505,1410,1417,8291
2022,324,814,2043,100336,99908,135,6.658,104,5.129,9283,1130,8153,1.131,9.292,8236,2105,6131,2.107,8.244,1047,1.048,16.487,18,18,265
2022,325,9709,13812,893591,870998,1324,9.679,1058,7.734,109846,27441,82405,3.151,12.612,64826,20268,44558,2.327,7.443,45020,5.169,14.885,659,674,6566
2022,326,7987,11080,811568,798239,554,4.988,607,5.465,84108,12786,71322,1.602,10.537,57577,16506,41071,2.068,7.213,26531,3.324,14.426,385,393,5380
2022,327,8200,14309,407071,405395,740,5.149,866,6.026,47490,7232,40258,1.784,11.715,44234,13374,30860,3.299,10.911,3256,0.803,21.823,435,457,4091
2022,331,2553,3472,350983,343544,143,4.097,180,5.157,35017,3825,31192,1.113,10.193,20009,5408,14601,1.574,5.824,15008,4.369,11.649,113,117,1728
2022,332,46528,51025,1427469,1400298,3073,6.006,3346,6.540,171738,44625,127113,3.187,12.264,118452,40587,77865,2.898,8.459,53286,3.805,16.918,2574,2594,21441
2022,333,18030,20733,1064794,1038221,1106,5.303,1352,6.483,124799,16279,108520,1.568,12.020,71112,26838,44274,2.585,6.849,53687,5.171,13.699,992,1000,9607
2022,334,9065,10634,794401,787578,633,5.903,813,7.581,80572,14250,66322,1.809,10.230,67304,21045,46259,2.672,8.546,13268,1.685,17.091,569,573,5657
2022,335,4275,5048,354224,346407,364,7.210,365,7.230,39707,6612,33095,1.909,11.463,23583,7730,15853,2.231,6.808,16124,4.655,13.616,265,268,3030
2022,336,8547,10938,1617048,1595004,857,7.895,692,6.375,161373,34533,126840,2.165,10.117,117506,24151,93355,1.514,7.367,43867,2.750,14.734,493,498,7105
2022,337,12949,13497,370773,362808,1116,8.284,1066,7.913,45892,7211,38681,1.988,12.649,29581,9513,20068,2.622,8.153,16311,4.496,16.307,840,845,5011
2022,339,20544,22108,556990,546593,1984,8.994,1884,8.541,74152,17833,56319,3.263,13.566,53188,12320,40868,2.254,9.731,20964,3.835,19.462,1526,1530,7741
2022,423,140614,215318,3552615,3496099,14652,6.772,16730,7.733,483862,108587,375275,3.106,13.840,369935,142687,227248,4.081,10.581,113927,3.259,21.163,9942,10602,65171
2022,424,83186,114760,2325846,2271152,9736,8.492,9525,8.308,327330,91960,235370,4.049,14.413,219410,87608,131802,3.857,9.661,107920,4.752,19.321,6272,6519,39058
2022,425,28946,31013,249860,249923,3608,11.626,3652,11.767,41060,16907,24153,6.765,16.429,40909,22368,18541,8.950,16.369,151,0.060,32.737,2885,2941,9569
2022,441,71578,114361,2025923,1996696,8246,7.226,7766,6.805,256513,88141,168372,4.414,12.847,197776,80506,117270,4.032,9.905,58737,2.942,19.810,5392,5595,49300
2022,442,26978,42996,443172,434984,2984,6.953,2821,6.574,63324,14078,49246,3.236,14.558,48232,12926,35306,2.972,11.088,15092,3.470,22.176,1840,1934,7466
2022,443,11878,20582,220287,220877,1136,5.378,2216,10.491,21439,4102,17337,1.857,9.706,22512,13167,9345,5.961,10.192,-1073,-0.486,19.413,1160,1295,6752
2022,444,42440,69963,1445836,1410910,4283,6.132,4058,5.810,168468,27963,140505,1.982,11.940,100125,23812,76313,1.688,7.096,68343,4.844,14.193,2590,2757,16446
2022,445,111109,144741,3323180,3331126,14985,10.465,11882,8.298,292689,101900,190789,3.059,8.786,310375,75932,234443,2.279,9.317,-17686,-0.531,17.573,8777,8993,45007
2022,446,38429,87240,1037059,1011080,6512,7.442,7049,8.055,162920,54621,108299,5.402,16.113,110345,56509,53836,5.589,10.914,52575,5.200,21.827,3391,3625,16074
2022,447,57072,104230,989389,979914,7378,7.055,8068,7.715,160912,58815,102097,6.002,16.421,139553,45689,93864,4.663,14.241,21359,2.180,28.483,4973,5294,25074
2022,448,46912,114713,1450017,1400613,9888,8.617,9959,8.679,272377,64916,207461,4.635,19.447,177090,56417,120673,4.028,12.644,95287,6.803,25.287,4028,5013,19447
2022,451,25908,39362,473267,465696,3943,10.170,2762,7.124,62247,18004,44243,3.866,13.366,46669,12412,34257,2.665,10.021,15578,3.345,20.043,1897,1968,7116
2022,452,6821,56764,2697636,2731630,4415,7.933,2192,3.939,197252,44490,152762,1.629,7.221,255541,79455,176086,2.909,9.355,-58289,-2.134,14.442,693,1004,2807
2022,453,74568,101203,795785,762111,13711,13.915,8378,8.502,158875,58678,100197,7.699,20.847,92349,37040,55309,4.860,12.118,66526,8.729,24.235,6045,6351,24183
2022,454,68257,77128,1010195,976121,13998,18.634,9983,13.289,174876,64322,110554,6.590,17.915,107030,45612,61418,4.673,10.965,67846,6.951,21.930,8458,8514,34618
2022,481,2265,4238,509329,487323,387,9.200,324,7.702,56887,2126,54761,0.436,11.673,13374,4420,8954,0.907,2.744,43513,8.929,5.489,190,193,704
2022,483,1138,1472,60559,58833,206,13.976,210,14.247,8189,967,7222,1.644,13.919,4637,1318,3319,2.240,7.882,3552,6.037,15.763,105,155,525
2022,484,128125,145267,1725510,1695540,31676,22.854,18348,13.238,284224,115806,168418,6.830,16.763,226577,90788,135789,5.355,13.363,57647,3.400,26.726,14922,15106,60210
2022,485,14035,17050,428255,415419,3447,21.064,2076,12.686,72243,18750,53493,4.514,17.390,45929,21466,24463,5.167,11.056,26314,6.334,22.112,1677,1694,9052
2022,486,225,3357,44545,44492,169,5.052,145,4.335,4473,1056,3417,2.373,10.054,4360,1072,3288,2.409,9.800,113,0.254,19.599,21,21,179
2022,487,2276,2410,23939,20960,521,22.628,306,13.290,7965,1717,6248,8.192,38.001,1906,956,950,4.561,9.094,6059,28.907,18.187,248,248,736
2022,488,33152,45408,810102,778931,5594,12.502,4268,9.538,155575,45764,109811,5.875,19.973,92980,32217,60763,4.136,11.937,62595,8.036,23.874,2802,2900,14775
2022,492,9336,15354,1197318,1149489,2074,13.750,1533,10.163,235975,45761,190214,3.981,20.529,130187,26489,103698,2.304,11.326,105788,9.203,22.651,1025,1094,18047
2022,493,8398,18870,1295175,1249484,2762,15.098,1609,8.795,183922,60510,123412,4.843,14.720,93857,31453,62404,2.517,7.512,90065,7.208,15.023,465,509,6390
2022,511,21188,28629,1091119,1075396,3854,13.571,3395,11.954,206299,54025,152274,5.024,19.184,177211,65574,111637,6.098,16.479,29088,2.705,32.957,2210,2320,25427
2022,512,19711,22969,308443,274639,4284,19.096,3214,14.326,96505,23091,73414,8.408,35.139,29908,12796,17112,4.659,10.890,66597,24.249,21.780,2483,2511,7955
2022,515,3682,7543,271788,271300,329,4.269,656,8.512,25055,4303,20752,1.586,9.235,24123,8484,15639,3.127,8.892,932,0.344,17.783,206,224,1969
2022,517,10653,57508,941180,940578,5663,9.750,6813,11.730,163922,35474,128448,3.772,17.428,163885,44809,119076,4.764,17.424,37,0.004,34.848,1370,1750,9682
2022,518,9824,15338,569300,560264,2175,13.995,2581,16.608,118625,36232,82393,6.467,21.173,98998,43189,55809,7.709,17.670,19627,3.503,35.340,1092,1171,14889
2022,519,9203,11297,333740,324851,1683,15.096,1387,12.441,50415,10454,39961,3.218,15.519,33287,15078,18209,4.642,10.247,17128,5.273,20.494,1034,1052,8887
2022,521,17,67,21053,20907,4,6.154,0,0.000,513,20,493,0.096,2.454,206,0,206,0.000,0.985,307,1.468,1.971,0,0,0
2022,522,34701,176091,2941130,2953135,12214,6.845,16927,9.486,471145,148356,322789,5.024,15.954,493043,244911,248132,8.293,16.696,-21898,-0.742,31.908,2790,3239,18890
2022,523,59620,100670,991501,964847,11761,11.868,8615,8.694,167533,66631,100902,6.906,17.364,112942,41048,71894,4.254,11.706,54591,5.658,23.411,5159,5304,19631
2022,524,121620,166483,2812247,2779074,17458,10.495,17173,10.324,446489,141327,305162,5.085,16.066,379754,120219,259535,4.326,13.665,66735,2.401,27.330,10397,10750,48029
2022,525,1443,1495,8983,8361,369,25.922,226,15.876,2366,1146,1220,13.706,28.298,1136,655,481,7.834,13.587,1230,14.711,27.174,192,192,544
2022,531,271760,342202,1797827,1754797,49671,14.771,37812,11.244,332419,143110,189309,8.155,18.943,246113,121847,124266,6.944,14.025,86306,4.918,28.050,27756,28144,76419
2022,532,19589,46777,491137,463280,4990,10.734,4414,9.495,108359,24838,83521,5.361,23.390,51543,18340,33203,3.959,11.126,56816,12.264,22.251,1787,2588,10953
2022,533,2044,2246,40145,38330,362,16.560,242,11.070,7703,2201,5502,5.742,20.097,4108,1459,2649,3.806,10.718,3595,9.379,21.435,186,188,940
2022,541,726449,825913,10075041,9757437,109842,13.339,104908,12.740,1907758,558616,1349142,5.725,19.552,1268888,611040,657848,6.262,13.004,638870,6.548,26.009,75750,76610,296468
2022,551,24245,49452,3625698,3547723,3509,7.032,4407,8.831,564228,81883,482345,2.308,15.904,409999,120264,289735,3.390,11.557,154229,4.347,23.113,954,988,13219
2022,561,294813,360146,11585929,11260325,49282,13.776,44485,12.435,2322127,509400,1812727,4.524,20.622,1669086,524484,1144602,4.658,14.823,653041,5.799,29.645,30076,30579,227878
2022,562,18917,26334,477600,467549,2780,10.706,2047,7.883,77718,24739,52979,5.291,16.622,57071,24007,33064,5.135,12.206,20647,4.416,24.413,1407,1430,11352
2022,611,90985,102288,3707733,3584549,12518,12.454,8972,8.926,445586,67670,377916,1.888,12.431,200282,59524,140758,1.661,5.587,245304,6.843,11.175,6638,6812,37512
2022,621,450740,620088,8392857,8262094,61433,10.005,49341,8.035,1316038,416275,899763,5.038,15.929,1052608,371926,680682,4.502,12.740,263430,3.188,25.480,34991,36476,214745
2022,622,3018,7543,6144575,6114269,379,5.091,183,2.458,319694,52170,267524,0.853,5.229,257686,40968,216718,0.670,4.215,62008,1.014,8.429,53,53,15834
2022,623,39600,91135,3185012,3224623,5278,5.747,6688,7.282,364840,128928,235912,3.998,11.314,443425,128093,315332,3.972,13.751,-78585,-2.437,22.628,3144,3504,69295
2022,624,133146,179771,3417375,3323171,19451,10.969,14572,8.217,590955,156755,434200,4.717,17.783,401058,129559,271499,3.899,12.069,189897,5.714,24.137,9806,10040,65897
2022,711,44487,45762,504191,422855,10631,24.435,6123,14.073,200881,37325,163556,8.827,47.506,38191,17193,20998,4.066,9.032,162690,38.474,18.063,4942,4956,12549
2022,712,7083,7558,142925,131766,569,7.655,320,4.305,27812,3192,24620,2.422,21.107,5508,1971,3537,1.496,4.180,22304,16.927,8.360,238,238,1380
2022,713,63121,75470,1639240,1504188,10047,13.588,6987,9.450,395469,82284,313185,5.470,26.291,127890,50095,77795,3.330,8.502,267579,17.789,17.005,5440,5527,37602
2022,721,51451,64105,1767485,1633253,6530,10.209,6241,9.758,411723,85705,326018,5.248,25.209,145253,69750,75503,4.271,8.893,266470,16.315,17.787,4391,4562,41328
2022,722,454704,635402,11979045,11320912,76884,12.338,52333,8.398,2670136,918022,1752114,8.109,23.586,1343058,507799,835259,4.485,11.864,1327078,11.722,23.727,38059,39868,333679
2022,811,181069,203291,1348570,1319844,22234,11.019,19203,9.517,240228,89538,150690,6.784,18.201,182447,84220,98227,6.381,13.823,57781,4.378,27.647,15256,15606,60811
2022,812,196832,232746,1492282,1417454,36977,16.315,24776,10.932,353832,124794,229038,8.804,24.963,204096,98779,105317,6.969,14.399,149736,10.564,28.798,18684,19151,70703
2022,813,281933,290722,2622378,2553147,17971,6.200,16190,5.586,351860,64650,287210,2.532,13.781,213821,58371,155450,2.286,8.375,138039,5.407,16.750,12300,12342,39871
