year,sector,firms,estabs,emp,denom,estabs_entry,estabs_entry_rate,estabs_exit,estabs_exit_rate,job_creation,job_creation_births,job_creation_continuers,job_creation_rate_births,job_creation_rate,job_destruction,job_destruction_deaths,job_destruction_continuers,job_destruction_rate_deaths,job_destruction_rate,net_job_creation,net_job_creation_rate,reallocation_rate,firmdeath_firms,firmdeath_estabs,firmdeath_emp
1978,11,20358,21019,185795,178798,4011,19.226,3698,17.726,57372,20570,36802,11.505,32.088,43724,17668,26056,9.882,24.454,13648,7.633,48.909,2690,2715,12047
1978,21,19105,24709,708633,710248,3948,16.224,3199,13.146,165068,57509,107559,8.097,23.241,168344,59996,108348,8.447,23.702,-3276,-0.461,46.482,1747,1783,16712
1978,22,5681,11859,658516,643489,928,7.946,567,4.855,80920,19715,61205,3.064,12.575,51198,12451,38747,1.935,7.956,29722,4.619,15.913,215,217,1820
1978,23,426309,431986,4095927,3822634,91838,22.160,56730,13.689,1336332,421722,914610,11.032,34.958,788469,273470,514999,7.154,20.626,547863,14.332,41.253,43833,43872,190035
1978,31-33,263909,311911,18324614,17892952,33616,10.894,26929,8.727,2407302,506190,1901112,2.829,13.454,1546160,528925,1017235,2.956,8.641,861142,4.813,17.282,18993,19135,224138
1978,42,235790,306378,3826450,3703833,38494,12.772,28511,9.460,793757,259109,534648,6.996,21.431,548775,247285,301490,6.676,14.816,244982,6.614,29.633,18036,18394,105518
1978,44-45,741550,1000784,9940686,9621886,136447,13.762,117903,11.891,2092467,816278,1276189,8.484,21.747,1457266,640907,816359,6.661,15.145,635201,6.602,30.291,77864,79711,318954
1978,48-49,90310,110558,2432380,2341394,18462,16.945,15247,13.994,545548,167378,378170,7.149,23.300,363178,136587,226591,5.834,15.511,182370,7.789,31.022,10904,10953,56821
1978,51,38463,62984,2164336,2107636,7918,12.754,6111,9.844,373216,83041,290175,3.940,17.708,258978,80448,178530,3.817,12.288,114238,5.420,24.575,3362,3478,32247
1978,52,146358,233803,4105764,3982340,25161,10.973,16134,7.037,679960,167548,512412,4.207,17.074,430870,134940,295930,3.388,10.820,249090,6.255,21.639,8679,8783,37414
1978,53,169264,178089,1024448,979878,30613,17.546,23374,13.397,293536,122133,171403,12.464,29.956,203084,95725,107359,9.769,20.725,90452,9.231,41.451,18247,18301,58593
1978,54,234677,250085,2217643,2115461,42345,17.546,24854,10.298,534296,197486,336810,9.335,25.257,330533,149600,180933,7.072,15.625,203763,9.632,31.249,17483,17751,95606
1978,55,18993,36128,2428735,2362628,3944,11.034,3177,8.888,524500,138903,385597,5.879,22.200,391529,97797,293732,4.139,16.572,132971,5.628,33.144,400,431,4528
1978,56,109139,121871,1961924,1834412,26432,22.651,16079,13.779,620230,206902,413328,11.279,33.811,366272,133171,233101,7.260,19.967,253958,13.844,39.933,11938,12019,72450
1978,61,30432,32424,1282237,1211637,4458,14.044,3098,9.759,272273,33454,238819,2.761,22.472,134005,64316,69689,5.308,11.060,138268,11.412,22.120,2260,2292,48802
1978,62,313994,340668,5845564,5579704,40859,12.349,21276,6.430,1007202,291686,715516,5.228,18.051,474129,192870,281259,3.457,8.497,533073,9.554,16.995,14703,14883,108264
1978,71,42613,44706,650943,614788,7669,17.637,5220,12.005,168217,60126,108091,9.780,27.362,96124,35822,60302,5.827,15.635,72093,11.726,31.271,3856,3874,22420
1978,72,286031,342041,5218158,4936398,61698,18.264,53225,15.756,1519285,777231,742054,15.745,30.777,953269,484598,468671,9.817,19.311,566016,11.466,38.622,38177,38757,300719
1978,81,430337,463829,3164734,3020615,62279,13.651,47072,10.318,763720,241157,522563,7.984,25.284,473667,179520,294147,5.943,15.681,290053,9.602,31.362,33772,34118,114292
1979,11,20027,20633,185894,186548,3612,17.490,3650,17.674,50071,19437,30634,10.419,26.841,51580,20607,30973,11.047,27.650,-1509,-0.809,53.682,2618,2662,13911
1979,21,19853,25591,819708,765274,4190,16.726,3111,12.418,218346,53660,164686,7.012,28.532,109606,45606,64000,5.959,14.322,108740,14.209,28.645,1868,1885,19101
1979,22,5947,12131,683736,672011,789,6.570,545,4.538,62484,21587,40897,3.212,9.298,39494,8065,31429,1.200,5.877,22990,3.421,11.754,213,213,897
1979,23,448273,453978,4582670,4355258,84801,19.122,63780,14.382,1383348,390620,992728,8.969,31.763,928401,305674,622727,7.019,21.317,454947,10.446,42.634,49605,49636,224287
1979,31-33,261130,309745,19113251,18733325,31453,10.191,29253,9.478,2445824,512800,1933024,2.737,13.056,1681062,550566,1130496,2.939,8.974,764762,4.082,17.947,19294,19478,220969
1979,42,247495,319360,4087885,3983135,35619,11.286,28124,8.911,756207,235710,520497,5.918,18.985,546680,209521,337159,5.260,13.725,209527,5.260,27.450,17767,18086,95145
1979,44-45,753555,1020350,10422110,10206313,123883,12.244,106738,10.550,1882218,742092,1140126,7.271,18.442,1444641,532170,912471,5.214,14.154,437577,4.287,28.309,73284,74924,303017
1979,48-49,93830,114687,2598759,2515453,19049,16.952,14413,12.826,495786,148578,347208,5.907,19.710,328815,103423,225392,4.112,13.072,166971,6.638,26.144,10732,10774,54888
1979,51,40714,64892,2280363,2228311,8041,12.557,6325,9.878,411892,81666,330226,3.665,18.484,308518,82970,225548,3.723,13.845,103374,4.639,27.691,3396,3425,25976
1979,52,152444,246442,4453090,4285649,26562,11.040,14853,6.174,724601,195155,529446,4.554,16.908,390761,101664,289097,2.372,9.118,333840,7.790,18.236,8970,9022,37081
1979,53,179084,189104,1125863,1078934,32132,17.393,23399,12.666,307935,124893,183042,11.576,28.541,214597,95191,119406,8.823,19.890,93338,8.651,39.779,18440,18491,63375
1979,54,252616,268576,2447778,2338143,44477,17.120,26928,10.365,536671,194067,342604,8.300,22.953,316215,126175,190040,5.396,13.524,220456,9.429,27.048,19670,19867,79234
1979,55,20026,37773,2573911,2501924,4305,11.619,2862,7.724,463418,144587,318831,5.779,18.522,317598,78274,239324,3.129,12.694,145820,5.828,25.388,424,429,4563
1979,56,118878,132615,2210321,2089591,27797,21.873,16740,13.172,628599,210326,418273,10.065,30.082,387319,128732,258587,6.161,18.536,241280,11.547,37.071,12674,12749,76702
1979,61,31267,33268,1322093,1270503,4198,12.804,3233,9.861,205024,29451,175573,2.318,16.137,100969,22803,78166,1.795,7.947,104055,8.190,15.894,2437,2472,14789
1979,62,330209,359024,6201180,6022531,38741,11.061,21170,6.044,872059,266208,605851,4.420,14.480,517018,176398,340620,2.929,8.585,355041,5.895,17.169,15363,15544,115847
1979,71,44797,46893,702673,677609,7745,16.905,5589,12.199,170867,51671,119196,7.625,25.216,120266,38592,81674,5.695,17.749,50601,7.468,35.497,4112,4136,27251
1979,72,292344,351803,5545298,5396968,58838,16.929,50336,14.483,1394643,713476,681167,13.220,25.841,1102709,458360,644349,8.493,20.432,291934,5.409,40.864,36305,36831,294744
1979,81,443977,478797,3339242,3255633,59940,12.707,45793,9.708,680922,227404,453518,6.985,20.915,514036,168849,345187,5.186,15.789,166886,5.126,31.578,33675,34001,116391
1980,11,19979,20586,187244,187524,3282,15.900,3392,16.433,45617,16313,29304,8.699,24.326,46386,15232,31154,8.123,24.736,-769,-0.410,48.652,2581,2581,10799
1980,21,21123,26896,856047,839820,4357,16.594,3077,11.719,172642,56482,116160,6.725,20.557,140104,45587,94517,5.428,16.683,32538,3.874,33.365,1988,2030,21654
1980,22,5956,12215,698989,691119,576,4.731,495,4.066,43076,11276,31800,1.632,6.233,27477,7856,19621,1.137,3.976,15599,2.257,7.951,279,281,1162
1980,23,439875,445342,4425748,4484988,71355,15.875,79623,17.715,1094242,323687,770555,7.217,24.398,1213112,352289,860823,7.855,27.048,-118870,-2.650,48.796,61255,61282,259369
1980,31-33,265485,313960,18723168,18891316,32373,10.387,27798,8.919,1970466,501421,1469045,2.654,10.431,2312873,596647,1716226,3.158,12.243,-342407,-1.813,20.861,19907,20052,239056
1980,42,253004,325201,4133218,4119198,34796,10.781,29914,9.268,640126,209310,430816,5.081,15.540,612058,221283,390775,5.372,14.859,28068,0.681,29.717,19377,19709,100513
1980,44-45,751969,1024896,10287781,10360906,115236,11.266,111217,10.873,1581024,702633,878391,6.782,15.260,1723049,553389,1169660,5.341,16.630,-142025,-1.371,30.519,76699,78811,321979
1980,48-49,94432,115730,2561616,2581354,17549,15.234,16485,14.310,384412,129369,255043,5.012,14.892,423697,112050,311647,4.341,16.414,-39285,-1.522,29.784,12621,12694,61862
1980,51,42716,67357,2348527,2311451,8455,12.787,5983,9.049,488495,84453,404042,3.654,21.134,414681,67863,346818,2.936,17.940,73814,3.193,35.881,3815,3905,31844
1980,52,154840,251693,4656623,4560665,23247,9.333,18045,7.244,632321,182610,449711,4.004,13.865,440791,130816,309975,2.868,9.665,191530,4.200,19.330,10457,10542,46740
1980,53,179087,189264,1117294,1120656,28713,15.176,28576,15.104,265875,110291,155584,9.842,23.725,271891,116248,155643,10.373,24.262,-6016,-0.537,47.450,22634,22698,78296
1980,54,265503,281999,2581489,2520106,44585,16.193,31266,11.355,497917,184938,312979,7.339,19.758,374749,138891,235858,5.511,14.870,123168,4.887,29.741,22986,23124,88879
1980,55,20555,38896,2649333,2607973,3974,10.366,2855,7.447,417351,122159,295192,4.684,16.003,332589,96856,235733,3.714,12.753,84762,3.250,25.506,568,592,6517
1980,56,127004,141566,2316782,2265880,27862,20.319,18975,13.838,557295,200093,357202,8.831,24.595,456030,130914,325116,5.778,20.126,101265,4.469,40.252,14453,14514,79128
1980,61,31547,33581,1382196,1358667,3715,11.116,3395,10.158,158308,22081,136227,1.625,11.652,111969,22442,89527,1.652,8.241,46339,3.411,16.482,2657,2676,15679
1980,62,344307,374695,6403532,6287675,39597,10.801,23434,6.392,791406,252099,539307,4.009,12.587,558672,180716,377956,2.874,8.885,232734,3.701,17.770,16958,17141,115859
1980,71,46296,48619,717424,710834,7783,16.297,6062,12.693,144337,50864,93473,7.156,20.305,131216,40970,90246,5.764,18.459,13121,1.846,36.919,4519,4539,27158
1980,72,291927,354375,5647126,5597816,55531,15.725,53046,15.022,1305449,694110,611339,12.400,23.321,1209523,484436,725087,8.654,21.607,95926,1.714,43.214,38592,39176,309516
1980,81,447746,483872,3353620,3349813,55396,11.507,50497,10.489,586032,205687,380345,6.140,17.494,578618,174510,404108,5.210,17.273,7414,0.221,34.546,37569,37854,123200
1981,11,19219,19812,179027,182599,2810,13.944,3489,17.314,41602,14777,26825,8.093,22.783,48798,19376,29422,10.611,26.724,-7196,-3.941,45.567,2486,2489,11514
1981,21,23905,29997,957180,907357,6176,21.693,3121,10.963,231885,79856,152029,8.801,25.556,131905,47854,84051,5.274,14.537,99980,11.019,29.075,2074,2092,24386
1981,22,5957,12293,722431,712097,628,5.142,467,3.824,44030,9482,34548,1.332,6.183,23486,6418,17068,0.901,3.298,20544,2.885,6.596,258,259,1364
1981,23,420897,426472,4275589,4349393,62263,14.287,80905,18.565,1046796,310936,735860,7.149,24.068,1191108,342837,848271,7.882,27.386,-144312,-3.318,48.135,60930,60965,257431
1981,31-33,273376,322208,18176645,18443451,35503,11.163,27186,8.548,1894407,645682,1248725,3.501,10.271,2427569,609116,1818453,3.303,13.162,-533162,-2.891,20.543,19702,19851,231667
1981,42,259180,333400,4215961,4170606,38395,11.665,29913,9.088,710465,279054,431411,6.691,17.035,619666,208462,411204,4.998,14.858,90799,2.177,29.716,20372,20803,107878
1981,44-45,743367,1028989,10227838,10256298,116704,11.371,111377,10.852,1614408,737052,877356,7.186,15.741,1669470,551734,1117736,5.379,16.278,-55062,-0.537,31.481,77947,80673,330474
1981,48-49,93849,115991,2503308,2535965,16677,14.400,16321,14.093,349170,128410,220760,5.064,13.769,414113,116619,297494,4.599,16.330,-64943,-2.561,27.537,12378,12426,64583
1981,51,45423,70302,2445720,2397345,9408,13.671,6443,9.362,493869,96129,397740,4.010,20.601,403254,70110,333144,2.924,16.821,90615,3.780,33.642,4128,4204,33511
1981,52,156585,256762,4908946,4775986,24778,9.747,19657,7.733,756754,227828,528926,4.770,15.845,492694,174054,318640,3.644,10.316,264060,5.529,20.632,11339,11441,66280
1981,53,176253,187079,1141188,1126033,26859,14.289,28637,15.235,267523,119666,147857,10.627,23.758,237541,100971,136570,8.967,21.095,29982,2.663,42.191,22605,22727,70151
1981,54,277791,295631,2754113,2667522,47579,16.483,33644,11.655,559725,217256,342469,8.144,20.983,385366,138524,246842,5.193,14.447,174359,6.536,28.893,25244,25420,90298
1981,55,21463,41359,2768294,2713183,4934,12.260,2707,6.726,457415,157298,300117,5.798,16.859,346346,66479,279867,2.450,12.765,111069,4.094,25.531,565,576,5837
1981,56,134601,150257,2353590,2332432,29084,19.929,20452,14.014,549266,213818,335448,9.167,23.549,506806,145527,361279,6.239,21.729,42460,1.820,43.457,15688,15800,91210
1981,61,31927,34035,1449874,1418870,3758,11.098,3413,10.079,166693,25598,141095,1.804,11.748,104225,21933,82292,1.546,7.346,62468,4.403,14.691,2638,2662,14299
1981,62,360647,393421,6791651,6607221,43255,11.265,24350,6.342,921177,330263,590914,4.999,13.942,548436,180507,367929,2.732,8.301,372741,5.641,16.601,18024,18205,122759
1981,71,47839,50263,745316,731979,7889,15.966,6186,12.519,151513,59830,91683,8.174,20.699,124382,37255,87127,5.090,16.993,27131,3.707,33.985,4581,4602,25217
1981,72,292409,357812,5758792,5701946,55568,15.609,51958,14.595,1255399,696650,558749,12.218,22.017,1141652,459623,682029,8.061,20.022,113747,1.995,40.044,38390,39131,313770
1981,81,448241,485398,3404850,3379602,54373,11.221,52669,10.870,615503,224469,391034,6.642,18.212,565762,188908,376854,5.590,16.740,49741,1.472,33.481,38655,39097,134521
1982,11,17956,18614,169727,172430,2600,13.649,3469,18.211,42832,16078,26754,9.324,24.840,48086,16623,31463,9.640,27.887,-5254,-3.047,49.681,2415,2420,11377
1982,21,26368,32811,1015349,986948,6786,21.576,4066,12.928,258661,90545,168116,9.174,26.208,202790,72956,129834,7.392,20.547,55871,5.661,41.094,2754,2774,32204
1982,22,5859,12240,747598,735518,449,3.670,439,3.588,47955,7461,40494,1.014,6.520,24210,4792,19418,0.652,3.292,23745,3.228,6.583,282,282,1590
1982,23,389008,395108,3890763,4057083,54293,13.255,83299,20.336,923817,265413,658404,6.542,22.770,1256974,369877,887097,9.117,30.982,-333157,-8.212,45.541,58288,58321,267344
1982,31-33,274415,323358,17333155,17788356,30735,9.502,30920,9.559,1675883,452339,1223544,2.543,9.421,2585992,606576,1979416,3.410,14.538,-910109,-5.116,18.842,22456,22624,254477
1982,42,263183,338168,4210113,4220640,37883,11.245,35346,10.492,729310,246642,482668,5.844,17.280,751569,254002,497567,6.018,17.807,-22259,-0.527,34.559,23045,23442,127864
1982,44-45,726514,1024171,10136388,10181592,119312,11.624,123796,12.061,1701101,717243,983858,7.045,16.708,1790074,626977,1163097,6.158,17.581,-88973,-0.874,33.415,85247,87900,362008
1982,48-49,92470,115525,2438976,2473386,16489,14.267,16588,14.353,345959,114980,230979,4.649,13.987,414286,110423,303863,4.464,16.750,-68327,-2.762,27.975,12449,12543,66918
1982,51,46650,72158,2451793,2446692,9298,13.086,7087,9.974,323976,97764,226212,3.996,13.241,315080,66891,248189,2.734,12.878,8896,0.364,25.756,4917,4996,37990
1982,52,156531,256712,4767022,4724332,22271,8.683,21802,8.501,613957,177314,436643,3.753,12.996,526357,161179,365178,3.412,11.141,87600,1.854,22.283,12771,12893,69579
1982,53,169260,180914,1123969,1133803,24703,13.451,30177,16.432,249244,103071,146173,9.091,21.983,267982,110282,157700,9.727,23.636,-18738,-1.653,43.966,23803,23881,80421
1982,54,279427,298145,2659810,2620822,48508,16.529,39178,13.349,574024,230411,343613,8.792,21.902,498633,188532,310101,7.194,19.026,75391,2.877,38.052,29529,29690,122142
1982,55,22131,42820,2807631,2794058,4660,11.058,3305,7.842,522373,182875,339498,6.545,18.696,492294,116340,375954,4.164,17.619,30079,1.077,35.239,644,657,8487
1982,56,146269,164135,2559532,2529838,30404,18.979,22524,14.060,604032,209745,394287,8.291,23.876,545384,169384,376000,6.695,21.558,58648,2.318,43.116,17127,17185,100379
1982,61,31671,34126,1494966,1484195,3703,10.872,3572,10.487,157772,27144,130628,1.829,10.630,135950,22796,113154,1.536,9.160,21822,1.470,18.320,2732,2744,15146
1982,62,375013,410873,7086050,6963757,44410,11.013,29131,7.224,922987,312357,610630,4.485,13.254,677899,207803,470096,2.984,9.735,245088,3.519,19.469,22092,22330,149084
1982,71,48957,51881,769914,757561,8885,17.404,7227,14.156,159583,58688,100895,7.747,21.065,134884,43414,91470,5.731,17.805,24699,3.260,35.610,5493,5516,33592
1982,72,288274,356850,5843831,5804552,53994,15.109,55002,15.391,1345954,685081,660873,11.802,23.188,1264101,520061,744040,8.960,21.778,81853,1.410,43.556,41523,42185,348000
1982,81,450085,488242,3457565,3445573,55528,11.389,54186,11.113,645481,225132,420349,6.534,18.734,618519,189988,428531,5.514,17.951,26962,0.783,35.902,39571,39865,132514
1983,11,18120,18748,168654,169958,2903,15.495,2877,15.356,42752,15297,27455,9.000,25.155,45330,16240,29090,9.555,26.671,-2578,-1.517,50.309,2057,2063,10483
1983,21,25452,31664,789171,904433,4318,13.355,5654,17.487,119535,50457,69078,5.579,13.217,350759,88319,262440,9.765,38.782,-231224,-25.566,26.433,3930,3957,42313
1983,22,5668,12090,751781,747532,585,4.864,458,3.808,51811,14999,36812,2.006,6.931,43054,6092,36962,0.815,5.759,8757,1.171,11.519,226,229,1048
1983,23,391645,397637,3789423,3867634,63585,16.019,62169,15.662,957724,289415,668309,7.483,24.763,1114938,290990,823948,7.524,28.827,-157214,-4.065,49.525,43906,43953,205678
1983,31-33,274849,322833,16186019,16783295,30043,9.297,30693,9.498,1566186,398169,1168017,2.372,9.332,2761287,610157,2151130,3.636,16.453,-1195101,-7.121,18.664,22079,22260,251408
1983,42,265869,340029,4074683,4141743,37785,11.150,35471,10.467,632393,215774,416619,5.210,15.269,765880,246771,519109,5.958,18.492,-133487,-3.223,30.538,23278,23799,130193
1983,44-45,731044,1029784,10129839,10142607,119763,11.656,115192,11.211,1679322,715624,963698,7.056,16.557,1707460,653753,1053707,6.446,16.835,-28138,-0.277,33.114,75736,78535,329330
1983,48-49,93226,116154,2371629,2405518,17093,14.749,16568,14.296,365829,126583,239246,5.262,15.208,432574,131371,301203,5.461,17.983,-66745,-2.775,30.416,11556,11676,64063
1983,51,47848,71591,2447535,2468964,9797,13.629,10387,14.449,710011,116149,S,4.704,28.757,765424,311514,453910,12.617,31.002,-55413,-2.244,57.515,4871,4978,37580
1983,52,165069,267432,4976749,4817636,33797,12.927,21833,8.351,906366,317759,588607,6.596,18.814,588352,204970,383382,4.255,12.212,318014,6.601,24.425,12367,12554,99632
1983,53,170302,182251,1139746,1134388,26909,14.811,25773,14.186,261988,114104,147884,10.059,23.095,251957,107450,144507,9.472,22.211,10031,0.884,44.422,19499,19591,71741
1983,54,314590,335272,2943281,2913014,57825,17.818,36336,11.197,568010,239432,328578,8.219,19.499,508355,168419,339936,5.782,17.451,59655,2.048,34.902,26294,26551,107012
1983,55,22683,42569,2751064,2780568,4164,9.754,4405,10.319,445061,134943,310118,4.853,16.006,503635,121085,382550,4.355,18.113,-58574,-2.107,32.012,644,660,7382
1983,56,141284,157899,2406565,2391592,30134,19.501,23388,15.135,580468,203032,377436,8.489,24.271,549110,181143,367967,7.574,22.960,31358,1.311,45.920,17563,17674,110802
1983,61,32677,35045,1505799,1479192,4292,12.442,3192,9.254,159408,33063,126345,2.235,10.777,106138,20452,85686,1.383,7.175,53270,3.601,14.351,2396,2437,14008
1983,62,391753,430418,7350879,7214645,46468,11.045,27039,6.427,948314,371799,576515,5.153,13.144,674126,202343,471783,2.805,9.344,274188,3.800,18.688,19603,19943,129791
1983,71,52466,55469,776852,771976,10283,19.076,7158,13.279,156077,64049,92028,8.297,20.218,146087,46853,99234,6.069,18.924,9990,1.294,37.848,5304,5342,32353
1983,72,298030,368669,5987826,5915905,62080,17.112,50310,13.868,1365227,735934,629293,12.440,23.077,1219164,505512,713652,8.545,20.608,146063,2.469,41.216,36640,37324,319453
1983,81,456882,496396,3453497,3425952,62067,12.653,50330,10.260,626776,233861,392915,6.826,18.295,572983,193522,379461,5.649,16.725,53793,1.570,33.450,36044,36525,132977
1984,11,18882,19467,178173,173440,3239,16.944,2536,13.267,47801,16852,30949,9.716,27.561,38526,12740,25786,7.346,22.213,9275,5.348,44.426,1819,1824,9135
1984,21,25380,31718,799441,791347,4468,14.088,4461,14.066,174076,44587,129489,5.634,21.997,159337,52875,106462,6.682,20.135,14739,1.863,40.270,3199,3229,27076
1984,22,5743,12240,756305,752892,739,6.114,433,3.582,41813,11675,30138,1.551,5.554,34889,5694,29195,0.756,4.634,6924,0.920,9.268,231,231,1141
1984,23,422210,428296,4289128,4044376,81318,19.651,52366,12.654,1356203,387351,968852,9.578,33.533,868532,250461,618071,6.193,21.475,487671,12.058,42.950,38720,38754,188263
1984,31-33,281173,328987,17338054,16782839,34217,10.499,28037,8.603,2601033,527651,2073382,3.144,15.498,1492030,515630,976400,3.072,8.890,1109003,6.608,17.780,20800,20958,209867
1984,42,271710,346612,4336930,4210537,39528,11.510,33143,9.651,807557,251440,556117,5.972,19.179,554115,208126,345989,4.943,13.160,253442,6.019,26.320,22787,23266,117269
1984,44-45,741700,1045829,10755129,10447796,123560,11.903,107986,10.403,1949649,758793,1190856,7.263,18.661,1333462,529150,804312,5.065,12.763,616187,5.898,25.526,75083,77441,309733
1984,48-49,96632,119946,2520972,2446782,19373,16.413,15543,13.169,476896,133201,343695,5.444,19.491,329738,117081,212657,4.785,13.476,147158,6.014,26.953,11162,11261,61090
1984,51,49965,76465,2537750,2496156,13777,18.618,8842,11.949,621538,350533,271005,14.043,24.900,535903,184894,351009,7.407,21.469,85635,3.431,42.938,5051,5138,36873
1984,52,169437,274045,4868188,4800483,31630,11.702,24125,8.926,812146,277165,534981,5.774,16.918,675753,265560,410193,5.532,14.077,136393,2.841,28.154,15001,15149,166083
1984,53,177687,191846,1276577,1208687,33825,18.083,24244,12.961,361613,175086,186527,14.486,29.918,222273,101230,121043,8.375,18.390,139340,11.528,36.779,18796,18903,71313
1984,54,335227,356632,3229632,3090929,59892,17.307,38727,11.191,721786,265610,456176,8.593,23.352,443998,172557,271441,5.583,14.365,277788,8.987,28.729,28523,28744,113739
1984,55,23398,43591,2851828,2797586,4347,10.098,3258,7.569,471911,136317,335594,4.873,16.869,363594,84569,279025,3.023,12.997,108317,3.872,25.993,713,731,8541
1984,56,151474,168826,2760211,2587699,32625,19.966,21777,13.327,760369,223708,536661,8.645,29.384,413486,146424,267062,5.658,15.979,346883,13.405,31.958,16600,16714,94900
1984,61,33823,36329,1524676,1502274,4573,12.816,3279,9.190,162773,27588,135185,1.836,10.835,118134,22567,95567,1.502,7.864,44639,2.971,15.727,2511,2535,15651
1984,62,404931,445527,7668497,7516728,43740,9.986,28675,6.547,960555,370058,590497,4.923,12.779,655098,214480,440618,2.853,8.715,305457,4.064,17.430,21325,21664,144496
1984,71,54133,57231,819720,797396,10154,18.045,8231,14.628,175323,64058,111265,8.033,21.987,130798,46783,84015,5.867,16.403,44525,5.584,32.806,6294,6347,33741
1984,72,302609,375856,6389114,6191498,61184,16.430,54236,14.565,1475423,758522,716901,12.251,23.830,1081565,518461,563104,8.374,17.469,393858,6.361,34.937,40453,41148,332365
1984,81,503782,543755,3754543,3608432,96248,18.500,49255,9.467,802797,330006,472791,9.145,22.248,510209,179941,330268,4.987,14.139,292588,8.108,28.279,36565,37080,126400
1985,11,18909,19465,177225,177288,2994,15.404,2937,15.111,45076,15592,29484,8.795,25.425,45074,15012,30062,8.468,25.424,2,0.001,50.848,2111,2115,10288
1985,21,25249,31505,762052,769885,4265,13.473,4569,14.433,139696,42587,97109,5.532,18.145,155836,57780,98056,7.505,20.241,-16140,-2.096,36.290,3280,3305,30014
1985,22,5769,12210,764587,760128,639,5.242,597,4.898,44320,8968,35352,1.180,5.831,35446,8329,27117,1.096,4.663,8874,1.167,9.326,317,317,1933
1985,23,443424,449596,4653976,4480740,83993,19.135,62710,14.286,1433570,441185,992385,9.846,31.994,1088392,356427,731965,7.955,24.290,345178,7.704,48.581,46379,46420,266433
1985,31-33,285164,332256,17266829,17300227,34640,10.484,30918,9.358,2087101,539014,1548087,3.116,12.064,2149091,804047,1345044,4.648,12.422,-61990,-0.358,24.128,22760,23018,335360
1985,42,273997,348923,4470944,4413102,40198,11.555,38130,10.960,797287,248352,548935,5.628,18.066,682480,296392,386088,6.716,15.465,114807,2.602,30.930,26634,27257,177742
1985,44-45,735096,1038965,11185311,10968112,122815,11.782,129706,12.443,1987934,771402,1216532,7.033,18.125,1554354,721029,833325,6.574,14.172,433580,3.953,28.343,88316,92186,424204
1985,48-49,98815,122400,2621200,2571178,19992,16.494,17601,14.522,474597,134305,340292,5.223,18.458,374675,148335,226340,5.769,14.572,99922,3.886,29.144,12903,13004,80549
1985,51,50730,78597,2616028,2584978,11500,14.837,9321,12.026,491208,194333,296875,7.518,19.002,432410,121115,311295,4.685,16.728,58798,2.275,33.456,6067,6191,56797
1985,52,168724,275961,5055530,4954472,31117,11.323,28814,10.485,859029,254419,604610,5.135,17.338,660117,253800,406317,5.123,13.324,198912,4.015,26.647,18188,18347,131812
1985,53,182916,198262,1384579,1329041,36036,18.482,29479,15.119,379851,175462,204389,13.202,28.581,270143,130083,140060,9.788,20.326,109708,8.255,40.652,22986,23086,92478
1985,54,351911,374213,3483914,3359483,63402,17.348,45908,12.561,783238,286472,496766,8.527,23.314,532580,228120,304460,6.790,15.853,250658,7.461,31.706,34757,34992,164251
1985,55,23750,43751,3003002,2927933,4118,9.430,3958,9.063,543319,140691,402628,4.805,18.556,395884,122549,273335,4.186,13.521,147435,5.035,27.042,981,993,11313
1985,56,159919,178284,3149331,2955823,35138,20.248,25654,14.783,918238,264980,653258,8.965,31.065,529858,192962,336896,6.528,17.926,388380,13.139,35.852,20000,20165,132918
1985,61,34096,36715,1550583,1538620,4423,12.115,4009,10.981,184890,27733,157157,1.802,12.017,160931,49384,111547,3.210,10.459,23959,1.557,20.919,3101,3132,31049
1985,62,413605,455948,7998433,7829997,45146,10.015,34818,7.724,1180844,466698,714146,5.960,15.081,843700,331415,512285,4.233,10.775,337144,4.306,21.550,26763,27182,240936
1985,71,55993,59096,837267,829778,10589,18.214,8670,14.913,194391,68986,125405,8.314,23.427,180514,81266,99248,9.794,21.754,13877,1.672,43.509,6631,6684,42813
1985,72,301404,376779,6679444,6539595,61890,16.440,61240,16.268,1593816,829492,764324,12.684,24.372,1309015,655677,653338,10.026,20.017,284801,4.355,40.034,45826,46872,411812
1985,81,512226,552559,3918589,3838466,70154,12.797,61426,11.205,758530,258510,500020,6.735,19.761,598922,243102,355820,6.333,15.603,159608,4.158,31.206,44831,45423,173458
1986,11,18526,19079,173966,175582,2844,14.773,3189,16.565,44274,15523,28751,8.841,25.216,47523,18071,29452,10.292,27.066,-3249,-1.850,50.431,2291,2292,11200
1986,21,24228,30127,686912,724681,3443,11.167,4852,15.737,112508,39248,73260,5.416,15.525,188433,53514,134919,7.384,26.002,-75925,-10.477,31.050,3390,3424,26793
1986,22,5930,12473,773470,770126,791,6.407,538,4.358,51548,16689,34859,2.167,6.693,43963,5822,38141,0.756,5.709,7585,0.985,11.417,276,276,1548
1986,23,462690,468553,4815850,4718600,83959,18.293,64765,14.111,1363071,406556,956515,8.616,28.887,1167451,364162,803289,7.718,24.741,195620,4.146,49.483,47469,47521,262008
1986,31-33,284682,331669,16809105,16933203,33663,10.161,32910,9.934,1930821,541795,1389026,3.200,11.403,2177511,679760,1497751,4.014,12.859,-246690,-1.457,22.805,24344,24527,296343
1986,42,276597,353339,4540942,4513171,41831,11.905,37915,10.790,777991,255972,522019,5.672,17.238,721281,267309,453972,5.923,15.982,56710,1.257,31.963,25910,26436,146360
1986,44-45,735982,1054949,11568448,11382618,134386,12.837,118282,11.298,2138993,914553,1224440,8.035,18.792,1770111,649630,1120481,5.707,15.551,368882,3.241,31.102,80953,83905,371891
1986,48-49,100237,124844,2676746,2648852,20597,16.662,18140,14.675,485446,162190,323256,6.123,18.327,429011,144182,284829,5.443,16.196,56435,2.131,32.392,13213,13419,83201
1986,51,50922,79176,2646896,2632740,10812,13.710,10186,12.916,432971,141618,291353,5.379,16.446,408544,124904,283640,4.744,15.518,24427,0.928,31.036,6241,6344,51009
1986,52,171719,282627,5299249,5166744,31610,11.318,24936,8.928,917496,278623,638873,5.393,17.758,652374,219967,432407,4.257,12.626,265122,5.131,25.253,14989,15216,106015
1986,53,189424,206966,1475618,1424231,37799,18.664,28915,14.277,395148,165114,230034,11.593,27.745,290205,129225,160980,9.073,20.376,104943,7.368,40.753,22119,22294,90753
1986,54,368757,392780,3709025,3595070,64784,16.900,45892,11.972,806214,295224,510990,8.212,22.426,576818,215712,361106,6.000,16.045,229396,6.381,32.089,34212,34405,150907
1986,55,24503,44778,3071927,3040602,5055,11.422,4016,9.074,541071,171671,369400,5.646,17.795,476865,113968,362897,3.748,15.683,64206,2.112,31.366,902,957,10070
1986,56,169872,189728,3414893,3280760,37861,20.579,26368,14.332,895812,305233,590579,9.304,27.305,627379,204327,423052,6.228,19.123,268433,8.182,38.246,19950,20062,132433
1986,61,34679,37562,1596455,1578152,4761,12.821,3904,10.513,180162,31042,149120,1.967,11.416,143872,29411,114461,1.864,9.116,36290,2.300,18.233,2978,3022,19942
1986,62,423357,470908,8396731,8244804,48873,10.542,34280,7.394,1189507,451391,738116,5.475,14.427,881437,270179,611258,3.277,10.691,308070,3.737,21.382,25575,25918,196982
1986,71,57708,61310,880804,859958,10912,18.111,8794,14.596,198141,77021,121120,8.956,23.041,156528,56577,99951,6.579,18.202,41613,4.839,36.404,6647,6675,38616
1986,72,304562,385774,7069151,6879873,67132,17.605,58216,15.267,1748877,992045,756832,14.420,25.420,1370092,606720,763372,8.819,19.914,378785,5.506,39.829,42761,43673,401851
1986,81,522855,565027,4053170,3985676,70090,12.543,57605,10.309,753967,282010,471957,7.076,18.917,619409,217940,401469,5.468,15.541,134558,3.376,31.082,41585,42184,155305
1987,11,18421,18977,170858,170501,3109,16.513,2811,14.930,47176,17183,29993,10.078,27.669,46099,18778,27321,11.013,27.037,1077,0.632,54.075,2058,2060,11605
1987,21,21621,27222,578807,632507,3291,11.498,6090,21.278,97884,41428,56456,6.550,15.476,205220,75848,129372,11.992,32.445,-107336,-16.970,30.951,4029,4064,31974
1987,22,5844,12393,774290,772758,654,5.294,575,4.655,45838,13958,31880,1.806,5.932,43066,7975,35091,1.032,5.573,2772,0.359,11.146,313,315,1606
1987,23,485658,492062,4965017,4877830,90479,18.838,66956,13.940,1407254,441939,965315,9.060,28.850,1234210,409421,824789,8.394,25.302,173044,3.548,50.605,49892,49934,282447
1987,31-33,286017,332737,16522435,16658447,35126,10.577,33854,10.194,1897280,535297,1361983,3.213,11.389,2174495,760351,1414144,4.564,13.053,-277215,-1.664,22.779,23996,24227,300581
1987,42,279786,357272,4671838,4637353,43355,12.146,42714,11.966,883091,307018,576073,6.621,19.043,812078,325172,486906,7.012,17.512,71013,1.531,35.023,26632,27290,159386
1987,44-45,729897,1059955,11923546,11732794,136344,12.912,128328,12.153,2293835,988114,1305721,8.422,19.551,1911575,783482,1128093,6.678,16.293,382260,3.258,32.585,82526,85578,409953
1987,48-49,103252,128677,2852556,2799704,22360,17.603,19056,15.002,578143,190321,387822,6.798,20.650,472182,204940,267242,7.320,16.865,105961,3.785,33.731,13083,13241,90227
1987,51,46228,76072,2539117,2542860,12180,16.119,11158,14.767,511203,273987,237216,10.775,20.103,516975,164781,352194,6.480,20.330,-5772,-0.227,40.207,6926,7103,70255
1987,52,173890,289319,5493500,5369892,34083,11.950,25878,9.073,956966,321318,635648,5.984,17.821,707275,218544,488731,4.070,13.171,249691,4.650,26.342,15843,16202,100021
1987,53,193496,212988,1500555,1480817,38683,18.426,32585,15.521,396114,182938,213176,12.354,26.750,358976,170819,188157,11.535,24.242,37138,2.508,48.484,24747,24963,106756
1987,54,386477,413483,4008483,3910913,66571,16.417,50630,12.485,889880,319984,569896,8.182,22.754,693088,279931,413157,7.158,17.722,196792,5.032,35.444,37221,37437,175171
1987,55,24505,44524,3024400,3051148,5330,11.976,5294,11.895,555466,172971,382495,5.669,18.205,610700,178671,432029,5.856,20.015,-55234,-1.810,36.410,1001,1036,13891
1987,56,179992,201376,3556810,3463304,40795,20.840,29557,15.099,989280,384885,604395,11.113,28.565,802039,278099,523940,8.030,23.158,187241,5.406,46.316,22121,22397,157783
1987,61,34784,38441,1637972,1610982,4642,12.180,3981,10.446,184652,33790,150862,2.097,11.462,129957,30872,99085,1.916,8.067,54695,3.395,16.134,3011,3036,19655
1987,62,430442,482970,9243094,8998615,49237,10.312,38238,8.008,1765763,899031,866732,9.991,19.623,1280161,354169,925992,3.936,14.226,485602,5.396,28.452,28066,28399,227425
1987,71,58739,63303,938902,918912,11267,18.064,9409,15.085,220950,84828,136122,9.231,24.045,180854,64512,116342,7.020,19.681,40096,4.363,39.363,7196,7226,45242
1987,72,308965,399275,7406004,7253382,72393,18.427,59552,15.159,1820203,1004983,815220,13.855,25.095,1517478,686727,830751,9.468,20.921,302725,4.174,41.842,43995,44899,444619
1987,81,528273,573125,4074998,4028426,70447,12.394,60973,10.727,769549,286763,482786,7.118,19.103,675583,252110,423473,6.258,16.770,93966,2.333,33.541,44259,44738,170446
1988,11,18757,19233,178943,174832,3139,16.423,2899,15.168,50800,20718,30082,11.850,29.056,42514,18638,23876,10.661,24.317,8286,4.739,48.634,2062,2065,11126
1988,21,21244,26499,576872,579117,3426,12.755,4148,15.443,120076,36090,83986,6.232,20.734,125013,50274,74739,8.681,21.587,-4937,-0.853,41.469,2645,2678,18840
1988,22,6043,12627,771124,772304,944,7.547,706,5.644,49403,18212,31191,2.358,6.397,52326,17792,34534,2.304,6.775,-2923,-0.378,12.794,243,325,6622
1988,23,495852,502349,5074300,5031244,83829,16.854,73881,14.854,1330097,394707,935390,7.845,26.437,1243751,393736,850015,7.826,24.721,86346,1.716,49.441,55950,56029,294651
1988,31-33,291863,339642,17060717,16876782,36336,10.776,31433,9.322,2283652,720176,1563476,4.267,13.531,1919722,678426,1241296,4.020,11.375,363930,2.156,22.750,23356,23546,293913
1988,42,284050,363415,4781327,4739544,42935,11.898,37804,10.476,866868,296657,570211,6.259,18.290,786467,311559,474908,6.574,16.594,80401,1.696,33.187,25352,26092,165535
1988,44-45,735643,1078776,12351224,12165919,134619,12.570,118941,11.106,2325719,1014843,1310876,8.342,19.117,1955840,739148,1216692,6.076,16.076,369879,3.040,32.153,77867,81543,391757
1988,48-49,105025,132110,3001167,2932405,22440,17.200,19151,14.679,624262,216157,408105,7.371,21.288,482082,182361,299721,6.219,16.440,142180,4.849,32.880,13473,13679,95050
1988,51,47732,77447,2576896,2561007,10889,14.100,10447,13.528,378286,149003,229283,5.818,14.771,347140,128945,218195,5.035,13.555,31146,1.216,27.110,5590,5758,52186
1988,52,173354,295328,5251402,5275215,37245,12.793,28876,9.918,863873,321110,542763,6.087,16.376,906093,287295,618798,5.446,17.176,-42220,-0.800,32.752,16128,16370,114483
1988,53,197912,220486,1585126,1545250,36428,16.801,29087,13.416,418539,203330,215209,13.158,27.086,337800,145241,192559,9.399,21.861,80739,5.225,43.721,21979,22293,99400
1988,54,401361,430790,4266791,4153682,69661,16.484,53301,12.612,934436,354921,579515,8.545,22.497,708559,281015,427544,6.765,17.059,225877,5.438,34.117,39556,39935,172570
1988,55,25544,47447,3065068,3051563,8204,17.842,5272,11.466,647254,215247,432007,7.054,21.211,619915,189129,430786,6.198,20.315,27339,0.896,40.629,869,920,14636
1988,56,189078,212830,3872309,3721649,41950,20.245,30707,14.819,1144211,431992,712219,11.608,30.745,839639,308951,530688,8.301,22.561,304572,8.184,45.122,23160,23422,180935
1988,61,35964,39963,1696012,1678654,5142,13.100,3721,9.480,179508,35965,143543,2.142,10.694,145140,27530,117610,1.640,8.646,34368,2.047,17.292,2755,2802,19920
1988,62,438236,496193,9441254,9297089,49484,10.106,36374,7.429,1345454,505995,839459,5.443,14.472,1059638,395638,664000,4.256,11.398,285816,3.074,22.795,26401,26906,247905
1988,71,62783,67433,983664,963045,13196,20.153,9287,14.183,230480,86465,144015,8.978,23.932,188510,71195,117315,7.393,19.574,41970,4.358,39.149,6956,7045,47895
1988,72,314991,410959,7653814,7539907,69135,17.051,58124,14.336,1790765,937745,853020,12.437,23.750,1571319,646135,925184,8.570,20.840,219446,2.910,41.680,40774,41797,408862
1988,81,538041,585087,4198738,4138537,69785,12.052,57639,9.955,784841,290058,494783,7.009,18.964,664396,229034,435362,5.534,16.054,120445,2.910,32.108,41597,42133,154265
1989,11,19066,19577,179228,179791,3020,15.554,2698,13.896,44578,17194,27384,9.563,24.794,45748,14871,30877,8.271,25.445,-1170,-0.651,49.589,2004,2005,10799
1989,21,20541,25715,559419,569324,2954,11.307,3775,14.449,101783,37868,63915,6.651,17.878,121638,49450,72188,8.686,21.365,-19855,-3.487,35.756,2553,2591,22092
1989,22,6317,12872,766130,769107,817,6.394,630,4.930,40384,12955,27429,1.684,5.251,46124,10914,35210,1.419,5.997,-5740,-0.746,10.502,287,287,1740
1989,23,504326,510558,5204540,5137253,80363,15.867,72230,14.261,1357611,387952,969659,7.552,26.427,1222949,392672,830277,7.644,23.806,134662,2.621,47.611,54879,54963,287822
1989,31-33,295000,342828,17314214,17173519,34970,10.245,32006,9.376,2140653,578054,1562599,3.366,12.465,1859014,655099,1203915,3.815,10.825,281639,1.640,21.650,23601,23859,281067
1989,42,286542,367369,4921903,4853518,41693,11.409,37803,10.345,870809,277880,592929,5.725,17.942,733907,309877,424030,6.385,15.121,136902,2.821,30.242,25562,26349,155710
1989,44-45,737428,1090426,12741033,12552024,126845,11.692,115677,10.663,2253092,950715,1302377,7.574,17.950,1882719,704711,1178008,5.614,14.999,370373,2.951,29.999,78154,82746,404367
1989,48-49,107196,134964,3095941,3048543,21170,15.858,18241,13.664,584759,196337,388422,6.440,19.182,493794,183055,310739,6.005,16.198,90965,2.984,32.395,13085,13316,88334
1989,51,49392,81496,2633366,2611671,13391,16.820,9627,12.092,447034,161745,285289,6.193,17.117,403779,150733,253046,5.772,15.461,43255,1.656,30.921,5650,5807,51704
1989,52,175222,302300,5348773,5306460,43755,14.647,36609,12.255,938597,401285,537312,7.562,17.688,865981,337698,528283,6.364,16.319,72616,1.368,32.639,15593,15823,127466
1989,53,200708,224871,1631655,1607433,35185,15.806,30648,13.768,391657,164482,227175,10.233,24.365,341696,140959,200737,8.769,21.257,49961,3.108,42.514,23309,23760,101816
1989,54,412647,443504,4556624,4414368,66410,15.206,52895,12.111,994675,360009,634666,8.155,22.533,711645,296728,414917,6.722,16.121,283030,6.412,32.242,39543,39957,172953
1989,55,26566,49793,3181866,3126658,6778,13.941,4433,9.118,617713,234608,383105,7.503,19.756,509600,123783,385817,3.959,16.299,108113,3.458,32.597,956,989,14571
1989,56,198476,225000,4227258,4053326,42806,19.533,31110,14.196,1180120,419320,760800,10.345,29.115,835153,291334,543819,7.188,20.604,344967,8.511,41.208,23801,24035,182501
1989,61,37277,41519,1759880,1725415,5172,12.668,3788,9.278,203669,43483,160186,2.520,11.804,134581,34262,100319,1.986,7.800,69088,4.004,15.600,2820,2891,24446
1989,62,446273,508804,9857342,9638980,49183,9.786,36715,7.305,1309218,433005,876213,4.492,13.583,872088,338494,533594,3.512,9.048,437130,4.535,18.095,27507,28165,214601
1989,71,65256,70164,1034389,1011289,12290,17.832,9804,14.225,226548,79320,147228,7.843,22.402,179275,65708,113567,6.497,17.727,47273,4.675,35.455,7521,7633,48495
1989,72,320815,420952,7940150,7800710,67196,16.151,57412,13.799,1740844,888444,852400,11.389,22.316,1461666,653975,807691,8.384,18.738,279178,3.579,37.475,41907,43273,427311
1989,81,548822,598576,4382280,4293087,69404,11.719,56767,9.585,814233,293151,521082,6.828,18.966,636354,231906,404448,5.402,14.823,177879,4.143,29.646,42287,43298,167233
1990,11,19708,20253,183371,181703,3324,16.681,2672,13.409,46112,18947,27165,10.427,25.378,42821,15575,27246,8.572,23.566,3291,1.811,47.133,1934,1946,10354
1990,21,20355,25414,568097,562410,2982,11.655,3324,12.992,103721,31111,72610,5.532,18.442,92228,36632,55596,6.513,16.399,11493,2.044,32.797,2204,2238,16444
1990,22,6428,13214,777011,771654,983,7.542,622,4.772,50872,19205,31667,2.489,6.593,40623,6817,33806,0.883,5.264,10249,1.328,10.529,339,339,2056
1990,23,513947,520168,5323886,5263951,81774,15.866,72278,14.023,1371313,385619,985694,7.326,26.051,1251115,383881,867234,7.293,23.768,120198,2.283,47.535,55039,55106,299741
1990,31-33,297134,345448,17066980,17204222,33755,9.810,31058,9.026,1745704,517990,1227714,3.011,10.147,2020196,559735,1460461,3.253,11.742,-274492,-1.595,20.294,23666,23862,260766
1990,42,288948,371803,5030998,4976059,40839,11.051,36344,9.835,827441,273618,553823,5.499,16.628,717896,265117,452779,5.328,14.427,109545,2.201,28.854,25517,26346,159467
1990,44-45,733726,1094884,12973847,12865081,120244,11.003,116113,10.625,2098076,863071,1235005,6.709,16.308,1881720,684240,1197480,5.319,14.627,216356,1.682,29.253,79862,84140,414628
1990,48-49,108856,137187,3209996,3152196,20608,15.145,18370,13.501,579761,183992,395769,5.837,18.392,463421,173145,290276,5.493,14.702,116340,3.691,29.403,13488,13688,90663
1990,51,50546,82899,2731731,2685195,11336,13.791,9935,12.087,425160,150598,274562,5.608,15.833,332826,120322,212504,4.481,12.395,92334,3.439,24.790,5695,5791,47444
1990,52,177809,311065,5484115,5435638,37309,12.165,28581,9.319,907958,336630,571328,6.193,16.704,810598,255747,554851,4.705,14.913,97360,1.791,29.825,15484,15602,99818
1990,53,202270,228102,1683306,1657185,33768,14.912,30463,13.452,387601,167617,219984,10.115,23.389,335214,146352,188862,8.831,20.228,52387,3.161,40.456,23158,23565,100070
1990,54,424217,456672,4781723,4669529,65608,14.581,52169,11.594,938787,332757,606030,7.126,20.105,716594,260819,455775,5.586,15.346,222193,4.758,30.692,39726,40049,179607
1990,55,27647,52036,3257969,3214607,6803,13.364,4544,8.926,559237,184855,374382,5.750,17.397,471939,116154,355785,3.613,14.681,87298,2.716,29.362,1034,1063,12361
1990,56,207346,235539,4575426,4415391,42867,18.613,32412,14.073,1217062,421350,795712,9.543,27.564,897444,308048,589396,6.977,20.325,319618,7.239,40.651,24983,25276,195155
1990,61,38802,43218,1846392,1811350,5471,12.893,3906,9.205,211440,54487,156953,3.008,11.673,141974,41121,100853,2.270,7.838,69466,3.835,15.676,2898,2946,21538
1990,62,455362,522674,10398417,10151303,48534,9.406,35133,6.809,1310352,413185,897167,4.070,12.908,814196,277968,536228,2.738,8.021,496156,4.888,16.041,26942,27507,180869
1990,71,65591,70509,1102999,1067600,10649,15.159,10126,14.415,236605,78209,158396,7.326,22.162,165590,63150,102440,5.915,15.510,71015,6.652,31.021,7783,7860,46919
1990,72,324747,428110,8143040,8043498,65343,15.389,58318,13.735,1685248,854671,830577,10.626,20.952,1486067,630432,855635,7.838,18.475,199181,2.476,36.951,42908,44087,421049
1990,81,558253,610188,4533140,4461629,67783,11.213,56464,9.340,793248,274403,518845,6.150,17.779,649419,220600,428819,4.944,14.556,143829,3.224,29.111,42762,43453,161626
1991,11,20140,20668,183846,185670,2904,14.042,2931,14.172,44657,16156,28501,8.701,24.052,48638,16649,31989,8.967,26.196,-3981,-2.144,48.104,2076,2081,11948
1991,21,21032,26047,570265,571659,3033,11.603,3219,12.314,100021,38156,61865,6.675,17.497,102834,36524,66310,6.389,17.989,-2813,-0.492,34.993,2160,2191,18949
1991,22,6498,13880,775093,777345,1227,9.005,719,5.277,53751,23571,30180,3.032,6.915,58046,11275,46771,1.450,7.467,-4295,-0.553,13.829,400,402,3218
1991,23,510450,516740,4755722,5057276,71441,13.691,81606,15.639,1000927,303643,697284,6.004,19.792,1606295,452253,1154042,8.943,31.762,-605368,-11.970,39.584,59015,59110,339106
1991,31-33,297140,345066,16086581,16579733,29814,8.585,34227,9.856,1433469,406520,1026949,2.452,8.646,2421120,738982,1682138,4.457,14.603,-987651,-5.957,17.292,25667,25982,424488
1991,42,277953,362004,4762289,4837864,40316,11.140,40104,11.082,708281,257814,450467,5.329,14.640,860802,334387,526415,6.912,17.793,-152521,-3.153,29.281,27269,28066,199322
1991,44-45,714820,1078126,12595258,12780784,110409,10.168,125918,11.596,1827650,800832,1026818,6.266,14.300,2201758,812000,1389758,6.353,17.227,-374108,-2.927,28.600,82780,87716,483965
1991,48-49,108925,138464,3194838,3201897,20688,14.990,19783,14.334,538020,189976,348044,5.933,16.803,552417,201820,350597,6.303,17.253,-14397,-0.450,33.606,13862,14095,104733
1991,51,50152,86983,2708850,2729458,14806,17.411,10912,12.832,435958,218819,217139,8.017,15.972,479012,147033,331979,5.387,17.550,-43054,-1.577,31.945,5949,6077,56137
1991,52,175460,334610,5558186,5598464,55446,17.171,32036,9.921,1096787,615078,481709,10.987,19.591,1184403,330227,854176,5.899,21.156,-87616,-1.565,39.182,16280,16811,145059
1991,53,192901,226371,1589225,1615613,36189,16.124,32340,14.409,377056,201315,175741,12.461,23.338,429473,183322,246151,11.347,26.583,-52417,-3.244,46.677,24345,24774,118608
1991,54,422955,459337,4700470,4718433,64873,14.260,56059,12.323,826034,311248,514786,6.596,17.507,863749,327484,536265,6.941,18.306,-37715,-0.799,35.013,42342,42739,214835
1991,55,28507,54558,3247624,3250365,6869,12.855,4622,8.650,518219,183333,334886,5.640,15.943,522192,108360,413832,3.334,16.066,-3973,-0.122,31.887,1178,1211,13503
1991,56,212861,243471,4528149,4548750,41657,17.338,35249,14.671,1101385,435206,666179,9.568,24.213,1141860,403128,738732,8.862,25.103,-40475,-0.890,48.426,26593,26921,273101
1991,61,41299,45934,1920627,1897570,5595,12.348,4351,9.602,196378,45600,150778,2.403,10.349,151657,37145,114512,1.958,7.992,44721,2.357,15.984,3160,3241,26764
1991,62,459221,533251,10700895,10545914,48647,9.215,37932,7.186,1291907,414940,876967,3.935,12.250,980241,372975,607266,3.537,9.295,311666,2.955,18.590,28766,29325,255014
1991,71,62817,67838,1097445,1090783,9453,13.905,9742,14.330,204046,74620,129426,6.841,18.706,191306,70783,120523,6.489,17.538,12740,1.168,35.077,7531,7663,53483
1991,72,324127,430253,7943750,8038423,62223,14.525,58516,13.659,1480698,803476,677222,9.995,18.420,1667612,667135,1000477,8.299,20.746,-186914,-2.325,36.841,42736,44190,456056
1991,81,565359,620828,4529195,4540350,64479,10.437,58464,9.463,734978,266427,468551,5.868,16.188,756679,248049,508630,5.463,16.666,-21701,-0.478,32.375,43273,43972,183528
1992,11,20283,20789,186909,184322,3036,14.671,2847,13.757,46867,15445,31422,8.379,25.427,41787,14253,27534,7.733,22.671,5080,2.756,45.341,2109,2116,10872
1992,21,19849,24650,520346,542899,2610,10.360,3695,14.667,88059,31828,56231,5.863,16.220,132652,45427,87225,8.367,24.434,-44593,-8.214,32.440,2314,2341,18067
1992,22,5717,13627,772695,772812,1127,8.419,647,4.833,82275,41305,40970,5.345,10.646,82499,23484,59015,3.039,10.675,-224,-0.029,21.292,300,301,1417
1992,23,498481,504726,4509800,4601019,72904,14.350,79533,15.655,1059593,297844,761749,6.473,23.030,1241825,366876,874949,7.974,26.990,-182232,-3.961,46.059,57557,57618,270252
1992,31-33,289890,336631,15855079,15969260,27891,8.224,32907,9.703,1634364,406525,1227839,2.546,10.234,1861230,590344,1270886,3.697,11.655,-226866,-1.421,20.469,24153,24341,250364
1992,42,290916,372307,4825209,4848703,39093,10.475,40850,10.946,787571,250669,536902,5.170,16.243,834323,310824,523499,6.410,17.207,-46752,-0.964,32.486,24628,25639,137419
1992,44-45,692502,1050050,12330525,12405301,108593,10.262,124965,11.809,1848753,776743,1072010,6.261,14.903,1998887,746281,1252606,6.016,16.113,-150134,-1.210,29.806,74190,78639,372194
1992,48-49,110073,140775,3162207,3170980,20609,14.746,18585,13.298,514154,175414,338740,5.532,16.214,535412,165762,369650,5.227,16.885,-21258,-0.670,32.429,12890,13064,83933
1992,51,50280,87546,2644320,2735415,11274,12.936,10490,12.036,389990,149914,240076,5.480,14.257,572100,196197,375903,7.172,20.915,-182110,-6.657,28.514,5230,5392,63085
1992,52,174330,337013,5357035,5394747,34884,10.421,30370,9.072,874384,291327,583057,5.400,16.208,951296,314839,636457,5.836,17.634,-76912,-1.426,32.416,14100,14543,111226
1992,53,193259,229082,1570255,1586062,30775,13.479,29232,12.804,341875,144793,197082,9.129,21.555,371204,149252,221952,9.410,23.404,-29329,-1.849,43.110,20546,21177,95169
1992,54,432139,469711,4665589,4652460,62903,13.538,52788,11.361,860879,304047,556832,6.535,18.504,829925,338609,491316,7.278,17.838,30954,0.665,35.677,37120,37446,227254
1992,55,28396,53457,3213472,3231654,4880,9.028,6076,11.240,572092,154983,417109,4.796,17.703,609150,173008,436142,5.354,18.849,-37058,-1.147,35.406,887,922,14297
1992,56,212226,244138,4714223,4627245,40137,16.564,36501,15.063,1202458,437884,764574,9.463,25.986,1025407,371663,653744,8.032,22.160,177051,3.826,44.320,26801,27051,223874
1992,61,41577,46887,1975609,1945372,5551,11.992,4356,9.410,200344,36314,164030,1.867,10.298,139040,33652,105388,1.730,7.147,61304,3.151,14.294,3143,3203,24002
1992,62,466830,546340,11282116,11015977,48762,9.031,36016,6.670,1577505,503694,1073811,4.572,14.320,1047543,316744,730799,2.875,9.509,529962,4.811,19.019,25276,25777,197265
1992,71,63612,68721,1142430,1120358,9685,14.219,8471,12.437,237928,81900,156028,7.310,21.237,192908,73758,119150,6.583,17.218,45020,4.018,34.437,6119,6175,43579
1992,72,329036,436951,8127508,8057395,62663,14.421,57798,13.302,1604205,795418,808787,9.872,19.910,1468614,645776,822838,8.015,18.227,135591,1.683,36.454,39097,40142,386548
1992,81,574535,631830,4577849,4561776,63071,10.024,57858,9.195,758860,245778,513082,5.388,16.635,726183,239669,486514,5.254,15.919,32677,0.716,31.838,40121,40656,163412
1993,11,20725,21228,185793,185975,3041,14.409,2796,13.248,44863,15016,29847,8.074,24.123,45166,15156,30010,8.150,24.286,-303,-0.163,48.246,2007,2009,10622
1993,21,19265,23945,480855,498678,2595,10.706,3183,13.132,80983,29525,51458,5.921,16.240,116879,37333,79546,7.486,23.438,-35896,-7.198,32.479,2062,2081,15379
1993,22,6039,14072,759131,765841,894,6.425,578,4.154,59421,17240,42181,2.251,7.759,73117,10426,62691,1.361,9.547,-13696,-1.788,15.518,217,221,1339
1993,23,503184,509356,4550934,4522952,79048,15.653,70357,13.932,1129012,314311,814701,6.949,24.962,1073912,319329,754583,7.060,23.744,55100,1.218,47.487,51778,51819,240821
1993,31-33,292274,338652,15876224,15879390,29906,8.847,28690,8.487,1656510,388998,1267512,2.450,10.432,1662013,462168,1199845,2.910,10.466,-5503,-0.035,20.864,21646,21857,213924
1993,42,295108,375917,4893370,4854470,39230,10.482,35945,9.604,766031,227125,538906,4.679,15.780,687743,235975,451768,4.861,14.167,78288,1.613,28.334,24326,24938,132074
1993,44-45,693419,1046795,12633834,12483164,103245,9.847,106698,10.176,1996256,786023,1210233,6.297,15.992,1703261,619564,1083697,4.963,13.644,292995,2.347,27.289,66259,69675,318825
1993,48-49,114296,144961,3204281,3185418,21030,14.699,17245,12.054,497673,141355,356318,4.438,15.623,458734,151363,307371,4.752,14.401,38939,1.222,28.802,12120,12309,79559
1993,51,52132,88841,2672002,2668508,11140,12.626,9920,11.243,401770,139513,262257,5.228,15.056,393910,138204,255706,5.179,14.761,7860,0.295,29.523,4770,4933,48787
1993,52,179894,337055,5264817,5301675,34512,10.226,35418,10.494,872076,275038,597038,5.188,16.449,951391,397385,554006,7.495,17.945,-79315,-1.496,32.898,13046,13869,74531
1993,53,198125,234093,1612015,1592366,30644,13.217,26181,11.292,353136,133586,219550,8.389,22.177,313746,121989,191757,7.661,19.703,39390,2.474,39.406,18691,19098,76716
1993,54,447763,484706,4854331,4786710,65387,13.700,50495,10.580,901161,313128,588033,6.542,18.826,767037,241687,525350,5.049,16.024,134124,2.802,32.049,35539,37338,147298
1993,55,28308,51481,3161463,3191561,4487,8.557,6401,12.207,529770,131911,397859,4.133,16.599,590957,158958,431999,4.981,18.516,-61187,-1.917,33.198,853,895,11920
1993,56,220921,252791,5133310,4925161,41764,16.810,33090,13.318,1390780,432186,958594,8.775,28.238,973258,341186,632072,6.927,19.761,417522,8.477,39.522,24180,24638,218848
1993,61,43203,48516,2018956,1980406,5827,12.221,4153,8.710,222053,51923,170130,2.622,11.213,144547,32149,112398,1.623,7.299,77506,3.914,14.598,2913,2993,22286
1993,62,474421,557345,11696742,11493682,47947,8.689,36860,6.680,1474655,414817,1059838,3.609,12.830,1072959,348257,724702,3.030,9.335,401696,3.495,18.670,26529,27137,183194
1993,71,65790,71000,1203234,1172716,9842,14.078,7662,10.960,241561,85601,155960,7.299,20.598,179671,52124,127547,4.445,15.321,61890,5.277,30.642,5626,5690,36380
1993,72,337845,443425,8232299,8175612,59493,13.515,53015,12.044,1546679,738732,807947,9.036,18.918,1432101,575744,856357,7.042,17.517,114578,1.401,35.033,36363,37564,345929
1993,81,581626,637919,4664678,4614298,60121,9.470,53960,8.500,755402,220011,535391,4.768,16.371,655754,201640,454114,4.370,14.211,99648,2.160,28.423,38629,39360,138184
1994,11,21379,21903,188932,187433,3387,15.720,2672,12.402,44716,15295,29421,8.160,23.857,41358,13509,27849,7.207,22.065,3358,1.792,44.131,1986,1986,9380
1994,21,18984,23794,488633,487271,2530,10.564,2842,11.866,87745,29459,58286,6.046,18.007,85076,29599,55477,6.074,17.460,2669,0.548,34.919,1886,1905,13406
1994,22,6014,14170,740969,750641,840,5.975,619,4.403,44132,16639,27493,2.217,5.879,63311,8160,55151,1.087,8.434,-19179,-2.555,11.758,266,281,1450
1994,23,519993,526176,4754656,4656587,83695,16.165,66846,12.911,1210711,335970,874741,7.215,26.000,1015316,308838,706478,6.632,21.804,195395,4.196,43.608,49397,49443,234319
1994,31-33,294059,340706,16061876,16021031,30019,8.824,28985,8.520,1746777,438652,1308125,2.738,10.903,1667082,508253,1158829,3.172,10.406,79695,0.497,20.811,21904,22109,238401
1994,42,299566,381385,5018281,4977937,40357,10.636,36496,9.618,778292,230391,547901,4.628,15.635,697329,244358,452971,4.909,14.008,80963,1.626,28.017,24994,25782,137409
1994,44-45,693163,1051125,13057870,12873818,105574,10.050,104359,9.934,2044232,840523,1203709,6.529,15.879,1678326,608435,1069891,4.726,13.037,365906,2.842,26.073,67687,71158,313693
1994,48-49,118300,149900,3309832,3261800,22837,15.470,18287,12.387,517661,164340,353321,5.038,15.870,422902,152004,270898,4.660,12.965,94759,2.905,25.931,12974,13264,77233
1994,51,54352,91601,2704397,2689740,12384,13.710,9837,10.890,426377,145177,281200,5.397,15.852,398658,149276,249382,5.550,14.821,27719,1.031,29.643,5127,5309,45538
1994,52,179252,343892,5359314,5300208,43561,12.851,33691,9.940,994642,429365,565277,8.101,18.766,869594,359454,510140,6.782,16.407,125048,2.359,32.814,14940,15595,94347
1994,53,201935,239751,1643328,1628577,32093,13.533,26874,11.332,344568,146509,198059,8.996,21.158,317556,127085,190471,7.803,19.499,27012,1.659,38.998,19304,19932,82936
1994,54,463649,502252,4971500,4907208,67689,13.709,50723,10.273,890119,307425,582694,6.265,18.139,760185,254539,505646,5.187,15.491,129934,2.648,30.982,36725,37128,153755
1994,55,28436,51403,3152945,3168244,4773,9.270,4947,9.608,474538,144592,329946,4.564,14.978,506228,149745,356483,4.726,15.978,-31690,-1.000,29.956,951,1004,12657
1994,56,230026,263651,5581295,5370760,43821,16.960,33279,12.880,1474990,462245,1012745,8.607,27.463,1053917,384138,669779,7.152,19.623,421073,7.840,39.246,25089,25462,246824
1994,61,45169,50596,2080549,2054823,6332,12.768,4325,8.721,198876,36665,162211,1.784,9.679,147690,32226,115464,1.568,7.187,51186,2.491,14.375,3137,3296,24112
1994,62,478234,568266,11991984,11854178,49007,8.698,39295,6.974,1343472,425127,918345,3.586,11.333,1067424,345191,722233,2.912,9.005,276048,2.329,18.009,29267,30165,215346
1994,71,68090,73553,1268439,1238032,10438,14.433,7974,11.026,252276,93573,158703,7.558,20.377,191305,62227,129078,5.026,15.452,60971,4.925,30.905,5918,6035,44906
1994,72,343407,452033,8537670,8405654,61490,13.717,53959,12.037,1655446,867239,788207,10.317,19.694,1389872,575016,814856,6.841,16.535,265574,3.159,33.070,39651,40975,382524
1994,81,589141,645038,4732145,4704061,61229,9.541,54709,8.525,751432,239089,512343,5.083,15.974,693070,215626,477444,4.584,14.733,58362,1.241,29.467,39112,39905,145619
1995,11,21905,22461,188240,188044,3367,15.179,2808,12.659,40920,14825,26095,7.884,21.761,40593,14466,26127,7.693,21.587,327,0.174,43.174,2083,2086,10686
1995,21,18625,23329,484427,485506,2314,9.823,2769,11.755,81666,24731,56935,5.094,16.821,84042,30184,53858,6.217,17.310,-2376,-0.489,33.642,1826,1844,13323
1995,22,6149,14552,721345,731842,983,6.846,598,4.164,41814,14097,27717,1.926,5.714,63200,6028,57172,0.824,8.636,-21386,-2.922,11.427,234,235,1248
1995,23,541616,547918,5079437,4915348,88371,16.456,66546,12.392,1265366,358417,906949,7.292,25.743,936950,298869,638081,6.080,19.062,328416,6.681,38.123,49996,50070,231511
1995,31-33,295560,342287,16450714,16234084,30178,8.850,27618,8.099,1869462,406999,1462463,2.507,11.516,1432217,440554,991663,2.714,8.822,437245,2.693,17.645,21261,21389,214097
1995,42,305393,388507,5230269,5123583,41635,10.814,34665,9.003,844816,254174,590642,4.961,16.489,632091,226126,405965,4.413,12.337,212725,4.152,24.674,24214,25023,134858
1995,44-45,695078,1055277,13546383,13302656,108255,10.280,103847,9.861,2145177,904823,1240354,6.802,16.126,1655678,664230,991448,4.993,12.446,489499,3.680,24.892,64885,68692,305048
1995,48-49,123618,156423,3492932,3399992,24491,15.982,18126,11.828,590568,180612,409956,5.312,17.370,406952,141423,265529,4.160,11.969,183616,5.400,23.938,13233,13466,78988
1995,51,57050,95310,2818778,2763254,13558,14.510,9814,10.503,481580,186414,295166,6.746,17.428,372251,119035,253216,4.308,13.471,109329,3.957,26.943,5313,5489,47418
1995,52,180760,351360,5299821,5326171,38525,11.083,30993,8.916,742423,287003,455420,5.389,13.939,791490,248027,543463,4.657,14.860,-49067,-0.921,27.878,14419,15654,92247
1995,53,204233,245182,1694140,1666723,32750,13.507,27332,11.272,355257,152384,202873,9.143,21.315,300073,117855,182218,7.071,18.004,55184,3.311,36.008,20056,20697,82147
1995,54,483045,523649,5183301,5076753,72428,14.119,51083,9.958,950195,330304,619891,6.506,18.717,738317,243899,494418,4.804,14.543,211878,4.173,29.086,37243,37681,151548
1995,55,28612,51852,3215254,3182490,4916,9.525,4437,8.597,525160,169780,355380,5.335,16.502,460457,129231,331226,4.061,14.468,64703,2.033,28.937,998,1034,14647
1995,56,241890,277907,6103840,5845225,47415,17.511,33154,12.244,1598248,579048,1019200,9.906,27.343,1076999,361415,715584,6.183,18.425,521249,8.918,36.851,25270,25769,236480
1995,61,47168,52851,2133078,2105131,6543,12.648,4307,8.325,198972,40901,158071,1.943,9.452,143095,28356,114739,1.347,6.797,55877,2.654,13.595,3219,3325,21559
1995,62,481266,578384,12309410,12138489,51516,8.986,41297,7.204,1474311,501753,972558,4.134,12.146,1133359,379080,754279,3.123,9.337,340952,2.809,18.674,31068,32056,250075
1995,71,70522,76293,1336446,1298794,10660,14.229,7908,10.556,265814,103877,161937,7.998,20.466,189921,59459,130462,4.578,14.623,75893,5.843,29.246,5902,5995,42644
1995,72,349944,463262,8832849,8677965,65242,14.256,54013,11.802,1764545,916021,848524,10.556,20.334,1458290,608333,849957,7.010,16.805,306255,3.529,33.609,39507,40887,389925
1995,81,598136,654893,4887219,4812184,63121,9.710,53429,8.219,782532,253258,529274,5.263,16.261,630097,200047,430050,4.157,13.094,152435,3.168,26.188,39348,40276,146826
1996,11,22042,22639,188724,188653,3177,14.085,3012,13.353,38345,13530,24815,7.172,20.326,38273,12403,25870,6.575,20.288,72,0.038,40.575,2261,2267,8913
1996,21,17906,22627,466823,472563,2168,9.474,2680,11.712,73285,18383,54902,3.890,15.508,84733,33789,50944,7.150,17.931,-11448,-2.423,31.016,1824,1854,16902
1996,22,6210,14981,692160,706612,1183,8.007,769,5.205,49801,24616,25185,3.484,7.048,78569,8865,69704,1.255,11.119,-28768,-4.071,14.096,262,270,1677
1996,23,552935,559311,5207411,5125843,81872,14.784,70853,12.794,1186144,336665,849479,6.568,23.140,1024113,307180,716933,5.993,19.979,162031,3.161,39.959,53078,53131,239768
1996,31-33,294560,341261,16158380,16245665,28493,8.348,28574,8.372,1581472,408236,1173236,2.513,9.735,1756075,505444,1250631,3.111,10.809,-174603,-1.075,19.469,21867,22106,247397
1996,42,308486,393241,5243306,5208867,43126,11.046,37480,9.600,812291,257020,555271,4.934,15.594,743107,266463,476644,5.116,14.266,69184,1.328,28.532,25710,26509,156884
1996,44-45,684292,1049648,13638709,13529122,107414,10.257,102666,9.803,2086290,880692,1205598,6.510,15.421,1877369,653425,1223944,4.830,13.877,208921,1.544,27.753,67000,70430,330547
1996,48-49,126746,160078,3601471,3546143,23831,15.065,20056,12.678,584307,188461,395846,5.315,16.477,473457,188227,285230,5.308,13.351,110850,3.126,26.703,14370,14661,86308
1996,51,59839,99299,2885902,2838745,15724,16.167,11650,11.978,528475,214235,314240,7.547,18.617,435650,152274,283376,5.364,15.347,92825,3.270,30.693,5881,6135,51064
1996,52,184288,359404,5413933,5345494,39181,11.036,30443,8.575,865432,331049,534383,6.193,16.190,727056,234364,492692,4.384,13.601,138376,2.589,27.203,13586,14677,74291
1996,53,204994,247318,1666632,1671572,30916,12.565,28376,11.533,326112,132909,193203,7.951,19.509,332928,125211,207717,7.491,19.917,-6816,-0.408,39.019,20266,21140,87382
1996,54,501280,544012,5452056,5342244,74705,13.998,54050,10.128,1008349,352899,655450,6.606,18.875,790060,263526,526534,4.933,14.789,218289,4.086,29.578,39828,40272,164510
1996,55,28294,51981,3219004,3209020,4818,9.306,4404,8.506,511865,149824,362041,4.669,15.951,491716,124143,367573,3.869,15.323,20149,0.628,30.646,1004,1056,15918
1996,56,243120,281473,6317119,6121559,47005,17.026,36226,13.121,1654474,581809,1072665,9.504,27.027,1266744,421237,845507,6.881,20.693,387730,6.334,41.386,27070,27447,258717
1996,61,48955,54816,2110975,2097917,6835,12.704,4811,8.942,186762,42762,144000,2.038,8.902,161292,40550,120742,1.933,7.688,25470,1.214,15.376,3649,3727,29935
1996,62,479863,583273,12391421,12292517,51893,8.947,45374,7.823,1473634,531448,942186,4.323,11.988,1272592,423009,849583,3.441,10.353,201042,1.635,20.705,33055,34210,258098
1996,71,72071,77996,1378365,1351050,10558,13.731,8355,10.866,263920,100489,163431,7.438,19.534,209215,62197,147018,4.604,15.485,54705,4.049,30.971,6260,6321,47596
1996,72,354631,472495,9016791,8912149,65210,13.946,55388,11.846,1722046,942674,779372,10.577,19.322,1512299,625933,886366,7.023,16.969,209747,2.353,33.938,40943,42185,405490
1996,81,605027,663277,4986424,4925409,63148,9.585,54186,8.225,777297,251846,525451,5.113,15.781,652887,204190,448697,4.146,13.255,124410,2.526,26.511,40008,40816,148789
1997,11,22070,22687,195669,193197,2970,13.079,3011,13.260,43580,15597,27983,8.073,22.557,38534,14591,23943,7.552,19.945,5046,2.612,39.891,2250,2261,10200
1997,21,17638,22288,478801,473297,2430,10.860,2605,11.642,100852,35236,65616,7.445,21.308,88896,38648,50248,8.166,18.782,11956,2.526,37.565,1594,1618,13323
1997,22,6149,14875,686368,694446,893,5.999,915,6.147,54292,18003,36289,2.592,7.818,69974,12696,57278,1.828,10.076,-15682,-2.258,15.636,311,315,2800
1997,23,569963,576016,5513180,5362407,84186,14.796,70082,12.317,1311952,349531,962421,6.518,24.466,1011217,337724,673493,6.298,18.858,300735,5.608,37.715,52649,52718,248199
1997,31-33,293200,338653,16321774,16263170,28021,8.252,29824,8.783,1779083,408652,1370431,2.513,10.939,1657426,578684,1078742,3.558,10.191,121657,0.748,20.383,22164,22389,252608
1997,42,312256,395051,5359971,5296908,41656,10.544,41666,10.547,927155,267684,659471,5.054,17.504,801992,316669,485323,5.978,15.141,125163,2.363,30.282,26527,27397,161267
1997,44-45,672455,1038360,13929794,13783199,109532,10.513,116650,11.196,2347378,901260,1446118,6.539,17.031,2057566,767274,1290292,5.567,14.928,289812,2.103,29.856,69081,74202,355945
1997,48-49,130199,164244,3744387,3689247,24930,15.315,22003,13.517,644495,221367,423128,6.000,17.470,535278,193790,341488,5.253,14.509,109217,2.960,29.018,15309,15586,97895
1997,51,61800,101971,3010431,2956928,15117,14.990,12870,12.762,598057,222930,375127,7.539,20.226,489438,183187,306251,6.195,16.552,108619,3.673,33.104,6753,6983,63506
1997,52,190956,369639,5628271,5557379,49281,13.492,40503,11.089,1125716,456851,668865,8.221,20.256,976807,439710,537097,7.912,17.577,148909,2.679,35.154,13899,14827,81665
1997,53,206686,253958,1737801,1704053,34292,13.626,29718,11.808,396750,163368,233382,9.587,23.283,330072,147864,182208,8.677,19.370,66678,3.913,38.740,20901,21619,96657
1997,54,518151,561597,5630279,5494531,80050,14.505,60619,10.984,1181231,401070,780161,7.299,21.498,909137,349964,559173,6.369,16.546,272094,4.952,33.092,43426,44035,204866
1997,55,27882,50512,3211444,3221755,5037,9.833,6459,12.610,603019,171083,431936,5.310,18.717,620099,230628,389471,7.158,19.247,-17080,-0.530,37.434,1295,1397,23488
1997,56,252462,294956,6996330,6733746,50273,17.345,40039,13.814,1989119,727709,1261410,10.807,29.540,1462244,522110,940134,7.754,21.715,526875,7.824,43.430,28901,29312,296748
1997,61,50212,56364,2198775,2158241,6774,12.197,5123,9.224,226430,43417,183013,2.012,10.491,144901,34174,110727,1.583,6.714,81529,3.778,13.428,3782,3833,24416
1997,62,481616,595704,12796134,12659762,60036,10.161,50281,8.510,1895540,684199,1211341,5.405,14.973,1621745,573799,1047946,4.532,12.810,273795,2.163,25.620,34505,35693,323739
1997,71,74845,80931,1510132,1480816,10436,12.998,9151,11.398,285907,101397,184510,6.847,19.307,228237,84446,143791,5.703,15.413,57670,3.894,30.826,6623,6681,58539
1997,72,357480,481276,9229316,9144265,69005,14.448,61648,12.908,1873609,996222,877387,10.895,20.489,1698053,696638,1001415,7.618,18.570,175556,1.920,37.139,44066,45593,438024
1997,81,599260,656228,4918114,4867805,62026,9.472,59197,9.040,799811,246011,553800,5.054,16.431,700122,250602,449520,5.148,14.383,99689,2.048,28.765,41793,42690,159388
1998,11,22153,22794,192291,194125,3117,13.702,3026,13.302,40740,15356,25384,7.910,20.986,44578,15114,29464,7.786,22.964,-3838,-1.977,41.973,2256,2256,9568
1998,21,17453,22157,488389,485137,2195,9.858,2414,10.841,92457,26706,65751,5.505,19.058,86179,30057,56122,6.196,17.764,6278,1.294,35.528,1504,1559,13919
1998,22,6178,15421,685626,686524,1395,9.210,847,5.592,67201,31707,35494,4.618,9.789,69264,10402,58862,1.515,10.089,-2063,-0.300,19.577,279,286,2041
1998,23,579083,585784,5771821,5662010,80339,13.828,70766,12.180,1291778,358736,933042,6.336,22.815,1070883,319930,750953,5.650,18.913,220895,3.901,37.827,51917,51958,232322
1998,31-33,295055,341530,16684358,16564958,27588,8.091,26449,7.757,1789982,436102,1353880,2.633,10.806,1549991,447482,1102509,2.701,9.357,239991,1.449,18.714,19450,19663,212549
1998,42,313278,397242,5564750,5496295,39699,9.999,39280,9.893,917428,278274,639154,5.063,16.692,776468,285383,491085,5.192,14.127,140960,2.565,28.254,26026,26938,151526
1998,44-45,675880,1043790,14332878,14175124,98513,9.439,98287,9.417,2168099,813295,1354804,5.737,15.295,1846168,627562,1218606,4.427,13.024,321931,2.271,26.048,60000,63529,297452
1998,48-49,133869,169761,3903675,3834537,25276,15.112,20277,12.123,641397,232867,408530,6.073,16.727,504990,166101,338889,4.332,13.170,136407,3.557,26.339,14301,14646,83720
1998,51,63077,107753,3190910,3107576,17782,16.943,12183,11.608,665319,261983,403336,8.430,21.410,494549,196157,298392,6.312,15.914,170770,5.495,31.829,6435,6718,57518
1998,52,197067,383400,5833183,5761229,47808,12.673,35506,9.412,1076185,383033,693152,6.648,18.680,941102,317635,623467,5.513,16.335,135083,2.345,32.670,13280,14037,74866
1998,53,209372,257877,1817166,1791092,31728,12.375,28755,11.215,389567,151043,238524,8.433,21.750,336391,141810,194581,7.918,18.781,53176,2.969,37.563,18862,20117,88946
1998,54,542596,589022,6206808,5957042,84510,14.659,59462,10.314,1352106,497474,854632,8.351,22.698,848700,291113,557587,4.887,14.247,503406,8.451,28.494,41214,41611,166943
1998,55,28093,51041,3294237,3259961,5406,10.604,5287,10.370,616732,172761,443971,5.299,18.918,548318,173533,374785,5.323,16.820,68414,2.099,33.640,1115,1186,16463
1998,56,257853,304940,7707202,7401237,47533,15.834,38050,12.675,2022309,683400,1338909,9.234,27.324,1405313,502050,903263,6.783,18.988,616996,8.336,37.975,27463,27958,247967
1998,61,51763,57988,2334976,2291154,6540,11.425,5045,8.814,244245,49988,194257,2.182,10.660,156061,35858,120203,1.565,6.811,88184,3.849,13.623,3582,3625,21727
1998,62,486943,605417,13605170,13446878,53095,8.817,46583,7.736,1719393,554517,1164876,4.124,12.787,1401676,446104,955572,3.318,10.424,317717,2.363,20.848,31607,32680,247483
1998,71,76551,82807,1569600,1541860,10408,12.690,8835,10.772,285777,98177,187600,6.367,18.535,229108,77231,151877,5.009,14.859,56669,3.675,29.718,6106,6208,49402
1998,72,360687,484081,9453947,9370251,58065,12.015,56472,11.685,1783606,822200,961406,8.775,19.035,1610631,655804,954827,6.999,17.189,172975,1.846,34.378,37753,38871,360229
1998,81,605440,664384,5040935,4996690,61301,9.272,54842,8.295,788062,252912,535150,5.062,15.772,696054,215531,480523,4.313,13.930,92008,1.841,27.861,38422,39365,140348
1999,11,22029,22652,190346,189271,2903,12.826,2865,12.659,39285,11969,27316,6.324,20.756,37204,13157,24047,6.951,19.657,2081,1.099,39.313,2112,2114,9283
1999,21,16501,21268,445218,467041,1871,8.617,2761,12.716,59581,20416,39165,4.371,12.757,102699,32559,70140,6.971,21.989,-43118,-9.232,25.514,1716,1756,14346
1999,22,6162,15934,660435,667346,1546,9.859,1039,6.626,66018,29167,36851,4.371,9.893,79201,19721,59480,2.955,11.868,-13183,-1.975,19.785,281,303,2284
1999,23,592086,599007,6163367,5961889,81496,13.765,67547,11.409,1416270,359612,1056658,6.032,23.755,1012870,328979,683891,5.518,16.989,403400,6.766,33.978,49738,49791,241655
1999,31-33,290670,337642,16405802,16551700,24344,7.169,28184,8.300,1559425,366170,1193255,2.212,9.422,1847461,539262,1308199,3.258,11.162,-288036,-1.740,18.843,20593,20803,243579
1999,42,310063,395498,5637113,5606298,36136,9.109,38536,9.714,842273,249967,592306,4.459,15.024,780022,292817,487205,5.223,13.913,62251,1.110,27.827,26127,27292,161528
1999,44-45,669354,1041385,14623710,14479331,96189,9.226,98496,9.448,2176177,851026,1325151,5.878,15.030,1883244,630395,1252849,4.354,13.006,292933,2.023,26.013,60917,64687,317772
1999,48-49,137182,173469,4047757,3964917,25037,14.599,21092,12.299,675179,243405,431774,6.139,17.029,508049,193573,314476,4.882,12.814,167130,4.215,25.627,14765,15125,92774
1999,51,64095,111391,3261157,3222770,18355,16.738,14896,13.584,673378,282086,391292,8.753,20.894,602523,256746,345777,7.967,18.696,70855,2.199,37.392,6863,7182,67733
1999,52,200796,389881,5923965,5896768,50372,13.022,44275,11.446,1109796,431014,678782,7.309,18.820,1068901,497989,570912,8.445,18.127,40895,0.694,36.254,14831,16374,103110
1999,53,211693,265474,1882446,1856358,35304,13.462,28845,10.999,392205,178285,213920,9.604,21.128,340124,144393,195731,7.778,18.322,52081,2.806,36.644,19764,20810,89643
1999,54,559970,610845,6579921,6410545,84385,14.054,63604,10.593,1340547,462522,878025,7.215,20.912,1000306,359194,641112,5.603,15.604,340241,5.308,31.208,44429,44991,195161
1999,55,28058,51653,3261450,3285743,6645,12.943,6017,11.720,564429,202058,362371,6.150,17.178,610265,214781,395484,6.537,18.573,-45836,-1.395,34.356,1264,1335,25114
1999,56,258486,307826,8210225,7970003,43569,14.232,40203,13.132,2117656,664555,1453101,8.338,26.570,1627558,544276,1083282,6.829,20.421,490098,6.149,40.842,28487,28960,295311
1999,61,52943,59473,2426544,2382495,6647,11.337,4960,8.460,241654,54849,186805,2.302,10.143,154923,33156,121767,1.392,6.503,86731,3.640,13.005,3568,3641,20780
1999,62,486390,608229,13715497,13678868,52924,8.722,49979,8.237,1642018,529647,1112371,3.872,12.004,1570771,587445,983326,4.295,11.483,71247,0.521,22.966,33012,34491,290105
1999,71,77725,84293,1617131,1590111,10112,12.094,8756,10.472,275543,82690,192853,5.200,17.329,219259,68881,150378,4.332,13.789,56284,3.540,27.578,6235,6307,47618
1999,72,360679,484420,9611777,9538205,56451,11.657,56169,11.598,1714170,847868,866302,8.889,17.972,1571655,647176,924479,6.785,16.477,142515,1.494,32.955,36931,38879,369293
1999,81,606324,665507,5134316,5092184,56994,8.575,55315,8.322,759281,232175,527106,4.559,14.911,675975,228256,447719,4.482,13.275,83306,1.636,26.550,38301,39161,144025
2000,11,21408,22002,189989,188206,2624,11.853,2894,13.073,38907,12664,26243,6.729,20.673,35563,12716,22847,6.756,18.896,3344,1.777,37.792,2103,2104,8804
2000,21,16300,21275,450036,450773,2124,9.973,2167,10.175,80904,25130,55774,5.575,17.948,83131,24568,58563,5.450,18.442,-2227,-0.494,35.896,1365,1396,9347
2000,22,6390,16548,653715,656795,1575,9.703,944,5.815,70541,31533,39008,4.801,10.740,77460,13813,63647,2.103,11.794,-6919,-1.053,21.480,312,328,2144
2000,23,600130,608019,6582283,6374308,78309,12.978,69107,11.453,1495306,373157,1122149,5.854,23.458,1078643,332293,746350,5.213,16.922,416663,6.537,33.843,50444,50513,243394
2000,31-33,286037,333457,16363609,16382995,23764,7.088,27397,8.172,1685845,384744,1301101,2.348,10.290,1721763,501551,1220212,3.061,10.509,-35918,-0.219,20.580,20082,20303,217445
2000,42,308818,396187,5828021,5753417,37627,9.496,37759,9.529,937979,296539,641440,5.154,16.303,790160,297087,493073,5.164,13.734,147819,2.569,27.468,25025,26120,152367
2000,44-45,666186,1040804,14926934,14784539,96318,9.249,97536,9.366,2212453,830278,1382175,5.616,14.965,1925374,785823,1139551,5.315,13.023,287079,1.942,26.046,58853,62656,321805
2000,48-49,138151,175901,4223937,4127932,24693,14.124,22562,12.905,726633,225051,501582,5.452,17.603,537176,208454,328722,5.050,13.013,189457,4.590,26.026,15695,16119,88323
2000,51,66528,118674,3575418,3475548,20588,17.869,13678,11.871,761215,334938,426277,9.637,21.902,559242,173532,385710,4.993,16.091,201973,5.811,32.182,7172,7849,74181
2000,52,202302,398661,6014530,5968097,50986,12.930,42287,10.724,1093973,439605,654368,7.366,18.330,1005626,354429,651197,5.939,16.850,88347,1.480,33.700,15867,17091,94172
2000,53,212001,268158,1945115,1917602,31139,11.662,28853,10.806,376666,148885,227781,7.764,19.643,319622,133654,185968,6.970,16.668,57044,2.975,33.336,19408,20379,78295
2000,54,571520,625857,6996984,6784037,82400,13.325,67477,10.912,1453976,498065,955911,7.342,21.432,1025333,370304,655029,5.458,15.114,428643,6.318,30.228,47138,47712,205818
2000,55,28262,53041,3341031,3308102,6447,12.312,5089,9.719,624073,211257,412816,6.386,18.865,564064,152131,411933,4.599,17.051,60009,1.814,34.102,1237,1396,20698
2000,56,258226,309879,9033281,8664924,42425,13.727,40808,13.203,2316461,653226,1663235,7.539,26.734,1586283,587850,998433,6.784,18.307,730178,8.427,36.614,28055,28524,266391
2000,61,54408,61432,2544704,2491511,6769,11.171,5098,8.413,263452,58957,204495,2.366,10.574,156838,30493,126345,1.224,6.295,106614,4.279,12.590,3611,3684,20692
2000,62,489788,614327,14008111,13878037,54075,8.842,48622,7.950,1696238,538309,1157929,3.879,12.222,1436071,537931,898140,3.876,10.348,260167,1.875,20.696,30236,31721,251885
2000,71,78719,85345,1730506,1673280,9890,11.641,9114,10.728,319815,89124,230691,5.326,19.113,204828,68430,136398,4.090,12.241,114987,6.872,24.482,6286,6509,47386
2000,72,359492,485590,9891749,9759366,53668,11.067,52363,10.798,1719150,780867,938283,8.001,17.615,1453112,560062,893050,5.739,14.889,266038,2.726,29.779,36022,37876,343281
2000,81,606024,665802,5281024,5215132,55372,8.318,55185,8.290,789382,232454,556928,4.457,15.136,658066,220853,437213,4.235,12.618,131316,2.518,25.237,37382,38411,138396
2001,11,21844,22461,182668,187125,2649,11.735,2873,12.728,33555,10495,23060,5.609,17.932,42185,16225,25960,8.671,22.544,-8630,-4.612,35.864,2005,2006,10040
2001,21,16714,21809,481026,466781,2354,10.880,2008,9.281,89936,25448,64488,5.452,19.267,61435,21149,40286,4.531,13.161,28501,6.106,26.323,1222,1257,10061
2001,22,6524,16741,652941,655476,1493,8.942,1404,8.409,82081,35799,46282,5.462,12.522,87716,23498,64218,3.585,13.382,-5635,-0.860,25.045,299,341,3259
2001,23,597522,605670,6507822,6480367,75216,12.459,71247,11.802,1300121,344820,955301,5.321,20.062,1244801,382332,862469,5.900,19.209,55320,0.854,38.418,50275,50323,254633
2001,31-33,285197,332430,15836892,16129687,23968,7.164,28190,8.426,1470075,387685,1082390,2.404,9.114,2050937,625284,1425653,3.877,12.715,-580862,-3.601,18.228,20099,20376,255217
2001,42,305792,395002,5894191,5887534,38818,9.804,40691,10.277,944191,336900,607291,5.722,16.037,927795,366240,561555,6.221,15.759,16396,0.278,31.517,25198,26770,173149
2001,44-45,661952,1038031,14897399,14934862,93363,8.966,99807,9.585,2033976,790776,1243200,5.295,13.619,2119033,747855,1371178,5.007,14.189,-85057,-0.570,27.238,60969,66215,342205
2001,48-49,139171,177752,4206857,4223122,24864,14.019,24088,13.581,618782,218810,399972,5.181,14.652,650946,227911,423035,5.397,15.414,-32164,-0.762,29.304,16040,16827,105548
2001,51,66016,124805,3758815,3681955,23709,19.482,17489,14.371,803595,373698,429897,10.149,21.825,653970,301983,351987,8.202,17.761,149625,4.064,35.523,8048,8702,100632
2001,52,206570,398680,6184370,6113693,52185,13.064,53726,13.450,1274303,546196,728107,8.934,20.843,1114349,515296,599053,8.429,18.227,159954,2.616,36.454,16377,17762,101890
2001,53,213198,271738,1977619,1968047,33329,12.325,30707,11.355,374794,160750,214044,8.168,19.044,355893,152038,203855,7.725,18.084,18901,0.960,36.167,19076,19977,80981
2001,54,584283,640883,7269332,7124130,86333,13.609,73294,11.554,1499602,520854,978748,7.311,21.050,1208122,455271,752851,6.391,16.958,291480,4.091,33.916,49946,50499,235454
2001,55,28145,52364,3278895,3313695,5619,10.661,6308,11.968,582317,191308,391009,5.773,17.573,651561,243105,408456,7.336,19.663,-69244,-2.090,35.146,1308,1378,26704
2001,56,263390,317224,8929952,9040184,43986,13.956,39898,12.659,2044602,673050,1371552,7.445,22.617,2274052,747157,1526895,8.265,25.155,-229450,-2.538,45.234,26664,27187,285599
2001,61,54336,61440,2466858,2430585,6935,11.435,5344,8.812,241123,51535,189588,2.120,9.920,167524,41154,126370,1.693,6.892,73599,3.028,13.785,3663,3722,25751
2001,62,494373,623611,14271479,14119753,58064,9.397,46597,7.541,1708904,547704,1161200,3.879,12.103,1405181,527143,878038,3.733,9.952,303723,2.151,19.904,28641,30062,256848
2001,71,78699,85511,1743484,1729416,10055,11.814,9249,10.867,266758,87305,179453,5.048,15.425,239373,79984,159389,4.625,13.841,27385,1.583,27.683,6422,6496,49647
2001,72,362289,490935,9974661,9945988,57208,11.697,53498,10.938,1647720,790140,857580,7.944,16.567,1594124,625284,968840,6.287,16.028,53596,0.539,32.056,35593,37435,364377
2001,81,594906,655454,5246861,5215732,54132,8.253,55033,8.390,738493,220929,517564,4.236,14.159,676122,223874,452248,4.292,12.963,62371,1.196,25.926,37732,38463,141700
2002,11,21375,22056,181060,184538,2545,11.349,3282,14.636,34656,13396,21260,7.259,18.780,41692,14930,26762,8.090,22.593,-7036,-3.813,37.560,2233,2234,10378
2002,21,16629,22051,474622,483189,2574,11.718,2405,10.948,83085,33556,49529,6.945,17.195,101627,34496,67131,7.139,21.033,-18542,-3.837,34.390,1264,1278,10954
2002,22,6490,17390,667593,668022,1291,7.509,898,5.223,75104,36841,38263,5.515,11.243,76600,18548,58052,2.777,11.467,-1496,-0.224,22.485,338,338,2819
2002,23,590231,599241,6382470,6464319,80254,13.400,79625,13.295,1294550,412634,881916,6.383,20.026,1460066,417005,1043061,6.451,22.587,-165516,-2.560,40.052,51967,52086,273884
2002,31-33,283439,330600,14569973,15323465,24431,7.298,32797,9.796,1307855,456992,850863,2.982,8.535,2816326,769644,2046682,5.023,18.379,-1508471,-9.844,17.070,22526,22916,363186
2002,42,306615,399022,5805894,5948806,38663,9.595,46485,11.537,921031,333728,587303,5.610,15.483,1204966,448906,756060,7.546,20.256,-283935,-4.773,30.965,26408,27543,218447
2002,44-45,645941,1022530,14589664,14640451,108869,10.635,111115,10.855,2256526,998625,1257901,6.821,15.413,2368316,812046,1556270,5.547,16.177,-111790,-0.764,30.826,64158,70210,440935
2002,48-49,138646,177290,4037387,4111761,24188,13.581,25812,14.493,593177,231799,361378,5.637,14.426,739996,228266,511730,5.552,17.997,-146819,-3.571,28.853,16607,17059,114463
2002,51,63634,125150,3721837,3830948,21821,17.392,22449,17.893,782553,440176,342377,11.490,20.427,998244,348071,650173,9.086,26.057,-215691,-5.630,40.854,8430,8663,113091
2002,52,209562,414687,6438745,6358392,54433,13.365,39604,9.724,1268463,531775,736688,8.363,19.949,1101871,402160,699711,6.325,17.329,166592,2.620,34.659,16164,16953,110215
2002,53,219761,282352,1978733,1984174,36251,12.981,30051,10.761,381739,173326,208413,8.735,19.239,393447,147335,246112,7.426,19.829,-11708,-0.590,38.478,18514,19093,82601
2002,54,590513,653369,7055899,7181885,91083,14.010,84570,13.009,1423925,615571,808354,8.571,19.827,1679700,689148,990552,9.596,23.388,-255775,-3.561,39.653,54360,54886,304379
2002,55,26619,47232,2831498,2903231,5426,11.279,7175,14.915,520091,186734,333357,6.432,17.914,662845,223995,438850,7.715,22.831,-142754,-4.917,35.828,1498,1589,31479
2002,56,251442,303565,8382408,8658015,44233,14.444,49565,16.185,2055185,721815,1333370,8.337,23.737,2616215,878078,1738137,10.142,30.217,-561030,-6.480,47.475,29461,30006,405512
2002,61,58507,66009,2717842,2673629,7855,12.105,5620,8.661,317254,81195,236059,3.037,11.866,228617,56962,171655,2.131,8.551,88637,3.315,17.102,3569,3646,37332
2002,62,512145,651339,14848455,14643812,71594,11.173,50493,7.880,2169145,796953,1372192,5.442,14.813,1765849,634853,1130996,4.335,12.059,403296,2.754,24.117,28891,29822,318932
2002,71,80583,87832,1777514,1765480,11744,13.425,11032,12.611,316284,112838,203446,6.391,17.915,292893,95311,197582,5.399,16.590,23391,1.325,33.180,6912,7024,62728
2002,72,367787,501018,10074579,10066444,68706,13.851,58716,11.837,1897329,999220,898109,9.926,18.848,1870679,677996,1192683,6.735,18.583,26650,0.265,37.167,36647,37963,373000
2002,81,607636,669760,5270301,5261653,63264,9.503,55198,8.291,832769,288946,543823,5.492,15.827,815515,247298,568217,4.700,15.499,17254,0.328,30.998,35713,36231,147544
2003,11,20721,21435,182401,180837,2574,11.937,2831,13.129,38141,11397,26744,6.302,21.091,34802,12329,22473,6.818,19.245,3339,1.846,38.490,1986,1986,7861
2003,21,16239,21468,455104,463857,1911,8.816,2329,10.744,72181,20283,51898,4.373,15.561,88773,31242,57531,6.735,19.138,-16592,-3.577,31.122,1254,1287,10395
2003,22,6457,17594,663088,663138,1482,8.504,1148,6.587,77394,27118,50276,4.089,11.671,76996,22841,54155,3.444,11.611,398,0.060,23.222,250,261,2079
2003,23,599452,608880,6364434,6370241,86811,14.360,78082,12.916,1315278,391846,923432,6.151,20.647,1326037,367932,958105,5.776,20.816,-10759,-0.169,41.294,53429,53481,249364
2003,31-33,276758,322652,14083544,14319549,22393,6.867,29280,8.979,1371754,347017,1024737,2.423,9.580,1847653,586933,1260720,4.099,12.903,-475899,-3.323,19.159,20896,21154,227254
2003,42,305123,394636,5825798,5802598,36963,9.330,40006,10.099,897524,292472,605052,5.040,15.468,851107,304689,546418,5.251,14.668,46417,0.800,29.335,24703,25494,138907
2003,44-45,652776,1030171,14910616,14774406,103651,10.092,97493,9.492,2116815,792257,1324558,5.362,14.328,1843202,646030,1197172,4.373,12.476,273613,1.852,24.951,59648,63004,314820
2003,48-49,138892,179167,3979210,4014977,25995,14.582,24193,13.571,736801,370618,366183,9.231,18.351,806162,232499,573663,5.791,20.079,-69361,-1.728,36.703,16137,16403,92788
2003,51,63557,125396,3604540,3652910,17578,14.050,17007,13.594,565805,227256,338549,6.221,15.489,666405,305092,361313,8.352,18.243,-100600,-2.754,30.978,7259,7478,65308
2003,52,214763,426346,6374172,6395960,54529,12.977,42232,10.051,1085834,415404,670430,6.495,16.977,1139744,421958,717786,6.597,17.820,-53910,-0.843,33.954,15737,16497,75663
2003,53,226618,289872,2061308,2022175,37040,12.954,29166,10.200,403159,155595,247564,7.694,19.937,325563,128163,197400,6.338,16.100,77596,3.837,32.199,18588,19134,71956
2003,54,597829,661475,7150563,7119848,86906,13.215,79178,12.040,1318291,459082,859209,6.448,18.516,1262708,455824,806884,6.402,17.735,55583,0.781,35.470,53425,53948,234077
2003,55,26472,46604,2803468,2829231,4781,10.180,5504,11.719,487717,142779,344938,5.047,17.239,535216,185092,350124,6.542,18.917,-47499,-1.679,34.477,1152,1221,17340
2003,56,254108,303033,8260098,8312910,43384,14.306,43824,14.451,1874880,522805,1352075,6.289,22.554,1969887,695333,1274554,8.364,23.697,-95007,-1.143,45.108,26596,27044,317017
2003,61,60483,67825,2782168,2745681,7902,11.825,5906,8.838,297258,53519,243739,1.949,10.826,225521,48063,177458,1.750,8.214,71737,2.613,16.427,3995,4099,28523
2003,62,525136,664828,15337990,15093402,60441,9.187,46583,7.081,1941542,555507,1386035,3.680,12.864,1451454,478999,972455,3.174,9.616,490088,3.247,19.233,29086,30547,230522
2003,71,83239,90602,1834916,1808039,12670,14.190,10048,11.253,331946,102260,229686,5.656,18.359,277790,82026,195764,4.537,15.364,54156,2.995,30.728,6884,6941,54137
2003,72,376793,511759,10432855,10252070,66264,13.082,55803,11.017,1926682,888669,1038013,8.668,18.793,1566843,617274,949569,6.021,15.283,359839,3.510,30.566,38388,39397,351570
2003,81,614105,675956,5364362,5316180,61265,9.109,54522,8.106,818027,238664,579363,4.489,15.387,721742,219884,501858,4.136,13.576,96285,1.811,27.153,38125,38919,141691
2004,11,20541,21182,182313,181435,2685,12.680,2672,12.618,33551,10839,22712,5.974,18.492,31905,12281,19624,6.769,17.585,1646,0.907,35.170,1894,1895,7792
2004,21,16570,21712,467403,461050,2154,9.963,1970,9.112,74441,23626,50815,5.124,16.146,61438,22915,38523,4.970,13.326,13003,2.820,26.651,1089,1120,9578
2004,22,6329,17263,630180,646499,1239,7.149,1375,7.934,55450,20662,34788,3.196,8.577,87739,23976,63763,3.709,13.571,-32289,-4.994,17.154,286,289,1431
2004,23,621701,631149,6630783,6492914,98242,15.851,75508,12.183,1463512,395845,1067667,6.097,22.540,1189490,377142,812348,5.809,18.320,274022,4.220,36.640,52669,52749,264364
2004,31-33,274059,319285,13760641,13909591,22705,7.066,26795,8.339,1329373,344496,984877,2.477,9.557,1626521,512249,1114272,3.683,11.694,-297148,-2.136,19.114,19383,19595,209436
2004,42,303924,395678,5913237,5876434,36444,9.231,34720,8.794,862107,290017,572090,4.935,14.671,790382,298211,492171,5.075,13.450,71725,1.221,26.900,22857,23580,131628
2004,44-45,658120,1035433,15401274,15158081,101429,9.822,95980,9.294,2241649,751937,1489712,4.961,14.788,1758655,635701,1122954,4.194,11.602,482994,3.186,23.204,61886,65970,325461
2004,48-49,140808,182435,4124345,4069010,25724,14.211,22892,12.646,663102,252169,410933,6.197,16.296,555964,207786,348178,5.107,13.663,107138,2.633,27.327,15604,15870,87140
2004,51,63495,126361,3472430,3542352,18696,14.867,17481,13.901,565997,196739,369258,5.554,15.978,700742,253664,447078,7.161,19.782,-134745,-3.804,31.956,6666,6982,52876
2004,52,221878,433648,6413502,6404345,53131,12.349,46339,10.770,1108040,439598,668442,6.864,17.301,1094893,441195,653698,6.889,17.096,13147,0.205,34.192,15588,16170,82214
2004,53,234445,300336,2102761,2078340,40082,13.603,28700,9.741,377329,163234,214095,7.854,18.155,326326,131921,194405,6.347,15.701,51003,2.454,31.403,18784,19676,80322
2004,54,611334,678747,7246248,7193786,90487,13.495,73994,11.036,1261231,456104,805127,6.340,17.532,1160305,443372,716933,6.163,16.129,100926,1.403,32.259,50549,51122,238914
2004,55,26130,46664,2776612,2809314,4195,8.989,4206,9.012,426541,145898,280643,5.193,15.183,489311,161932,327379,5.764,17.417,-62770,-2.234,30.366,1146,1201,20610
2004,56,262261,311663,8433070,8381828,46267,15.009,39446,12.797,1859432,550744,1308688,6.571,22.184,1774620,640958,1133662,7.647,21.172,84812,1.012,42.344,25454,26013,296749
2004,61,62778,70288,2878497,2824143,8027,11.610,5731,8.289,291309,61796,229513,2.188,10.315,182132,46708,135424,1.654,6.449,109177,3.866,12.898,4087,4144,35215
2004,62,537142,680314,15682117,15504314,59884,8.904,44413,6.603,1689051,509734,1179317,3.288,10.894,1334959,414382,920577,2.673,8.610,354092,2.284,17.220,30270,31258,230253
2004,71,86785,94348,1885544,1861895,13511,14.593,9980,10.780,295928,99624,196304,5.351,15.894,249813,77863,171950,4.182,13.417,46115,2.477,26.834,6997,7035,50065
2004,72,387168,522008,10734503,10586918,66462,12.852,56722,10.968,1870482,887168,983314,8.380,17.668,1583711,611363,972348,5.775,14.959,286771,2.709,29.918,40547,41670,381986
2004,81,616198,679050,5418054,5391721,58620,8.662,53963,7.974,774385,247956,526429,4.599,14.362,720910,234235,486675,4.344,13.371,53475,0.992,26.741,39634,40167,146562
2005,11,19153,19798,167163,168427,2547,12.881,2499,12.638,29509,10006,19503,5.941,17.520,32060,10168,21892,6.037,19.035,-2551,-1.515,35.041,1777,1780,7156
2005,21,16876,22065,493342,479768,2260,10.354,1783,8.169,87807,25291,62516,5.272,18.302,60378,19252,41126,4.013,12.585,27429,5.717,25.170,1052,1084,7888
2005,22,6149,16733,632875,630265,1035,6.130,1335,7.907,62011,19691,42320,3.124,9.839,57465,22225,35240,3.526,9.118,4546,0.721,18.235,224,237,1026
2005,23,645742,656055,6788131,6715744,101620,15.750,79908,12.385,1459007,449460,1009547,6.693,21.725,1313885,384432,929453,5.724,19.564,145122,2.161,39.129,55803,55852,263501
2005,31-33,269463,314140,13676303,13693759,21806,6.897,25886,8.187,1395976,311059,1084917,2.272,10.194,1428902,449386,979516,3.282,10.435,-32926,-0.240,20.389,18834,19017,198560
2005,42,304689,398225,5976102,5966050,35536,8.934,34633,8.707,804257,252528,551729,4.233,13.481,783730,252599,531131,4.234,13.136,20527,0.344,26.273,23579,24321,128170
2005,44-45,654170,1035251,15315469,15335919,101204,9.795,97162,9.404,1957326,767003,1190323,5.001,12.763,2001059,598419,1402640,3.902,13.048,-43733,-0.285,25.526,64222,67232,321581
2005,48-49,143944,186062,4166258,4156868,25880,14.026,22792,12.352,580265,211256,369009,5.082,13.959,558672,169796,388876,4.085,13.440,21593,0.519,26.879,15355,15644,81098
2005,51,63266,127262,3406388,3437745,15927,12.568,14847,11.716,477291,185010,292281,5.382,13.884,540188,186686,353502,5.430,15.713,-62897,-1.830,27.768,6484,6893,57565
2005,52,226966,440990,6371725,6398506,57836,13.232,50043,11.449,1032125,467647,564478,7.309,16.131,1081233,486193,595040,7.599,16.898,-49108,-0.767,32.261,16939,17670,90121
2005,53,243525,314174,2138446,2119338,46841,15.266,32154,10.479,402535,199897,202638,9.432,18.993,364105,128143,235962,6.046,17.180,38430,1.813,34.360,21048,22066,77033
2005,54,627541,695694,7383262,7315756,90777,13.197,75102,10.918,1279561,443164,836397,6.058,17.490,1139553,397832,741721,5.438,15.577,140008,1.914,31.153,50619,51223,213133
2005,55,25901,47717,2836320,2839140,4662,9.871,3685,7.802,421067,140498,280569,4.949,14.831,427533,119272,308261,4.201,15.059,-6466,-0.228,29.662,1061,1102,16602
2005,56,267722,317852,8969949,8718447,45867,14.562,40129,12.740,2068068,639686,1428382,7.337,23.721,1563267,553601,1009666,6.350,17.931,504801,5.790,35.861,26058,26450,309954
2005,61,63651,71797,2880425,2850363,8752,12.403,6288,8.911,295619,96880,198739,3.399,10.371,235610,45370,190240,1.592,8.266,60009,2.105,16.532,4411,4457,26564
2005,62,548373,696897,15911250,15805506,62014,8.999,46518,6.750,1664066,545493,1118573,3.451,10.528,1455804,430770,1025034,2.725,9.211,208262,1.318,18.421,31690,32566,228286
2005,71,89217,96934,1937420,1915521,13463,14.074,10915,11.410,307216,112229,194987,5.859,16.038,264068,76329,187739,3.985,13.786,43148,2.253,27.571,7722,7773,52002
2005,72,397879,537395,11031862,10895182,71508,13.472,58334,10.990,1968361,1024053,944308,9.399,18.066,1701859,628314,1073545,5.767,15.620,266502,2.446,31.241,44142,45291,426207
2005,81,618837,681912,5353941,5385669,60057,8.828,56910,8.365,717152,239739,477413,4.451,13.316,781055,221260,559795,4.108,14.502,-63903,-1.187,26.632,40555,41229,149373
2006,11,18979,19639,164201,165115,2629,13.404,2578,13.144,30603,10897,19706,6.600,18.534,32324,12477,19847,7.557,19.577,-1721,-1.042,37.069,1898,1898,7855
2006,21,17801,23275,550843,522538,2982,13.130,1855,8.168,115480,41650,73830,7.971,22.100,58159,23920,34239,4.578,11.130,57321,10.970,22.260,1117,1142,8358
2006,22,6039,16675,618629,626020,1125,6.750,1106,6.636,52121,18924,33197,3.023,8.326,66565,14255,52310,2.277,10.633,-14444,-2.307,16.652,258,263,2700
2006,23,675898,687247,7361231,7072098,112069,16.691,80476,11.985,1725110,503696,1221414,7.122,24.393,1150148,351580,798568,4.971,16.263,574962,8.130,32.526,59597,59734,251130
2006,31-33,268807,313902,13638697,13635804,23769,7.559,24867,7.908,1375532,333944,1041588,2.449,10.088,1368807,421343,947464,3.090,10.038,6725,0.049,20.077,18481,18643,182063
2006,42,305345,402445,6044465,6012243,39167,9.778,35394,8.836,848335,282396,565939,4.697,14.110,784396,269371,515025,4.480,13.047,63939,1.063,26.093,23771,24498,134507
2006,44-45,648785,1040070,15742716,15536627,106147,10.241,98905,9.543,2220633,928980,1291653,5.979,14.293,1816355,574124,1242231,3.695,11.691,404278,2.602,23.382,67843,70919,315415
2006,48-49,147857,191511,4330680,4260327,29042,15.370,23920,12.659,669891,252659,417232,5.931,15.724,531897,186189,345708,4.370,12.485,137994,3.239,24.970,16458,16784,87209
2006,51,63404,130238,3438981,3429961,18485,14.366,15351,11.930,533367,209765,323602,6.116,15.550,520094,166627,353467,4.858,15.163,13273,0.387,30.327,6426,6743,52541
2006,52,231955,460388,6578513,6471623,64039,14.221,43890,9.747,1181016,531102,649914,8.207,18.249,966494,388438,578056,6.002,14.934,214522,3.315,29.869,18456,18939,77237
2006,53,251749,328252,2200067,2166473,51539,16.055,37068,11.547,420653,191784,228869,8.852,19.416,352962,143773,209189,6.636,16.292,67691,3.124,32.584,25422,25903,86247
2006,54,647549,722275,7785599,7587237,104216,14.696,78000,10.999,1479325,512963,966362,6.761,19.498,1083644,394825,688819,5.204,14.282,395681,5.215,28.565,53725,54203,216240
2006,55,26249,49228,2917518,2917628,5477,11.258,4318,8.876,483322,149498,333824,5.124,16.566,486133,125251,360882,4.293,16.662,-2811,-0.096,33.131,1091,1125,13906
2006,56,276471,332173,9675627,9338446,53260,16.368,39685,12.196,2261548,707391,1554157,7.575,24.218,1592335,523614,1068721,5.607,17.051,669213,7.166,34.103,27219,27546,274551
2006,61,65727,74946,2980168,2931672,9687,13.184,6741,9.175,312346,84003,228343,2.865,10.654,215097,43329,171768,1.478,7.337,97249,3.317,14.674,4969,5050,31910
2006,62,557523,717544,16425973,16180641,69964,9.890,49686,7.024,1867987,666623,1201364,4.120,11.545,1373121,435974,937147,2.694,8.486,494866,3.058,16.972,33626,34538,239086
2006,71,91391,99598,1981530,1958424,14639,14.900,11945,12.158,303323,108270,195053,5.528,15.488,256967,80745,176222,4.123,13.121,46356,2.367,26.242,8760,8812,58392
2006,72,407537,553098,11420256,11235635,75233,13.787,60389,11.067,2050355,1050537,999818,9.350,18.249,1681812,625293,1056519,5.565,14.969,368543,3.280,29.937,46608,47633,426801
2006,81,614897,678728,5418240,5384526,61978,9.113,64669,9.509,768782,254464,514318,4.726,14.278,701418,232030,469388,4.309,13.027,67364,1.251,26.053,45924,46766,156998
2007,11,18970,19648,168245,169079,2381,12.078,2513,12.747,29529,11169,18360,6.606,17.465,30931,10886,20045,6.438,18.294,-1402,-0.829,34.929,1822,1825,7794
2007,21,18547,24183,707490,625731,3382,14.374,2074,8.815,236050,59809,176241,9.558,37.724,71974,29428,42546,4.703,11.502,164076,26.221,23.005,1160,1177,10974
2007,22,5457,16201,645266,635759,1031,6.358,1063,6.555,69884,16890,52994,2.657,10.992,51119,13853,37266,2.179,8.041,18765,2.952,16.081,240,252,1611
2007,23,685736,697465,7317007,7363968,98350,14.166,91937,13.242,1424911,399740,1025171,5.428,19.350,1522219,406656,1115563,5.522,20.671,-97308,-1.321,38.700,68823,68883,287555
2007,31-33,269703,314630,13366099,13516650,21972,6.949,25084,7.933,1254614,294991,959623,2.182,9.282,1559386,480612,1078774,3.556,11.537,-304772,-2.255,18.564,17961,18155,200546
2007,42,302002,401331,6112242,6131301,36347,9.044,37434,9.315,882815,273562,609253,4.462,14.398,922035,323756,598279,5.280,15.038,-39220,-0.640,28.797,23311,23932,131749
2007,44-45,642893,1044482,15611657,15643550,110264,10.593,103175,9.912,2191232,868019,1323213,5.549,14.007,2252356,680252,1572104,4.348,14.398,-61124,-0.391,28.015,65451,68194,336073
2007,48-49,150040,195202,4438557,4402798,28207,14.575,24860,12.846,692571,232125,460446,5.272,15.730,620813,216919,403894,4.927,14.100,71758,1.630,28.201,16640,16844,82286
2007,51,62549,128447,3478620,3478017,17346,13.444,18497,14.336,585322,220030,365292,6.326,16.829,584321,240041,344280,6.902,16.800,1001,0.029,33.601,6361,6615,54056
2007,52,234290,471202,6598005,6624289,60823,13.037,51510,11.041,1111900,447302,664598,6.752,16.785,1164310,453194,711116,6.841,17.576,-52410,-0.791,33.570,19917,20945,105777
2007,53,251683,330867,2187592,2190553,46708,14.176,43946,13.338,421802,175839,245963,8.027,19.256,429535,173751,255784,7.932,19.609,-7733,-0.353,38.511,28430,28873,93895
2007,54,656038,731500,7738660,7695483,96029,13.264,81007,11.189,1371442,453728,917714,5.896,17.821,1290623,462562,828061,6.011,16.771,80819,1.050,33.542,54913,55330,231025
2007,55,26438,50097,2855677,2834537,5872,11.765,5501,11.022,572430,179093,393337,6.318,20.195,525464,203021,322443,7.162,18.538,46966,1.657,37.076,870,904,11324
2007,56,280745,337271,9760720,9734740,48699,14.569,42675,12.767,1979676,621306,1358370,6.382,20.336,1932869,590904,1341965,6.070,19.855,46807,0.481,39.711,27454,27764,310120
2007,61,68281,77854,3040446,3009506,8997,11.725,6757,8.806,285682,71506,214176,2.376,9.493,225057,49619,175438,1.649,7.478,60625,2.014,14.956,4743,4791,28127
2007,62,564457,730391,16752786,16581253,67663,9.348,54467,7.525,1990388,618988,1371400,3.733,12.004,1649353,528288,1121065,3.186,9.947,341035,2.057,19.894,33516,34520,258184
2007,71,92407,101210,2030105,2017704,13924,13.863,12380,12.326,309157,102765,206392,5.093,15.322,285320,88806,196514,4.401,14.141,23837,1.181,28.282,8998,9051,59135
2007,72,414957,568457,11611509,11545901,78344,13.958,63981,11.399,2087679,1058285,1029394,9.166,18.082,1947478,709524,1237954,6.145,16.867,140201,1.214,33.735,46749,47735,442089
2007,81,615026,678396,5369200,5361438,61804,9.128,59190,8.742,781863,255576,526287,4.767,14.583,764729,234947,529782,4.382,14.264,17134,0.320,28.527,40934,41535,147090
2008,11,18239,18958,163262,164850,1989,10.299,2698,13.970,26807,7652,19155,4.642,16.261,30195,10718,19477,6.502,18.317,-3388,-2.055,32.523,1882,1885,8114
2008,21,18513,24449,621652,662629,2741,11.337,2200,9.099,103799,29998,73801,4.527,15.665,185963,31728,154235,4.788,28.064,-82164,-12.400,31.329,1407,1415,13805
2008,22,5416,16379,636236,638340,1319,8.101,1123,6.898,65445,23604,41841,3.698,10.252,69468,18885,50583,2.958,10.883,-4023,-0.630,20.505,221,224,1435
2008,23,660448,672561,7005225,7160095,81050,11.823,107030,15.612,1275034,333185,941849,4.653,17.808,1585114,418001,1167113,5.838,22.138,-310080,-4.331,35.615,79781,79823,298989
2008,31-33,260312,304010,12944913,13100498,19271,6.279,25040,8.159,1153910,268251,885659,2.048,8.808,1464487,438237,1026250,3.345,11.179,-310577,-2.371,17.616,18518,18694,197604
2008,42,299194,399546,6128426,6139043,34827,8.686,37627,9.385,845787,260842,584945,4.249,13.777,870225,297369,572856,4.844,14.175,-24438,-0.398,27.554,23784,24603,133896
2008,44-45,629302,1031896,15561459,15581423,87815,8.468,98025,9.453,1920864,677685,1243179,4.349,12.328,1969067,588571,1380496,3.777,12.637,-48203,-0.309,24.656,65178,68114,315154
2008,48-49,148182,193933,4433299,4441130,25265,12.979,26717,13.725,578858,168914,409944,3.803,13.034,591344,201094,390250,4.528,13.315,-12486,-0.281,26.068,17972,18116,89270
2008,51,62552,128730,3419033,3423294,16162,12.547,16319,12.669,529907,199341,330566,5.823,15.479,543216,181725,361491,5.308,15.868,-13309,-0.389,30.959,6215,6317,54805
2008,52,227195,467443,6430692,6501072,48850,10.409,52586,11.205,963590,382623,580967,5.886,14.822,1100128,426154,673974,6.555,16.922,-136538,-2.100,29.644,24425,25923,132356
2008,53,239557,320239,2149108,2165044,38979,11.976,49460,15.196,383956,153261,230695,7.079,17.734,415599,178806,236793,8.259,19.196,-31643,-1.462,35.469,31873,32269,99870
2008,54,658784,734529,7880230,7818217,88695,12.090,86921,11.848,1333434,447839,885595,5.728,17.055,1203244,453994,749250,5.807,15.390,130190,1.665,30.781,58781,59240,228320
2008,55,26639,50298,2860402,2911161,4512,8.938,4873,9.654,473393,141356,332037,4.856,16.261,576023,149680,426343,5.142,19.787,-102630,-3.525,32.523,1025,1069,16203
2008,56,279824,338467,9682184,9684077,46486,13.781,44196,13.102,1915217,632338,1282879,6.530,19.777,1933221,604991,1328230,6.247,19.963,-18004,-0.186,39.554,28910,29300,304875
2008,61,69519,79338,3119766,3079027,8647,11.000,7187,9.143,285394,58328,227066,1.894,9.269,203996,55083,148913,1.789,6.625,81398,2.644,13.251,5171,5259,37307
2008,62,570606,739663,17156348,16959223,62932,8.563,53448,7.273,1949234,541057,1408177,3.190,11.494,1561537,520382,1041155,3.068,9.208,387697,2.286,18.415,33463,34284,257294
2008,71,92053,100887,2063402,2045235,12698,12.561,13102,12.961,299534,93209,206325,4.557,14.645,261953,92808,169145,4.538,12.808,37581,1.837,25.616,9407,9467,60334
2008,72,418298,575997,11882851,11756449,72027,12.582,64918,11.341,2073350,974102,1099248,8.286,17.636,1830221,689614,1140607,5.866,15.568,243129,2.068,31.136,48276,49243,460063
2008,81,614726,678529,5439353,5409925,57104,8.411,57851,8.521,787628,233321,554307,4.313,14.559,726935,231490,495445,4.279,13.437,60693,1.122,26.874,40374,41180,152034
2009,11,17469,18169,149370,156090,1795,9.658,2628,14.140,19966,6406,13560,4.104,12.791,33204,10729,22475,6.874,21.272,-13238,-8.481,25.583,1794,1794,7666
2009,21,18689,24740,601500,613885,2599,10.536,2453,9.944,88484,28285,60199,4.608,14.414,113425,29615,83810,4.824,18.477,-24941,-4.063,28.828,1442,1474,13875
2009,22,5354,16839,644570,639551,1290,7.762,852,5.126,66135,23052,43083,3.604,10.341,56565,15513,41052,2.426,8.844,9570,1.496,17.689,233,320,5234
2009,23,598457,610662,5944783,6481440,63799,9.925,128044,19.920,856548,262484,594064,4.050,13.215,1929515,480488,1449027,7.413,29.770,-1072967,-16.554,26.431,88282,88353,337150
2009,31-33,250424,292982,11586979,12265166,16670,5.578,28372,9.494,813010,240822,572188,1.963,6.629,2172798,459934,1712864,3.750,17.715,-1359788,-11.087,13.257,20072,20268,199529
2009,42,290604,392072,5822280,5993736,30012,7.564,39396,9.929,634933,200577,434356,3.346,10.593,977231,282825,694406,4.719,16.304,-342298,-5.711,21.187,25500,26215,141680
2009,44-45,608978,1009735,14735470,15161452,77846,7.617,102434,10.023,1432706,597616,835090,3.942,9.450,2290803,673384,1617419,4.441,15.109,-858097,-5.660,18.899,66921,70951,378254
2009,48-49,143060,188983,4159952,4304997,22184,11.564,27883,14.535,450854,178858,271996,4.155,10.473,745105,212518,532587,4.937,17.308,-294251,-6.835,20.946,18417,18799,110849
2009,51,61237,125218,3289538,3363154,16622,13.059,20758,16.308,427863,187530,240333,5.576,12.722,575027,191454,383573,5.693,17.098,-147164,-4.376,25.444,6622,6865,57491
2009,52,217580,454687,6158767,6282242,41236,8.934,54951,11.906,779506,318442,461064,5.069,12.408,1026392,330941,695451,5.268,16.338,-246886,-3.930,24.816,24124,25707,107481
2009,53,226545,306978,2016696,2090640,32284,10.275,46726,14.871,296919,129480,167439,6.193,14.202,445290,173872,271418,8.317,21.299,-148371,-7.097,28.405,29011,29440,94301
2009,54,647986,729092,7791191,7879376,84251,11.491,92469,12.612,1205625,475055,730570,6.029,15.301,1380670,460940,919730,5.850,17.523,-175045,-2.222,30.602,62420,62930,254564
2009,55,26703,50351,2817786,2853174,4357,8.633,4596,9.106,408766,140104,268662,4.910,14.327,479402,123869,355533,4.341,16.802,-70636,-2.476,28.653,993,1124,18573
2009,56,273928,332757,8602500,9148438,40914,12.160,48304,14.357,1357131,475395,881736,5.196,14.835,2455964,625748,1830216,6.840,26.846,-1098833,-12.011,29.669,29535,29917,321614
2009,61,70366,80378,3187937,3150715,8221,10.283,7361,9.207,280652,55530,225122,1.762,8.908,207087,52832,154255,1.677,6.573,73565,2.335,13.145,5266,5327,37058
2009,62,578046,752393,17477366,17330600,60769,8.133,50441,6.750,1790345,523863,1266482,3.023,10.331,1491929,482862,1009067,2.786,8.609,298416,1.722,17.217,33329,34247,295818
2009,71,90965,100116,2007630,2038913,11473,11.377,12920,12.812,245781,82433,163348,4.043,12.055,309306,84904,224402,4.164,15.170,-63525,-3.116,24.109,9353,9411,62436
2009,72,419160,579790,11441979,11681380,66019,11.402,64505,11.140,1616951,854126,762825,7.312,13.842,2095963,679441,1416522,5.816,17.943,-479012,-4.101,27.684,48667,49892,464003
2009,81,611779,674616,5255389,5348503,51223,7.557,57596,8.497,616282,192527,423755,3.600,11.523,802987,222301,580686,4.156,15.013,-186705,-3.491,23.045,40458,41402,152118
2010,11,17245,17939,151387,149587,1965,10.897,2152,11.934,26889,7815,19074,5.224,17.976,23358,7876,15482,5.265,15.615,3531,2.361,31.230,1406,1410,5648
2010,21,18411,24631,586548,596060,2334,9.431,2568,10.377,87557,32376,55181,5.432,14.689,106786,25938,80848,4.352,17.915,-19229,-3.226,29.379,1576,1588,12162
2010,22,5420,17196,639651,640686,1111,6.546,664,3.912,41281,14918,26363,2.328,6.443,43266,10676,32590,1.666,6.753,-1985,-0.310,12.887,179,181,1287
2010,23,559414,571900,5350537,5644937,69898,11.830,107809,18.246,902497,288962,613535,5.119,15.988,1493998,387115,1106883,6.858,26.466,-591501,-10.478,31.975,69449,69570,257112
2010,31-33,241637,282941,10850854,11205909,16525,5.737,26696,9.269,833945,204075,629870,1.821,7.442,1543286,397083,1146203,3.544,13.772,-709341,-6.330,14.884,18392,18530,156558
2010,42,284091,386470,5600702,5710043,31009,7.969,36342,9.339,622885,214566,408319,3.758,10.909,840297,246851,593446,4.323,14.716,-217412,-3.808,21.817,23311,24089,123295
2010,44-45,598597,996278,14452522,14589700,75813,7.560,89024,8.877,1433962,502297,931665,3.443,9.829,1701249,523831,1177418,3.590,11.661,-267287,-1.832,19.657,56709,61482,315537
2010,48-49,139595,185293,4015722,4091251,21024,11.226,25012,13.355,464916,153824,311092,3.760,11.364,613685,199956,413729,4.887,15.000,-148769,-3.636,22.727,15805,16086,77872
2010,51,60130,123589,3133993,3206670,13201,10.611,14849,11.935,367393,151544,215849,4.726,11.457,509904,164873,345031,5.142,15.901,-142511,-4.444,22.914,6011,6141,39373
2010,52,213529,443777,5917307,6040910,39156,8.718,49899,11.110,766452,288166,478286,4.770,12.688,1011128,332162,678966,5.499,16.738,-244676,-4.050,25.375,18607,19814,81329
2010,53,223804,303031,1931518,1969433,34351,11.264,38224,12.534,290755,136048,154707,6.908,14.763,366956,159775,207181,8.113,18.633,-76201,-3.869,29.527,21784,22224,68361
2010,54,644190,728402,7723625,7765226,86939,11.924,88355,12.118,1171693,448538,723155,5.776,15.089,1257655,405991,851664,5.228,16.196,-85962,-1.107,30.178,57126,57716,213636
2010,55,26850,50068,2837069,2842990,4115,8.168,4736,9.401,395550,125873,269677,4.427,13.913,406385,115438,290947,4.060,14.294,-10835,-0.381,27.826,913,983,15674
2010,56,270776,328782,8627907,8627816,40303,12.177,44703,13.506,1629898,459512,1170386,5.326,18.891,1631546,514998,1116548,5.969,18.910,-1648,-0.019,37.782,26907,27465,252055
2010,61,70963,81627,3265393,3226998,8817,10.891,7474,9.232,294092,73277,220815,2.271,9.113,217245,50024,167221,1.550,6.732,76847,2.381,13.464,5162,5218,32635
2010,62,583934,767615,17732213,17608717,63062,8.296,48064,6.323,1705749,587413,1118336,3.336,9.687,1457137,383122,1074015,2.176,8.275,248612,1.412,16.550,31723,32613,216018
2010,71,89979,99460,1995103,2002922,11215,11.244,11777,11.808,243642,91926,151716,4.590,12.164,260273,72500,187773,3.620,12.995,-16631,-0.830,24.329,8362,8442,54600
2010,72,424944,587549,11305129,11378627,63783,10.923,56560,9.686,1508218,774771,733447,6.809,13.255,1646268,540472,1105796,4.750,14.468,-138050,-1.213,26.510,42123,43184,365824
2010,81,612295,675509,5192775,5221163,52298,7.742,52295,7.742,623995,205728,418267,3.940,11.951,680633,193146,487487,3.699,13.036,-56638,-1.085,23.903,35953,36369,122882
2011,11,17131,17831,153579,152773,2025,11.313,2162,12.079,24283,7420,16863,4.857,15.895,22631,7388,15243,4.836,14.813,1652,1.081,29.627,1476,1476,5157
2011,21,18812,25245,648741,618184,2809,11.264,2194,8.798,133861,33325,100536,5.391,21.654,71968,20478,51490,3.313,11.642,61893,10.012,23.284,1403,1426,10308
2011,22,5436,17144,642280,642466,990,5.761,1073,6.244,48163,17624,30539,2.743,7.497,48676,16271,32405,2.533,7.576,-513,-0.080,14.993,198,206,1033
2011,23,541923,554515,5169072,5263693,74529,13.229,92263,16.377,970040,258675,711365,4.914,18.429,1157329,331254,826075,6.293,21.987,-187289,-3.558,36.858,59103,59256,219508
2011,31-33,238681,279452,10938828,10874573,18176,6.460,22033,7.830,1064808,195491,869317,1.798,9.792,936539,279476,657063,2.570,8.612,128269,1.180,17.224,15637,15805,129174
2011,42,281592,386670,5638657,5620236,32282,8.344,32695,8.451,689891,209136,480755,3.721,12.275,652842,224588,428254,3.996,11.616,37049,0.659,23.232,21447,22089,106967
2011,44-45,591702,996121,14646939,14548020,82619,8.296,82097,8.244,1628759,534413,1094346,3.673,11.196,1429148,432593,996555,2.974,9.824,199611,1.372,19.647,54351,56935,233593
2011,48-49,142413,187794,4115150,4063126,25451,13.658,22566,12.109,530438,162889,367549,4.009,13.055,422153,143630,278523,3.535,10.390,108285,2.665,20.780,14605,14796,65434
2011,51,59824,125131,3147411,3144860,16737,13.459,15185,12.211,466178,196203,269975,6.239,14.823,463075,166472,296603,5.293,14.725,3103,0.099,29.450,5625,5755,38203
2011,52,210264,437991,5880326,5897721,37567,8.518,43602,9.887,741943,245557,496386,4.164,12.580,779006,265564,513442,4.503,13.209,-37063,-0.628,25.160,17411,18316,69633
2011,53,220629,298964,1905218,1918243,34727,11.548,38231,12.713,290114,126583,163531,6.599,15.124,317653,151277,166376,7.886,16.560,-27539,-1.436,30.248,21067,24436,82299
2011,54,645641,732492,7844558,7791906,89578,12.264,85422,11.695,1268587,407532,861055,5.230,16.281,1168546,418412,750134,5.370,14.997,100041,1.284,29.994,56381,56957,206566
2011,55,26562,50568,2955969,2905433,4291,8.530,3760,7.475,472876,146118,326758,5.029,16.276,370517,89504,281013,3.081,12.753,102359,3.523,25.505,831,864,12898
2011,56,270401,329066,9065148,8848030,41857,12.728,41453,12.605,1866901,404757,1462144,4.575,21.100,1421801,477243,944558,5.394,16.069,445100,5.030,32.138,25445,25936,223391
2011,61,72374,83444,3387189,3326751,9052,10.962,7319,8.863,342079,81521,260558,2.450,10.283,220385,47208,173177,1.419,6.625,121694,3.658,13.249,5020,5077,28270
2011,62,587221,776531,18004299,17859673,59584,7.720,50223,6.507,1693199,491463,1201736,2.752,9.481,1402985,410186,992799,2.297,7.856,290214,1.625,15.711,33645,34716,242047
2011,71,89829,99477,1996359,1996072,11589,11.659,11439,11.508,251124,83057,168067,4.161,12.581,251177,71822,179355,3.598,12.584,-53,-0.003,25.162,8099,8172,50108
2011,72,429984,594744,11558401,11443242,62919,10.642,55895,9.454,1615727,764491,851236,6.681,14.119,1382276,504014,878262,4.404,12.079,233451,2.040,24.159,42858,43988,364506
2011,81,611990,675329,5181242,5188812,53143,7.868,53328,7.896,636618,195848,440770,3.774,12.269,653517,184676,468841,3.559,12.595,-16899,-0.326,24.538,37006,37549,124087
2012,11,17380,18066,156531,155660,2025,11.271,1826,10.163,25134,7379,17755,4.740,16.147,23475,7077,16398,4.546,15.081,1659,1.066,30.162,1248,1251,4681
2012,21,19596,26275,726058,688404,3019,11.675,2186,8.454,156037,40978,115059,5.953,22.667,81530,29017,52513,4.215,11.843,74507,10.823,23.687,1306,1334,11893
2012,22,5489,17324,642577,642806,946,5.486,784,4.547,45921,15082,30839,2.346,7.144,46709,9668,37041,1.504,7.266,-788,-0.123,14.288,197,204,1748
2012,23,545793,557776,5300354,5230637,76857,13.818,73699,13.251,1060802,261076,799726,4.991,20.281,920884,294196,626688,5.624,17.606,139918,2.675,35.211,47128,47305,191775
2012,31-33,239642,280269,11177542,11079256,18343,6.529,19722,7.020,1098110,199582,898528,1.801,9.911,900563,266009,634554,2.401,8.128,197547,1.783,16.257,13793,13932,132733
2012,42,283593,387774,5765869,5715584,31216,8.028,33325,8.571,791631,201621,590010,3.528,13.850,688474,220675,467799,3.861,12.046,103157,1.805,24.091,19325,19988,102885
2012,44-45,589747,990242,14760708,14655769,81918,8.275,81409,8.223,1723237,539232,1184005,3.679,11.758,1512173,473431,1038742,3.230,10.318,211064,1.440,20.636,49675,52579,234679
2012,48-49,145687,191152,4226498,4177885,24597,12.985,21142,11.161,529427,157825,371602,3.778,12.672,430952,139794,291158,3.346,10.315,98475,2.357,20.630,13838,14042,69056
2012,51,61175,125913,3246636,3228553,14698,11.627,15699,12.419,504249,165899,338350,5.138,15.618,473159,179568,293591,5.562,14.655,31090,0.963,29.311,5273,5505,36085
2012,52,209979,443372,5995051,5950376,42640,9.677,37153,8.432,843826,282281,561545,4.744,14.181,756498,270247,486251,4.542,12.713,87328,1.468,25.427,14814,15535,58091
2012,53,223889,302348,1900831,1896960,36343,12.066,34045,11.303,347756,154211,193545,8.129,18.332,338290,130145,208145,6.861,17.833,9466,0.499,35.667,18168,18969,59833
2012,54,652872,737503,7919322,7876189,88655,12.077,81849,11.150,1296786,419091,877695,5.321,16.465,1206796,456202,750594,5.792,15.322,89990,1.143,30.644,52320,52921,213071
2012,55,26011,51374,3054139,3032965,4766,9.302,4494,8.771,480415,115777,364638,3.817,15.840,435939,129891,306048,4.283,14.373,44476,1.466,28.747,823,868,11363
2012,56,275930,333796,9458807,9240289,41588,12.553,36607,11.049,1766605,406936,1359669,4.404,19.119,1327596,439422,888174,4.756,14.367,439009,4.751,28.735,22953,23317,239178
2012,61,74696,85867,3460096,3419783,9289,10.961,7045,8.313,314306,65521,248785,1.916,9.191,232483,54235,178248,1.586,6.798,81823,2.393,13.596,4693,4744,28220
2012,62,590824,781878,18287802,18120354,60409,7.754,54752,7.028,1934105,559065,1375040,3.085,10.674,1601621,463817,1137804,2.560,8.839,332484,1.835,17.678,33810,36348,274074
2012,71,91015,100816,2065318,2023650,12274,12.271,10684,10.682,298112,94402,203710,4.665,14.731,214719,67961,146758,3.358,10.610,83393,4.121,21.221,7297,7367,45417
2012,72,438374,602082,11984980,11799237,65746,10.982,58957,9.848,1849736,811443,1038293,6.877,15.677,1475006,576591,898415,4.887,12.501,374730,3.176,25.002,41295,42517,373433
2012,81,617394,679740,5224374,5189549,55024,8.131,49051,7.248,682190,208567,473623,4.019,13.145,611395,185851,425544,3.581,11.781,70795,1.364,23.563,33068,33728,117387
2013,11,17366,18063,153875,154389,1971,10.904,1997,11.048,22926,7259,15667,4.702,14.850,24033,9911,14122,6.419,15.567,-1107,-0.717,29.699,1378,1378,7513
2013,21,19625,26332,730762,726167,2688,10.230,2574,9.796,116189,34003,82186,4.683,16.000,107322,36148,71174,4.978,14.779,8867,1.221,29.558,1554,1588,12999
2013,22,5515,17453,635906,638521,1004,5.773,880,5.060,45986,17060,28926,2.672,7.202,51180,12002,39178,1.880,8.015,-5194,-0.813,14.404,206,215,2062
2013,23,545596,557638,5457712,5378460,71281,12.782,71298,12.786,1054288,257282,797006,4.784,19.602,895952,273534,622418,5.086,16.658,158336,2.944,33.316,45113,45230,185320
2013,31-33,236730,277111,11257612,11211871,16991,6.104,19474,6.996,996656,189119,807537,1.687,8.889,907032,270305,636727,2.411,8.090,89624,0.799,16.180,13876,13998,127536
2013,42,282037,387196,5872240,5817668,31145,8.036,31846,8.217,792056,241197,550859,4.146,13.615,681035,234326,446709,4.028,11.706,111021,1.908,23.413,20055,20555,107189
2013,44-45,588436,992837,15000135,14884022,79083,7.976,76450,7.710,1645145,524225,1120920,3.522,11.053,1407390,432582,974808,2.906,9.456,237755,1.597,18.911,49884,51982,220320
2013,48-49,147265,192708,4281387,4252466,23635,12.307,22319,11.621,562823,158089,404734,3.718,13.235,507026,205231,301795,4.826,11.923,55797,1.312,23.846,14021,14192,70548
2013,51,61326,124267,3273592,3245496,14683,11.791,15203,12.209,519124,196210,322914,6.046,15.995,465188,193076,272112,5.949,14.333,53936,1.662,28.667,5728,5931,44108
2013,52,210212,438098,6053098,6019507,35348,8.024,40191,9.124,765004,216046,548958,3.589,12.709,697346,237720,459626,3.949,11.585,67658,1.124,23.170,14342,14854,71418
2013,53,229053,308477,1950648,1927114,37714,12.366,30724,10.074,337665,143361,194304,7.439,17.522,290306,119482,170824,6.200,15.064,47359,2.458,30.129,17508,17898,59129
2013,54,660354,748095,8210537,8054888,92036,12.380,82675,11.121,1439441,560415,879026,6.957,17.870,1129861,425955,703906,5.288,14.027,309580,3.843,28.054,52923,53258,215348
2013,55,25990,51783,3164210,3129676,4024,7.791,3756,7.272,492084,154520,337564,4.937,15.723,429770,123165,306605,3.935,13.732,62314,1.991,27.464,644,664,8447
2013,56,274889,337545,9865014,9711850,43880,13.089,39291,11.720,1756904,435738,1321166,4.487,18.090,1449630,469188,980442,4.831,14.926,307274,3.164,29.853,23703,23951,222665
2013,61,76769,88214,3507807,3487104,9218,10.569,7225,8.284,287648,64398,223250,1.847,8.249,245162,53287,191875,1.528,7.031,42486,1.218,14.061,4981,5109,36625
2013,62,594087,789578,18430842,18337519,62485,7.952,54852,6.981,1842572,523840,1318732,2.857,10.048,1657643,493349,1164294,2.690,9.040,184929,1.008,18.079,35732,36524,283985
2013,71,92312,102240,2114125,2091986,12090,11.902,10773,10.605,278480,97941,180539,4.682,13.312,233601,69606,163995,3.327,11.166,44879,2.145,22.333,7399,7425,46376
2013,72,445198,612831,12380648,12184720,68149,11.217,57591,9.479,1931810,875306,1056504,7.184,15.854,1534519,611704,922815,5.020,12.594,397291,3.261,25.188,42141,43178,376115
2013,81,621093,682995,5262129,5248132,53703,7.880,50710,7.441,651280,205522,445758,3.916,12.410,621183,198234,422949,3.777,11.836,30097,0.573,23.673,34375,34765,119733
2014,11,17470,18149,155200,153600,1993,11.013,1888,10.433,23953,7455,16498,4.854,15.594,20703,7533,13170,4.904,13.479,3250,2.116,26.957,1307,1308,5810
2014,21,19936,26817,753393,742405,2849,10.722,2360,8.881,127661,40305,87356,5.429,17.196,105130,37433,67697,5.042,14.161,22531,3.035,28.321,1480,1511,14968
2014,22,5553,17482,634606,635248,867,4.967,814,4.663,44741,10337,34404,1.627,7.043,45741,10959,34782,1.725,7.201,-1000,-0.157,14.086,190,201,1241
2014,23,553641,566226,5697359,5573526,73592,13.097,64938,11.557,1102124,291196,810928,5.225,19.774,853559,250564,602995,4.496,15.315,248565,4.460,30.629,41588,41659,157429
2014,31-33,235249,275922,11366994,11305410,17604,6.371,18398,6.658,1039623,220382,819241,1.949,9.196,914313,255752,658561,2.262,8.087,125310,1.108,16.175,13308,13397,118422
2014,42,280732,386660,5944267,5904137,29676,7.666,30573,7.898,709748,181753,527995,3.078,12.021,628028,231197,396831,3.916,10.637,81720,1.384,21.274,19292,19812,100722
2014,44-45,587867,995305,15394259,15197019,78326,7.880,75780,7.623,1633808,559887,1073921,3.684,10.751,1247028,387829,859199,2.552,8.206,386780,2.545,16.411,49502,51592,210939
2014,48-49,149347,196192,4405776,4344763,24244,12.461,20968,10.777,554247,167963,386284,3.866,12.757,431882,145126,286756,3.340,9.940,122365,2.816,19.881,14020,14213,67630
2014,51,62421,128263,3342083,3310274,18083,14.314,14212,11.250,531549,188215,343334,5.686,16.058,466519,151856,314663,4.587,14.093,65030,1.964,28.186,5349,5472,34792
2014,52,211067,441003,6061542,6074650,38114,8.670,35290,8.028,749198,272806,476392,4.491,12.333,778990,241216,537774,3.971,12.824,-29792,-0.490,24.666,14092,14562,54420
2014,53,233872,316563,2007211,1977549,37979,12.149,30061,9.616,342115,141403,200712,7.150,17.300,281220,123202,158018,6.230,14.221,60895,3.079,28.441,17637,18041,59018
2014,54,667218,759185,8437208,8318038,93714,12.433,82899,10.998,1361420,470763,890657,5.660,16.367,1122901,378674,744227,4.552,13.500,238519,2.867,26.999,53546,54156,198727
2014,55,26213,52292,3240066,3235443,4226,8.094,4071,7.797,444205,134049,310156,4.143,13.729,429449,140717,288732,4.349,13.273,14756,0.456,26.547,689,717,10571
2014,56,276712,342132,10170480,9981229,42706,12.570,37927,11.163,1963986,510379,1453607,5.113,19.677,1595823,577212,1018611,5.783,15.988,368163,3.689,31.976,22799,23100,213926
2014,61,78107,89676,3560269,3532448,9043,10.165,7616,8.561,315979,86465,229514,2.448,8.945,258465,60744,197721,1.720,7.317,57514,1.628,14.634,5143,5215,37008
2014,62,597527,802184,18684094,18538811,67520,8.483,55102,6.923,1825939,598642,1227297,3.229,9.849,1531528,463255,1068273,2.499,8.261,294411,1.588,16.522,36911,38129,268441
2014,71,93691,104195,2167600,2133506,12622,12.228,10671,10.338,291558,102831,188727,4.820,13.666,221976,73478,148498,3.444,10.404,69582,3.261,20.809,7540,7624,52599
2014,72,450241,619971,12777765,12590234,65120,10.563,58152,9.433,1890818,866658,1024160,6.884,15.018,1513695,578029,935666,4.591,12.023,377123,2.995,24.046,43784,44913,398658
2014,81,624247,688005,5324611,5296113,54399,7.935,49464,7.215,648611,223556,425055,4.221,12.247,590508,181579,408929,3.429,11.150,58103,1.097,22.300,34857,35239,121911
2015,11,17763,18434,158590,156439,2184,11.998,1722,9.460,25843,8226,17617,5.258,16.520,21554,6973,14581,4.457,13.778,4289,2.742,27.556,1166,1168,5448
2015,21,19793,26836,741335,749368,2811,10.474,2813,10.482,108672,40282,68390,5.375,14.502,125445,36554,88891,4.878,16.740,-16773,-2.238,29.004,1802,1820,15017
2015,22,5541,17526,640792,638430,957,5.466,924,5.277,48600,11846,36754,1.855,7.612,43942,9516,34426,1.491,6.883,4658,0.730,13.766,225,227,1012
2015,23,567356,580649,6009907,5854676,75821,13.221,61480,10.721,1152648,303880,848768,5.190,19.688,843299,239796,603503,4.096,14.404,309349,5.284,28.808,40132,40190,156205
2015,31-33,234805,276170,11548531,11451866,18238,6.604,18237,6.604,1077455,226952,850503,1.982,9.409,882879,249255,633624,2.177,7.709,194576,1.699,15.419,13382,13472,119389
2015,42,278460,385232,6051228,5995339,29234,7.573,30781,7.974,712397,200694,511703,3.348,11.883,598796,205128,393668,3.421,9.988,113601,1.895,19.975,19714,20204,102261
2015,44-45,587049,999635,15711141,15532568,79363,7.958,74656,7.486,1719793,651409,1068384,4.194,11.072,1364970,443239,921731,2.854,8.788,354823,2.284,17.576,49606,52521,231224
2015,48-49,153862,202983,4600557,4505100,27795,13.920,21192,10.613,652768,209226,443542,4.644,14.490,461979,170309,291670,3.780,10.255,190789,4.235,20.509,13805,13989,66198
2015,51,63247,129226,3386512,3365788,13955,10.829,13240,10.274,469504,135540,333964,4.027,13.949,426460,137071,289389,4.072,12.670,43044,1.279,25.341,5690,5981,46835
2015,52,212330,441533,6099103,6070646,38929,8.822,38426,8.708,804099,245682,558417,4.047,13.246,744454,224439,520015,3.697,12.263,59645,0.983,24.526,14081,14719,58515
2015,53,239526,324828,2055761,2033249,38361,11.961,30128,9.394,325105,132924,192181,6.538,15.989,280108,121987,158121,6.000,13.776,44997,2.213,27.553,18213,18696,63900
2015,54,673421,770466,8650330,8528552,94033,12.295,82765,10.821,1435756,518894,916862,6.084,16.835,1188285,415033,773252,4.866,13.933,247471,2.902,27.866,54782,55284,212738
2015,55,26653,52869,3348111,3306622,4527,8.611,3938,7.490,504673,159539,345134,4.825,15.262,421162,94862,326300,2.869,12.737,83511,2.526,25.474,681,717,10559
2015,56,279544,346454,10654051,10440759,43472,12.629,39010,11.333,1802894,461723,1341171,4.422,17.268,1372380,434597,937783,4.163,13.144,430514,4.123,26.289,22626,22876,227397
2015,61,80039,91994,3636957,3596752,9909,10.898,7770,8.546,304025,63484,240541,1.765,8.453,224269,55028,169241,1.530,6.235,79756,2.217,12.471,5218,5430,32860
2015,62,599268,820150,19104980,18906323,75422,9.297,57634,7.104,2142751,754128,1388623,3.989,11.334,1743796,518710,1225086,2.744,9.223,398955,2.110,18.447,38267,39253,274733
2015,71,95836,106758,2232209,2196172,13300,12.604,10834,10.267,291723,99837,191886,4.546,13.283,219015,75866,143149,3.454,9.973,72708,3.311,19.945,7493,7559,53408
2015,72,455809,626712,13196129,12984890,66096,10.602,59587,9.558,2060972,959228,1101744,7.387,15.872,1641039,664930,976109,5.121,12.638,419933,3.234,25.276,42660,43934,436518
2015,81,628039,692843,5404622,5369692,55372,8.022,50220,7.275,653598,215464,438134,4.013,12.172,584414,195381,389033,3.639,10.884,69184,1.288,21.767,34879,35400,121509
2016,11,18165,18891,159735,159246,2281,12.201,1888,10.099,24584,9451,15133,5.935,15.438,23845,7647,16198,4.802,14.974,739,0.464,29.947,1322,1322,5450
2016,21,18059,24969,583970,662692,1960,7.568,3822,14.757,53639,26066,27573,3.933,8.094,210680,41600,169080,6.277,31.792,-157041,-23.697,16.188,2392,2423,18871
2016,22,5537,17750,640551,640084,1074,6.099,795,4.514,44085,13268,30817,2.073,6.887,42992,11445,31547,1.788,6.717,1093,0.171,13.433,247,253,1465
2016,23,584732,598488,6315829,6160877,78687,13.357,59964,10.178,1167292,299431,867861,4.860,18.947,857048,246135,610913,3.995,13.911,310244,5.036,27.822,39975,40038,161093
2016,31-33,233933,276023,11549550,11548228,18047,6.535,18359,6.648,974083,197771,776312,1.713,8.435,969618,244508,725110,2.117,8.396,4465,0.039,16.792,13570,13676,119650
2016,42,275404,384332,6117070,6098602,28759,7.471,30009,7.795,683034,198600,484434,3.256,11.200,645872,217580,428292,3.568,10.590,37162,0.609,21.181,19797,20381,107203
2016,44-45,588049,1005489,15960559,15834818,80874,8.072,73780,7.364,1711758,571809,1139949,3.611,10.810,1465768,456762,1009006,2.885,9.257,245990,1.553,18.513,48241,51531,231304
2016,48-49,156731,207283,4728530,4665488,26906,13.113,22725,11.075,616820,193543,423277,4.148,13.221,492261,191545,300716,4.106,10.551,124559,2.670,21.102,15156,15403,105344
2016,51,64859,135319,3400863,3375508,17432,13.161,11690,8.826,463059,179523,283536,5.318,13.718,411844,144030,267814,4.267,12.201,51215,1.517,24.402,5688,5915,39728
2016,52,213073,451749,6309524,6199853,42794,9.582,32545,7.287,883945,294833,589112,4.755,14.258,666297,197400,468897,3.184,10.747,217648,3.511,21.494,14328,14965,62446
2016,53,245748,335423,2096916,2070418,41713,12.638,31011,9.395,341591,153912,187679,7.434,16.499,290037,115150,174887,5.562,14.009,51554,2.490,28.017,18754,19077,64885
2016,54,679612,781606,8793302,8682440,93881,12.096,82892,10.680,1313924,451878,862046,5.205,15.133,1093901,386210,707691,4.448,12.599,220023,2.534,25.198,56294,56875,222411
2016,55,26849,54156,3378665,3366630,5059,9.461,3693,6.906,458923,130427,328496,3.874,13.632,437273,104696,332577,3.110,12.988,21650,0.643,25.977,684,722,13760
2016,56,287053,357861,10930800,10857194,45733,12.972,35088,9.953,1865566,515563,1350003,4.749,17.183,1712963,533267,1179696,4.912,15.777,152603,1.406,31.554,22525,22732,234010
2016,61,81679,93511,3659607,3638786,9683,10.452,7944,8.575,298648,65659,232989,1.804,8.207,255543,69017,186526,1.897,7.023,43105,1.185,14.046,5291,5483,44443
2016,62,603640,836435,19609814,19360185,72341,8.732,56382,6.806,2065226,615979,1449247,3.182,10.667,1564364,476147,1088217,2.459,8.080,500862,2.587,16.161,38684,39776,288876
2016,71,98883,110319,2312395,2269530,14430,13.290,10952,10.087,309083,101946,207137,4.492,13.619,221330,74814,146516,3.296,9.752,87753,3.867,19.504,7729,7786,52592
2016,72,466652,645244,13701444,13457006,71220,11.197,52910,8.318,2079640,1022481,1057159,7.598,15.454,1596161,589475,1006686,4.380,11.861,483479,3.593,23.722,40572,41627,415351
2016,81,635813,701625,5497776,5446465,57819,8.291,49269,7.065,682002,221436,460566,4.066,12.522,579723,188597,391126,3.463,10.644,102279,1.878,21.288,35301,35750,127715
2017,11,18295,19012,161691,160200,2134,11.258,2020,10.657,27589,9041,18548,5.644,17.222,24547,8388,16159,5.236,15.323,3042,1.899,30.645,1365,1365,5525
2017,21,16732,23498,575573,576608,2413,10.044,3464,14.419,103682,35706,67976,6.192,17.981,107093,45402,61691,7.874,18.573,-3411,-0.592,35.963,1941,2015,15934
2017,22,5518,17995,645142,644516,1096,6.120,925,5.165,50888,18486,32402,2.868,7.896,49700,9740,39960,1.511,7.711,1188,0.184,15.422,225,229,1349
2017,23,597685,611695,6533369,6429782,76848,12.697,63965,10.568,1122659,282682,839977,4.396,17.460,915243,264458,650785,4.113,14.234,207416,3.226,28.469,42374,42436,166360
2017,31-33,231583,274183,11689358,11635680,17659,6.417,19639,7.137,1112708,224864,887844,1.933,9.563,1006305,303022,703283,2.604,8.648,106403,0.914,17.297,13756,13895,142082
2017,42,269206,378662,6098884,6081663,27404,7.198,31470,8.266,762265,203938,558327,3.353,12.534,725998,260651,465347,4.286,11.937,36267,0.596,23.875,19488,20063,111394
2017,44-45,585687,994622,15684250,15704753,75590,7.575,82239,8.241,1706042,526802,1179240,3.354,10.863,1742404,573541,1168863,3.652,11.095,-36362,-0.232,21.726,48888,51701,239624
2017,48-49,157779,208888,4858301,4789910,25181,12.087,24071,11.554,653692,204991,448701,4.280,13.647,511879,176476,335403,3.684,10.687,141813,2.961,21.373,15737,15979,73057
2017,51,66828,139061,3457282,3490938,16382,11.744,17251,12.367,504191,162320,341871,4.650,14.443,573107,166910,406197,4.781,16.417,-68916,-1.974,28.886,6182,6398,51092
2017,52,212492,445942,6364092,6351086,34828,7.763,40232,8.967,893273,318340,574933,5.012,14.065,870285,313983,556302,4.944,13.703,22988,0.362,27.406,14566,15199,64952
2017,53,251966,346988,2145761,2121447,44494,13.043,32803,9.616,358920,143943,214977,6.785,16.919,307125,121900,185225,5.746,14.477,51795,2.441,28.954,19522,20004,66850
2017,54,682675,784575,8864974,8762036,87940,11.239,83730,10.701,1296902,387355,909547,4.421,14.801,1090571,445785,644786,5.088,12.447,206331,2.355,24.893,56265,56888,244226
2017,55,26485,55298,3493863,3422211,5516,10.066,4512,8.234,569992,166512,403480,4.866,16.656,428506,137154,291352,4.008,12.521,141486,4.134,25.043,780,811,15889
2017,56,290117,361936,11205932,11078959,40728,11.293,38175,10.585,2023797,591343,1432454,5.338,18.267,1771614,575450,1196164,5.194,15.991,252183,2.276,31.982,23959,24316,248387
2017,61,82818,94213,3689320,3678625,9665,10.323,8495,9.073,301881,63988,237893,1.739,8.206,280753,85060,195693,2.312,7.632,21128,0.574,15.264,5573,6023,52136
2017,62,606361,843553,20109347,19860067,71653,8.528,65037,7.740,2378025,617988,1760037,3.112,11.974,1882734,642470,1240264,3.235,9.480,495291,2.494,18.960,39561,40971,323267
2017,71,101197,113716,2376395,2347546,14973,13.366,11584,10.341,327257,111805,215452,4.763,13.940,269250,89157,180093,3.798,11.469,58007,2.471,22.939,7954,7996,56094
2017,72,475838,658065,14020830,13866581,71311,10.935,59414,9.111,2220470,1022078,1198392,7.371,16.013,1923315,737703,1185612,5.320,13.870,297155,2.143,27.740,41358,42892,447040
2017,81,640178,706374,5506488,5478407,57485,8.170,51887,7.375,696433,224354,472079,4.095,12.712,638688,202798,435890,3.702,11.658,57745,1.054,23.317,36890,37501,138798
2018,11,18353,19016,162310,161801,2088,10.997,2030,10.692,24196,8673,15523,5.360,14.954,23104,8001,15103,4.945,14.279,1092,0.675,28.559,1431,1431,5369
2018,21,16743,23248,605867,592358,2187,9.347,2487,10.629,107961,21966,85995,3.708,18.226,79759,31622,48137,5.338,13.465,28202,4.761,26.929,1433,1488,11063
2018,22,5561,18379,647167,646314,1956,10.753,1579,8.680,78482,40920,37562,6.331,12.143,76438,37979,38459,5.876,11.827,2044,0.316,23.654,218,228,1085
2018,23,611733,626165,6805887,6664282,79045,12.774,64304,10.392,1187906,321729,866177,4.828,17.825,904537,250495,654042,3.759,13.573,283369,4.252,27.146,43620,43681,168267
2018,31-33,229746,273785,11867119,11778508,18299,6.680,18584,6.784,1113165,240980,872185,2.046,9.451,938783,238605,700178,2.026,7.970,174382,1.481,15.941,13683,13769,124547
2018,42,265449,373895,6126198,6110033,25380,6.746,30044,7.986,682513,161882,520631,2.649,11.170,649379,216749,432630,3.547,10.628,33134,0.542,21.256,18889,19391,101573
2018,44-45,580413,984256,15669440,15678905,70233,7.103,79275,8.017,1621254,484151,1137103,3.088,10.340,1647170,555290,1091880,3.542,10.506,-25916,-0.165,20.681,48615,51818,248694
2018,48-49,162147,213269,5020972,4937995,27038,12.811,22622,10.718,648586,189665,458921,3.841,13.135,482371,154122,328249,3.121,9.769,166215,3.366,19.537,14934,15096,75739
2018,51,67868,141888,3541620,3517055,15354,10.894,13465,9.553,503713,171198,332515,4.868,14.322,453829,144983,308846,4.122,12.904,49884,1.418,25.807,6258,6666,49735
2018,52,212494,446812,6442913,6405160,37498,8.403,36335,8.143,878725,327175,551550,5.108,13.719,803827,237738,566089,3.712,12.550,74898,1.169,25.099,14988,15909,71004
2018,53,259316,354751,2199591,2172757,41876,11.935,34104,9.720,361102,143168,217934,6.589,16.620,308530,128604,179926,5.919,14.200,52572,2.420,28.400,19709,20112,63980
2018,54,686673,786087,9059402,8958911,87258,11.114,85269,10.861,1292193,383081,909112,4.276,14.424,1091729,424020,667709,4.733,12.186,200464,2.238,24.372,56769,57484,230242
2018,55,25641,53569,3494326,3486391,2466,4.544,3871,7.133,457689,87378,370311,2.506,13.128,440459,139256,301203,3.994,12.634,17230,0.494,25.267,739,763,12086
2018,56,293378,359159,11493551,11355363,39780,11.034,42479,11.783,1848487,470654,1377833,4.145,16.279,1561795,475540,1086255,4.188,13.754,286692,2.525,27.508,24015,24226,213641
2018,61,84520,95852,3725178,3703193,9465,9.953,7952,8.362,295065,61502,233563,1.661,7.968,249318,57532,191786,1.554,6.733,45747,1.235,13.465,5536,5603,37456
2018,62,601106,843151,20476451,20324832,69537,8.280,62967,7.497,2215303,689290,1526013,3.391,10.899,1908962,563753,1345209,2.774,9.392,306341,1.507,18.785,39635,40579,283347
2018,71,104138,116802,2434177,2406570,14741,12.779,11849,10.272,321274,116686,204588,4.849,13.350,265192,79607,185585,3.308,11.020,56082,2.330,22.039,8177,8282,55633
2018,72,483641,666757,14321104,14176239,67343,10.167,58607,8.848,2111533,921274,1190259,6.499,14.895,1821933,694643,1127290,4.900,12.852,289600,2.043,25.704,43105,44662,471701
2018,81,644116,709181,5592000,5551161,56460,7.978,53423,7.549,711235,227774,483461,4.103,12.812,628137,205204,422933,3.697,11.315,83098,1.497,22.631,37200,37817,136434
2019,11,18481,19166,164375,163634,2155,11.276,2045,10.701,24855,8448,16407,5.163,15.189,23382,6965,16417,4.256,14.289,1473,0.900,28.578,1508,1508,5343
2019,21,16663,23107,627318,615083,2185,9.460,2164,9.369,94046,25551,68495,4.154,15.290,69506,21891,47615,3.559,11.300,24540,3.990,22.601,1366,1400,10608
2019,22,5660,18492,641613,644137,944,5.118,847,4.592,39064,13853,25211,2.151,6.065,44520,13678,30842,2.123,6.912,-5456,-0.847,12.129,224,224,1456
2019,23,626588,641700,7044367,6926685,81980,12.930,66647,10.512,1174368,320593,853775,4.628,16.954,941039,258243,682796,3.728,13.586,233329,3.369,27.171,46963,47045,181679
2019,31-33,227849,272129,12064265,11960937,17161,6.287,18815,6.893,1085308,222948,862360,1.864,9.074,876970,237753,639217,1.988,7.332,208338,1.742,14.664,13788,13903,119545
2019,42,261284,371340,6167881,6148524,24963,6.696,27851,7.471,638952,172986,465966,2.813,10.392,599763,188375,411388,3.064,9.755,39189,0.637,19.509,19209,19593,100356
2019,44-45,576742,982653,15740179,15703304,69886,7.108,70923,7.214,1474942,483126,991816,3.077,9.393,1413148,476601,936547,3.035,8.999,61794,0.394,17.998,48483,50669,252325
2019,48-49,168065,220348,5484922,5256794,29236,13.478,22376,10.315,881687,209157,672530,3.979,16.772,430683,133885,296798,2.547,8.193,451004,8.579,16.386,15844,16066,78781
2019,51,69086,143969,3526129,3534095,16675,11.664,14669,10.260,483533,160938,322595,4.554,13.682,499434,137101,362333,3.879,14.132,-15901,-0.450,27.364,6587,6846,46525
2019,52,211869,446462,6530170,6496540,36071,8.079,36090,8.083,799236,282531,516705,4.349,12.302,730516,241086,489430,3.711,11.245,68720,1.058,22.489,15480,16004,65076
2019,53,265394,361878,2239168,2217870,41543,11.593,34448,9.613,333079,140272,192807,6.325,15.018,292667,118778,173889,5.355,13.196,40412,1.822,26.392,20868,21283,66956
2019,54,693741,795291,9238083,9152587,91255,11.539,82367,10.415,1246170,386303,859867,4.221,13.615,1080769,387617,693152,4.235,11.808,165401,1.807,23.617,58418,58876,229646
2019,55,25235,51599,3499834,3505788,2105,4.005,4029,7.665,378695,66456,312239,1.896,10.802,394270,96153,298117,2.743,11.246,-15575,-0.444,21.604,698,731,14175
2019,56,297537,366272,11712210,11554915,44002,12.132,36866,10.164,1807999,504847,1303152,4.369,15.647,1498270,451002,1047268,3.903,12.967,309729,2.680,25.933,24657,24888,198792
2019,61,86243,97470,3804405,3773272,9906,10.241,8423,8.708,296593,72414,224179,1.919,7.860,234781,64103,170678,1.699,6.222,61812,1.638,12.444,5835,5968,41996
2019,62,605174,858128,20803459,20618166,74888,8.806,59458,6.992,2104364,692342,1412022,3.358,10.206,1740434,568721,1171713,2.758,8.441,363930,1.765,16.883,39480,40593,296448
2019,71,107173,120551,2472834,2442641,15656,13.184,12058,10.154,317192,113798,203394,4.659,12.986,256828,78894,177934,3.230,10.514,60364,2.471,21.029,8700,8781,60096
2019,72,490604,677595,14492771,14404984,69114,10.284,58028,8.634,1977509,930771,1046738,6.461,13.728,1795920,662864,1133056,4.602,12.467,181589,1.261,24.935,44639,45740,466192
2019,81,648282,714335,5626303,5608760,57317,8.054,51903,7.294,647683,218510,429173,3.896,11.548,613372,195967,417405,3.494,10.936,34311,0.612,21.872,38428,38889,140439
2020,11,18092,18790,166501,164924,2031,10.777,2144,11.376,26369,8514,17855,5.162,15.989,23050,7773,15277,4.713,13.976,3319,2.012,27.952,1470,1470,5316
2020,21,16084,22322,579439,601763,1879,8.272,2666,11.736,72613,23219,49394,3.858,12.067,117697,37496,80201,6.231,19.559,-45084,-7.492,24.133,1576,1646,13265
2020,22,5707,18683,636945,639459,927,4.984,757,4.070,38884,10014,28870,1.566,6.081,43739,9675,34064,1.513,6.840,-4855,-0.759,12.162,242,245,2359
2020,23,632775,648751,7185415,7115288,80418,12.461,73648,11.412,1124642,313576,811066,4.407,15.806,984835,285465,699370,4.012,13.841,139807,1.965,27.682,50042,50142,192403
2020,31-33,223825,268369,11960402,12010601,16630,6.153,20458,7.569,977303,216658,760645,1.804,8.137,1079248,256545,822703,2.136,8.986,-101945,-0.849,16.274,14354,14470,127688
2020,42,254683,365130,6131925,6153608,23656,6.424,29861,8.109,613156,167624,445532,2.724,9.964,659193,230176,429017,3.741,10.712,-46037,-0.748,19.928,19284,19769,98016
2020,44-45,567286,971985,15813874,15771138,72034,7.374,81925,8.386,1564512,564593,999919,3.580,9.920,1469642,515420,954222,3.268,9.319,94870,0.602,18.637,49383,52834,253092
2020,48-49,169279,221782,5706311,5605059,29754,13.456,28444,12.863,790023,326870,463153,5.832,14.095,586032,223637,362395,3.990,10.455,203991,3.639,20.911,18021,18248,91056
2020,51,69986,145282,3502996,3509405,14508,10.022,13453,9.294,444787,143472,301315,4.088,12.674,454820,144671,310149,4.122,12.960,-10033,-0.286,25.348,6835,7174,55281
2020,52,212395,444961,6639343,6587738,33339,7.481,34733,7.794,788840,223552,565288,3.393,11.974,682816,207271,475545,3.146,10.365,106024,1.609,20.730,14934,15788,66227
2020,53,270841,368320,2278527,2261081,43499,11.915,37012,10.138,338449,138908,199541,6.143,14.968,304430,123981,180449,5.483,13.464,34019,1.505,26.928,22110,22443,66303
2020,54,701286,805495,9501619,9380348,95791,11.967,85704,10.707,1366804,455226,911578,4.853,14.571,1123686,423887,699799,4.519,11.979,243118,2.592,23.958,58901,59424,236936
2020,55,25062,50968,3537057,3513104,2787,5.439,3331,6.501,466491,124750,341741,3.551,13.279,417010,113579,303431,3.233,11.870,49481,1.408,23.740,681,728,13744
2020,56,298923,372014,11655124,11699095,46211,12.519,40425,10.952,1799760,615222,1184538,5.259,15.384,1900308,526047,1374261,4.496,16.243,-100548,-0.859,30.768,25995,26159,219727
2020,61,87574,99361,3756643,3750972,10505,10.670,8699,8.835,278785,76520,202265,2.040,7.432,267499,59886,207613,1.597,7.131,11286,0.301,14.263,6026,6096,39944
2020,62,607096,867442,21205058,21027964,75516,8.757,65272,7.569,2181441,695462,1485979,3.307,10.374,1826448,583494,1242954,2.775,8.686,354993,1.688,17.372,40863,42046,315310
2020,71,109316,123379,2474826,2474045,16532,13.547,13849,11.348,325415,126069,199346,5.096,13.153,323340,91392,231948,3.694,13.069,2075,0.084,26.139,9546,9648,64268
2020,72,490559,680641,14387087,14435387,67340,9.916,64329,9.472,1930789,883802,1046987,6.122,13.375,2028317,687423,1340894,4.762,14.051,-97528,-0.676,26.751,46402,47988,470009
2020,81,645820,713073,5618154,5625338,60410,8.463,61885,8.670,685607,245032,440575,4.356,12.188,698248,245766,452482,4.369,12.413,-12641,-0.225,24.376,40637,41043,154279
2021,11,18580,19303,164535,165562,2386,12.519,1899,9.964,25425,10264,15161,6.199,15.357,27343,7495,19848,4.527,16.515,-1918,-1.158,30.714,1409,1409,5621
2021,21,15069,21088,474197,524872,1530,7.055,2725,12.566,41910,16551,25359,3.153,7.985,142877,30279,112598,5.769,27.221,-100967,-19.237,15.970,1644,1728,14316
2021,22,5902,19126,631819,633737,1258,6.638,907,4.786,41358,10599,30759,1.672,6.526,44931,11216,33715,1.770,7.090,-3573,-0.564,13.052,274,278,1766
2021,23,650376,667247,7085774,7132216,89558,13.616,70550,10.726,1037610,335150,702460,4.699,14.548,1127795,262699,865096,3.683,15.813,-90185,-1.264,29.096,49145,49226,172207
2021,31-33,220403,265398,11658587,11810019,18251,6.846,20646,7.744,987815,234806,753009,1.988,8.364,1289582,259129,1030453,2.194,10.919,-301767,-2.555,16.728,13875,14046,114600
2021,42,251523,362491,5914984,6028840,26407,7.250,29886,8.205,581537,179255,402282,2.973,9.646,808477,214520,593957,3.558,13.410,-226940,-3.764,19.292,18316,18959,96693
2021,44-45,569747,962814,15551286,15678067,80350,8.311,88393,9.143,1585780,502269,1083511,3.204,10.115,1847896,534659,1313237,3.410,11.787,-262116,-1.672,20.229,46504,53303,262790
2021,48-49,181469,235333,5706256,5706031,40242,17.602,26830,11.735,800401,340117,460284,5.961,14.027,795380,190059,605321,3.331,13.939,5021,0.088,27.879,17003,17321,87736
2021,51,71899,143495,3326876,3410739,16941,11.717,19129,13.230,448868,145635,303233,4.270,13.160,614620,176805,437815,5.184,18.020,-165752,-4.860,26.321,6903,7250,49225
2021,52,215627,446071,6682653,6658672,40705,9.141,39192,8.801,891719,286027,605692,4.296,13.392,841955,290346,551609,4.360,12.644,49764,0.747,25.289,15314,15953,64812
2021,53,282646,378955,2185501,2232774,52984,14.188,41949,11.233,323888,156818,167070,7.023,14.506,422979,133820,289159,5.993,18.944,-99091,-4.438,29.012,23650,24003,69693
2021,54,716547,820662,9494946,9492468,105957,13.030,91023,11.193,1352622,465705,886917,4.906,14.249,1347027,462878,884149,4.876,14.190,5595,0.059,28.381,62438,63022,241017
2021,55,24765,50180,3462885,3508467,3821,7.574,4363,8.648,455134,102001,353133,2.907,12.972,543659,131231,412428,3.740,15.496,-88525,-2.523,25.945,818,951,18439
2021,56,304073,380910,11532442,11619687,53320,14.148,45266,12.011,1832014,553637,1278377,4.765,15.766,2000488,433132,1567356,3.728,17.216,-168474,-1.450,31.533,27511,27737,190957
2021,61,86933,98563,3432239,3595677,10896,11.003,11823,11.939,219233,67564,151669,1.879,6.097,545701,75898,469803,2.111,15.177,-326468,-9.079,12.194,7719,7894,45580
2021,62,613494,883128,20700670,20971645,85690,9.794,69240,7.914,1997060,731553,1265507,3.488,9.523,2539746,580942,1958804,2.770,12.110,-542686,-2.588,19.045,43341,44887,293553
2021,71,106946,120722,1833173,2155711,16509,13.498,19678,16.089,198910,87752,111158,4.071,9.227,842276,135922,706354,6.305,39.072,-643366,-29.845,18.454,12018,12176,75791
2021,72,483456,673983,12165865,13280426,69697,10.286,76896,11.349,1527927,772858,755069,5.820,11.505,3760734,859638,2901096,6.473,28.318,-2232807,-16.813,23.010,47532,49229,475942
2021,81,643472,709846,5127661,5372016,68101,9.574,70966,9.977,571958,246716,325242,4.593,10.647,1061667,259064,802603,4.822,19.763,-489709,-9.116,21.294,45252,46876,161017
2022,11,18541,19265,166810,164747,2312,12.029,2221,11.556,30796,10036,20760,6.092,18.693,26809,8930,17879,5.420,16.273,3987,2.420,32.546,1797,1829,6016
2022,21,15228,21010,505960,492465,2046,9.668,2353,11.118,87837,20248,67589,4.112,17.836,60678,25495,35183,5.177,12.321,27159,5.515,24.643,1460,1528,11923
2022,22,6084,19541,645391,639580,1518,7.835,1186,6.121,70312,19294,51018,3.017,10.993,58946,16594,42352,2.595,9.216,11366,1.777,18.433,308,332,1901
2022,23,669836,687689,7358283,7217295,94650,13.977,73677,10.880,1264646,358065,906581,4.961,17.522,981833,313943,667890,4.350,13.604,282813,3.919,27.208,60359,60496,229858
2022,31-33,222426,268182,12150259,11931515,20868,7.803,19354,7.237,1390059,270697,1119362,2.269,11.650,954300,279857,674443,2.346,7.998,435759,3.652,15.996,14340,14495,120399
2022,42,251542,361091,6128321,6017173,27996,7.733,29907,8.261,852263,217454,634809,3.614,14.164,630252,252663,377589,4.199,10.474,222011,3.690,20.948,19075,20062,113798
2022,44-45,578711,973283,15911746,15721756,91479,9.469,77134,7.984,1988291,600030,1388261,3.817,12.647,1608275,539477,1068798,3.431,10.230,380016,2.417,20.459,49155,52343,254290
2022,48-49,197744,253426,6094732,5900470,46836,19.162,28819,11.791,1007550,292457,715093,4.957,17.076,611483,210179,401304,3.562,10.363,396067,6.712,20.727,21434,21920,110618
2022,51,73746,143284,3515570,3447027,17988,12.552,18046,12.592,660966,163579,497387,4.746,19.175,527049,189930,337119,5.510,15.290,133917,3.885,30.580,8383,9028,68809
2022,52,216408,444806,6774914,6726322,41806,9.387,42941,9.642,1088218,357480,730738,5.315,16.178,986659,406833,579826,6.048,14.669,101559,1.510,29.337,18526,19485,87094
2022,53,293314,391225,2329109,2256406,55023,14.294,42468,11.032,448809,170149,278660,7.541,19.890,301562,141646,159916,6.278,13.365,147247,6.526,26.729,29729,30920,88312
2022,54,726449,825913,10075041,9757437,109842,13.339,104908,12.740,1907758,558616,1349142,5.725,19.552,1268888,611040,657848,6.262,13.004,638870,6.548,26.009,75750,76610,296468
2022,55,24245,49452,3625698,3547723,3509,7.032,4407,8.831,564228,81883,482345,2.308,15.904,409999,120264,289735,3.390,11.557,154229,4.347,23.113,954,988,13219
2022,56,313605,386480,12063529,11727874,52062,13.568,46532,12.127,2399941,534139,1865802,4.554,20.464,1726219,548491,1177728,4.677,14.719,673722,5.745,29.438,31482,32009,239230
2022,61,90985,102288,3707733,3584549,12518,12.454,8972,8.926,445586,67670,377916,1.888,12.431,200282,59524,140758,1.661,5.587,245304,6.843,11.175,6638,6812,37512
2022,62,621495,898537,21139819,20924156,86541,9.717,70784,7.947,2590057,754128,1835929,3.604,12.378,2153578,670546,1483032,3.205,10.292,436479,2.086,20.585,47958,50073,365771
2022,71,114582,128790,2286356,2058808,21247,17.014,13430,10.754,623619,122801,500818,5.965,30.290,171567,69259,102308,3.364,8.333,452052,21.957,16.667,10619,10721,51531
2022,72,505826,699507,13746530,12954164,83414,12.140,58574,8.525,3082015,1003727,2078288,7.748,23.792,1488027,577549,910478,4.458,11.487,1593988,12.305,22.974,42443,44430,375007
2022,81,659719,726759,5463230,5290445,77182,10.746,60169,8.377,945727,278982,666745,5.273,17.876,600276,241370,358906,4.562,11.346,345451,6.530,22.693,46240,47099,171385
