year,pfg_utly,sector,firms,estabs,emp,denom,estabs_entry,estabs_entry_rate,estabs_exit,estabs_exit_rate,job_creation,job_creation_births,job_creation_continuers,job_creation_rate_births,job_creation_rate,job_destruction,job_destruction_deaths,job_destruction_continuers,job_destruction_rate_deaths,job_destruction_rate,net_job_creation,net_job_creation_rate,reallocation_rate,firmdeath_firms,firmdeath_estabs,firmdeath_emp
1978,No Utility Patent Granted,11,20273,20612,158446,152276,3975,19.425,3677,17.969,52956,19737,33219,12.961,34.776,40953,17161,23792,11.270,26.894,12003,7.882,53.788,2689,2714,12044
1978,No Utility Patent Granted,21,18783,21165,388476,379710,3546,17.052,2806,13.494,110449,39111,71338,10.300,29.088,92580,36199,56381,9.533,24.382,17869,4.706,48.764,1745,1781,16701
1978,No Utility Patent Granted,22,5606,10439,577064,561665,857,8.356,492,4.797,74964,18830,56134,3.353,13.347,44251,10767,33484,1.917,7.879,30713,5.468,15.757,214,216,1818
1978,No Utility Patent Granted,23,425719,429676,3763792,3495877,91637,22.236,56514,13.713,1260553,400811,859742,11.465,36.058,723695,259043,464652,7.410,20.701,536858,15.357,41.403,43819,43858,189899
1978,No Utility Patent Granted,31-33,256922,277121,8097426,7813994,32100,11.728,25256,9.228,1453594,354638,1098956,4.538,18.602,886588,359056,527532,4.595,11.346,567006,7.256,22.692,18821,18961,215363
1978,No Utility Patent Granted,42,233323,270748,2974362,2868181,34970,13.138,25827,9.703,627345,196282,431063,6.843,21.873,414981,189395,225586,6.603,14.468,212364,7.404,28.937,18000,18357,104211
1978,No Utility Patent Granted,44-45,740523,936274,8742433,8463565,131271,14.155,113458,12.234,1874821,734882,1139939,8.683,22.152,1320029,589208,730821,6.962,15.597,554792,6.555,31.193,77845,79690,318838
1978,No Utility Patent Granted,48-49,89565,103937,1988676,1910460,17823,17.396,14861,14.505,469029,142971,326058,7.484,24.551,313447,119241,194206,6.241,16.407,155582,8.144,32.814,10901,10950,56777
1978,No Utility Patent Granted,51,38144,49050,1099730,1063397,7452,15.504,5479,11.400,206681,66896,139785,6.291,19.436,134409,63854,70555,6.005,12.640,72272,6.796,25.279,3359,3475,32237
1978,No Utility Patent Granted,52,146025,219631,3753638,3643840,23894,11.095,15354,7.129,615309,147439,467870,4.046,16.886,393174,121076,272098,3.323,10.790,222135,6.096,21.580,8670,8774,37336
1978,No Utility Patent Granted,53,168857,175887,962889,914909,30014,17.405,23139,13.418,279081,113119,165962,12.364,30.504,182165,89459,92706,9.778,19.911,96916,10.593,39.821,18233,18286,58560
1978,No Utility Patent Granted,54,233451,246644,1809600,1712611,41919,17.620,24451,10.277,477177,178167,299010,10.403,27.863,283346,137703,145643,8.041,16.545,193831,11.318,33.089,17440,17708,95273
1978,No Utility Patent Granted,55,17197,23240,968153,940059,2927,12.826,2090,9.158,253249,75992,177257,8.084,26.940,197088,51530,145558,5.482,20.966,56161,5.974,41.931,398,429,4375
1978,No Utility Patent Granted,56,108715,118925,1785126,1654264,25963,22.808,15778,13.861,576836,192573,384263,11.641,34.870,314936,121662,193274,7.354,19.038,261900,15.832,38.076,11925,12006,72382
1978,No Utility Patent Granted,61,30343,32171,1088786,1033934,4388,13.924,3074,9.754,235070,31776,203294,3.073,22.736,126629,63792,62837,6.170,12.247,108441,10.488,24.495,2260,2292,48802
1978,No Utility Patent Granted,62,313872,339659,5726871,5464329,40706,12.339,21203,6.427,989422,283715,705707,5.192,18.107,462854,186765,276089,3.418,8.470,526568,9.636,16.941,14701,14881,108256
1978,No Utility Patent Granted,71,42490,44220,606127,573762,7625,17.731,5192,12.073,157938,56758,101180,9.892,27.527,93389,34336,59053,5.984,16.277,64549,11.250,32.553,3855,3873,22410
1978,No Utility Patent Granted,72,285804,327759,4783488,4512685,60231,18.606,52134,16.105,1432296,731445,700851,16.209,31.739,889474,457679,431795,10.142,19.711,542822,12.029,39.421,38173,38753,300593
1978,No Utility Patent Granted,81,429878,460228,3065029,2920262,61972,13.690,46880,10.356,749138,236809,512329,8.109,25.653,458431,173698,284733,5.948,15.698,290707,9.955,31.397,33765,34111,114262
1978,Utility Patent Granted,11,85,407,27349,26522,36,9.011,21,5.257,4324,833,3491,3.141,16.304,2688,507,2181,1.912,10.135,1636,6.169,20.270,D,D,D
1978,Utility Patent Granted,21,322,3544,320157,330538,402,11.358,393,11.103,54969,18398,36571,5.566,16.630,75805,23797,52008,7.199,22.934,-20836,-6.304,33.260,D,D,D
1978,Utility Patent Granted,22,75,1420,81452,81824,71,4.993,75,5.274,6094,885,5209,1.082,7.448,6933,1684,5249,2.058,8.473,-839,-1.025,14.895,D,D,D
1978,Utility Patent Granted,23,590,2310,332135,326757,201,8.673,216,9.320,76716,20911,55805,6.400,23.478,64838,14427,50411,4.415,19.843,11878,3.635,39.686,14,14,136
1978,Utility Patent Granted,31-33,6987,34790,10227188,10078959,1516,4.348,1673,4.798,953963,151552,802411,1.504,9.465,659706,169869,489837,1.685,6.545,294257,2.920,13.091,172,174,8775
1978,Utility Patent Granted,42,2467,35630,852088,835653,3524,10.009,2684,7.623,166345,62827,103518,7.518,19.906,133846,57890,75956,6.928,16.017,32499,3.889,32.034,36,37,1307
1978,Utility Patent Granted,44-45,1027,64510,1198253,1158321,5176,8.069,4445,6.930,218749,81396,137353,7.027,18.885,138467,51699,86768,4.463,11.954,80282,6.931,23.908,19,21,116
1978,Utility Patent Granted,48-49,745,6621,443704,430934,639,9.839,386,5.943,76732,24407,52325,5.664,17.806,49883,17346,32537,4.025,11.576,26849,6.230,23.151,3,3,44
1978,Utility Patent Granted,51,319,13934,1064606,1044239,466,3.325,632,4.509,167415,16145,151270,1.546,16.032,124749,16594,108155,1.589,11.946,42666,4.086,23.893,3,3,10
1978,Utility Patent Granted,52,333,14172,352126,338500,1267,9.096,780,5.600,64668,20109,44559,5.941,19.104,37698,13864,23834,4.096,11.137,26970,7.968,22.274,9,9,78
1978,Utility Patent Granted,53,407,2202,61559,64969,599,29.653,235,11.634,14415,9014,5401,13.874,22.188,20978,6266,14712,9.645,32.289,-6563,-10.102,44.375,14,15,33
1978,Utility Patent Granted,54,1226,3441,408043,402850,426,12.422,403,11.751,57617,19319,38298,4.796,14.302,47363,11897,35466,2.953,11.757,10254,2.545,23.514,43,43,333
1978,Utility Patent Granted,55,1796,12888,1460582,1422569,1017,7.870,1087,8.411,271396,62911,208485,4.422,19.078,194575,46267,148308,3.252,13.678,76821,5.400,27.355,D,D,D
1978,Utility Patent Granted,56,424,2946,176798,180149,469,16.387,301,10.517,43548,14329,29219,7.954,24.173,51201,11509,39692,6.389,28.422,-7653,-4.248,48.347,13,13,68
1978,Utility Patent Granted,61,89,253,193451,177703,70,30.435,24,10.435,37163,1678,35485,0.944,20.913,7193,524,6669,0.295,4.048,29970,16.865,8.096,0,0,0
1978,Utility Patent Granted,62,122,1009,118693,115375,153,15.789,73,7.534,17715,7971,9744,6.909,15.354,11306,6105,5201,5.291,9.799,6409,5.555,19.599,D,D,D
1978,Utility Patent Granted,71,123,486,44816,41026,44,9.205,28,5.858,10274,3368,6906,8.209,25.043,2719,1486,1233,3.622,6.628,7555,18.415,13.255,D,D,D
1978,Utility Patent Granted,72,227,14282,434670,423713,1467,10.409,1091,7.741,85579,45786,39793,10.806,20.197,63209,26919,36290,6.353,14.918,22370,5.280,29.836,4,4,126
1978,Utility Patent Granted,81,459,3601,99705,100354,307,8.664,192,5.418,14382,4348,10034,4.333,14.331,15226,5822,9404,5.801,15.172,-844,-0.841,28.663,7,7,30
1979,No Utility Patent Granted,11,19936,20198,158744,158844,3588,17.746,3630,17.953,47396,18858,28538,11.872,29.838,47802,20350,27452,12.811,30.094,-406,-0.256,59.676,2617,2661,13906
1979,No Utility Patent Granted,21,19532,21917,449911,418918,3846,17.971,2815,13.153,135985,37936,98049,9.056,32.461,74536,31693,42843,7.565,17.793,61449,14.669,35.585,1863,1880,19065
1979,No Utility Patent Granted,22,5868,10604,589119,578063,724,6.910,470,4.486,55446,19747,35699,3.416,9.592,33562,6542,27020,1.132,5.806,21884,3.786,11.612,212,212,890
1979,No Utility Patent Granted,23,447704,451707,4234476,4018044,84589,19.172,63587,14.412,1310931,381796,929135,9.502,32.626,878778,296076,582702,7.369,21.871,432153,10.755,43.742,49595,49626,224211
1979,No Utility Patent Granted,31-33,254562,275115,8465006,8286583,29839,10.890,27611,10.077,1384999,349598,1035401,4.219,16.714,1027588,384537,643051,4.640,12.401,357411,4.313,24.801,19146,19323,211474
1979,No Utility Patent Granted,42,245060,283654,3212251,3122304,32373,11.560,25166,8.986,595041,169105,425936,5.416,19.058,414649,156381,258268,5.009,13.280,180392,5.778,26.560,17727,18040,94706
1979,No Utility Patent Granted,44-45,752545,962706,9368001,9179139,119951,12.574,102412,10.736,1714238,671854,1042384,7.319,18.675,1329325,490140,839185,5.340,14.482,384913,4.193,28.964,73264,74904,302770
1979,No Utility Patent Granted,48-49,93117,107782,2166355,2091723,18495,17.526,13988,13.255,433478,131189,302289,6.272,20.723,282855,90963,191892,4.349,13.523,150623,7.201,27.045,10730,10772,54875
1979,No Utility Patent Granted,51,40401,52609,1198912,1162713,7735,15.017,5531,10.738,209262,70209,139053,6.038,17.998,136017,52137,83880,4.484,11.698,73245,6.299,23.396,3389,3418,25881
1979,No Utility Patent Granted,52,152129,230403,4060307,3903358,24889,11.055,14365,6.380,673284,177646,495638,4.551,17.249,360693,95978,264715,2.459,9.241,312591,8.008,18.481,8965,9017,36995
1979,No Utility Patent Granted,53,178694,186492,1057517,1019048,31128,17.052,23235,12.728,283876,117066,166810,11.488,27.857,206721,91231,115490,8.953,20.286,77155,7.571,40.571,18436,18487,63346
1979,No Utility Patent Granted,54,251418,265315,2016149,1916924,44100,17.186,26670,10.394,474996,178149,296847,9.293,24.779,275789,115088,160701,6.004,14.387,199207,10.392,28.774,19636,19833,78947
1979,No Utility Patent Granted,55,18272,24705,1056883,1016968,3011,12.479,1857,7.696,220749,79161,141588,7.784,21.707,140684,38132,102552,3.750,13.834,80065,7.873,27.667,424,429,4563
1979,No Utility Patent Granted,56,118439,129541,1994460,1894419,27344,22.028,16527,13.314,558765,186459,372306,9.843,29.495,359936,121350,238586,6.406,19.000,198829,10.496,38.000,12666,12741,76627
1979,No Utility Patent Granted,61,31178,32997,1102413,1064434,4169,12.818,3224,9.913,171391,28772,142619,2.703,16.102,94729,22752,71977,2.137,8.899,76662,7.202,17.799,2436,2471,14783
1979,No Utility Patent Granted,62,330070,357860,6061358,5888092,38554,11.043,21089,6.040,850031,259326,590705,4.404,14.436,505756,173501,332255,2.947,8.589,344275,5.847,17.179,15362,15543,115817
1979,No Utility Patent Granted,71,44687,46430,642801,625717,7721,17.027,5554,12.248,147499,49871,97628,7.970,23.573,113709,37107,76602,5.930,18.173,33790,5.400,36.345,4109,4133,27248
1979,No Utility Patent Granted,72,292131,338013,5105905,4975673,57370,17.171,49560,14.834,1301310,672879,628431,13.523,26.153,1046777,438253,608524,8.808,21.038,254533,5.116,42.076,36302,36828,294741
1979,No Utility Patent Granted,81,443499,474813,3233468,3151624,59626,12.747,45515,9.730,665358,222431,442927,7.058,21.112,501935,165043,336892,5.237,15.926,163423,5.185,31.852,33669,33994,116357
1979,Utility Patent Granted,11,91,435,27150,27704,24,5.543,20,4.619,2578,579,1999,2.090,9.306,3699,257,3442,0.928,13.352,-1121,-4.046,18.611,D,D,D
1979,Utility Patent Granted,21,321,3674,369797,346356,344,9.425,296,8.110,82632,15724,66908,4.540,23.858,35309,13913,21396,4.017,10.194,47323,13.663,20.389,5,5,36
1979,Utility Patent Granted,22,79,1527,94617,93948,65,4.243,75,4.896,7085,1840,5245,1.959,7.541,5920,1523,4397,1.621,6.301,1165,1.240,12.603,D,D,D
1979,Utility Patent Granted,23,569,2271,348194,337214,212,9.374,193,8.534,73439,8824,64615,2.617,21.778,50279,9598,40681,2.846,14.910,23160,6.868,29.820,10,10,76
1979,Utility Patent Granted,31-33,6568,34630,10648245,10446743,1614,4.659,1642,4.740,1061025,163202,897823,1.562,10.157,653660,166029,487631,1.589,6.257,407365,3.899,12.514,148,155,9495
1979,Utility Patent Granted,42,2435,35706,875634,860832,3246,9.128,2958,8.318,161156,66605,94551,7.737,18.721,132093,53140,78953,6.173,15.345,29063,3.376,30.690,40,46,439
1979,Utility Patent Granted,44-45,1010,57644,1054109,1027175,3932,6.798,4326,7.479,169042,70238,98804,6.838,16.457,116807,42030,74777,4.092,11.372,52235,5.085,22.743,20,20,247
1979,Utility Patent Granted,48-49,713,6905,432404,423730,554,8.099,425,6.213,62707,17389,45318,4.104,14.799,46138,12460,33678,2.941,10.889,16569,3.910,21.777,D,D,D
1979,Utility Patent Granted,51,313,12283,1081451,1065598,306,2.443,794,6.338,202326,11457,190869,1.075,18.987,171159,30833,140326,2.893,16.062,31167,2.925,32.125,7,7,95
1979,Utility Patent Granted,52,315,16039,392783,382292,1673,10.831,488,3.159,51329,17509,33820,4.580,13.427,30072,5686,24386,1.487,7.866,21257,5.560,15.732,5,5,86
1979,Utility Patent Granted,53,390,2612,68346,59886,1004,45.803,164,7.482,24223,7827,16396,13.070,40.449,7781,3960,3821,6.613,12.993,16442,27.455,25.986,4,4,29
1979,Utility Patent Granted,54,1198,3261,431629,421219,377,11.776,258,8.059,62099,15918,46181,3.779,14.743,40627,11087,29540,2.632,9.645,21472,5.098,19.290,34,34,287
1979,Utility Patent Granted,55,1754,13068,1517028,1484957,1294,10.013,1005,7.777,242886,65426,177460,4.406,16.356,176992,40142,136850,2.703,11.919,65894,4.437,23.838,0,0,0
1979,Utility Patent Granted,56,439,3074,215861,195172,453,15.335,213,7.211,69761,23867,45894,12.229,35.743,27441,7382,20059,3.782,14.060,42320,21.683,28.120,8,8,75
1979,Utility Patent Granted,61,89,271,219680,206069,29,11.111,9,3.448,33640,679,32961,0.330,16.325,6056,51,6005,0.025,2.939,27584,13.386,5.878,D,D,D
1979,Utility Patent Granted,62,139,1164,139822,134439,187,16.832,81,7.291,22089,6882,15207,5.119,16.431,11255,2897,8358,2.155,8.372,10834,8.059,16.744,D,D,D
1979,Utility Patent Granted,71,110,463,59872,51892,24,5.123,35,7.471,23310,1800,21510,3.469,44.920,6572,1485,5087,2.862,12.665,16738,32.255,25.330,3,3,3
1979,Utility Patent Granted,72,213,13790,439393,421295,1468,10.919,776,5.772,92803,40597,52206,9.636,22.028,54904,20107,34797,4.773,13.032,37899,8.996,26.064,3,3,3
1979,Utility Patent Granted,81,478,3984,105774,104010,314,7.917,278,7.010,15454,4973,10481,4.781,14.858,12025,3806,8219,3.659,11.561,3429,3.297,23.123,6,7,34
1980,No Utility Patent Granted,11,19888,20157,159534,160074,3257,16.115,3364,16.645,41908,15656,26252,9.780,26.180,43149,14765,28384,9.224,26.956,-1241,-0.775,52.361,2580,2580,10798
1980,No Utility Patent Granted,21,20805,23259,481956,469894,4023,17.777,2767,12.227,115217,43048,72169,9.161,24.520,91078,32899,58179,7.001,19.383,24139,5.137,38.765,1986,2028,21628
1980,No Utility Patent Granted,22,5877,10553,590424,584029,522,4.967,436,4.148,34413,8511,25902,1.457,5.892,21859,5841,16018,1.000,3.743,12554,2.150,7.486,279,281,1162
1980,No Utility Patent Granted,23,439307,443006,4123655,4175537,71177,15.919,79381,17.754,1048376,317021,731355,7.592,25.108,1152824,341062,811762,8.168,27.609,-104448,-2.501,50.215,61242,61269,259154
1980,No Utility Patent Granted,31-33,259172,279882,8348408,8410610,30872,11.128,25964,9.359,1134659,337394,797265,4.012,13.491,1258391,383133,875258,4.555,14.962,-123732,-1.471,26.982,19768,19909,230851
1980,No Utility Patent Granted,42,250571,289097,3244237,3232220,31673,11.043,27097,9.448,512844,161129,351715,4.985,15.867,488167,164394,323773,5.086,15.103,24677,0.763,30.206,19340,19672,100030
1980,No Utility Patent Granted,44-45,750990,968600,9286355,9353762,111616,11.548,107531,11.125,1463293,638611,824682,6.827,15.644,1593310,515385,1077925,5.510,17.034,-130017,-1.390,31.288,76677,78762,321495
1980,No Utility Patent Granted,48-49,93720,109035,2145219,2161632,17036,15.687,16165,14.885,341740,117744,223996,5.447,15.809,374716,100445,274271,4.647,17.335,-32976,-1.526,31.619,12619,12692,61656
1980,No Utility Patent Granted,51,42402,54980,1251365,1225332,8159,15.168,5781,10.747,205059,70979,134080,5.793,16.735,153421,58153,95268,4.746,12.521,51638,4.214,25.042,3808,3898,31730
1980,No Utility Patent Granted,52,154532,235966,4271545,4183684,21963,9.412,16711,7.162,574338,158137,416201,3.780,13.728,398329,116024,282305,2.773,9.521,176009,4.207,19.042,10450,10535,46696
1980,No Utility Patent Granted,53,178698,186368,1055418,1058017,28192,15.119,28393,15.227,253186,105173,148013,9.941,23.930,257623,111684,145939,10.556,24.350,-4437,-0.419,47.860,22624,22688,78273
1980,No Utility Patent Granted,54,264283,278532,2115697,2066009,44130,16.227,30975,11.390,439001,168124,270877,8.138,21.249,338985,127742,211243,6.183,16.408,100016,4.841,32.815,22943,23079,88432
1980,No Utility Patent Granted,55,18800,25733,1092527,1071345,2771,10.955,1892,7.480,196263,68129,128134,6.359,18.319,153715,40997,112718,3.827,14.348,42548,3.971,28.696,564,588,6432
1980,No Utility Patent Granted,56,126555,138307,2088060,2040112,27544,20.575,18671,13.947,518529,187316,331213,9.182,25.417,422961,120343,302618,5.899,20.732,95568,4.684,41.464,14440,14496,78766
1980,No Utility Patent Granted,61,31455,33304,1165079,1146249,3692,11.138,3379,10.194,140724,21863,118861,1.907,12.277,103728,22099,81629,1.928,9.049,36996,3.228,18.099,2655,2674,15672
1980,No Utility Patent Granted,62,344166,373492,6225964,6117910,39469,10.800,23369,6.395,763565,244655,518910,3.999,12.481,546339,178082,368257,2.911,8.930,217226,3.551,17.860,16955,17138,115851
1980,No Utility Patent Granted,71,46195,47951,653422,648488,7542,15.980,6031,12.779,137677,48941,88736,7.547,21.230,128238,40303,87935,6.215,19.775,9439,1.456,39.550,4517,4537,27149
1980,No Utility Patent Granted,72,291716,340717,5227144,5191541,53948,15.877,52100,15.333,1218852,641916,576936,12.365,23.478,1150788,460295,690493,8.866,22.167,68064,1.311,44.333,38584,39168,309479
1980,No Utility Patent Granted,81,447253,479639,3238850,3236794,55010,11.527,50196,10.518,569662,200229,369433,6.186,17.600,565544,170851,394693,5.278,17.472,4118,0.127,34.945,37562,37847,123164
1980,Utility Patent Granted,11,91,429,27710,27450,25,5.807,28,6.504,3641,657,2984,2.393,13.264,3156,467,2689,1.701,11.497,485,1.767,22.995,D,D,D
1980,Utility Patent Granted,21,318,3637,374091,369927,334,9.214,310,8.552,57798,13434,44364,3.632,15.624,49280,12688,36592,3.430,13.322,8518,2.303,26.643,D,D,D
1980,Utility Patent Granted,22,79,1662,108565,107090,54,3.244,59,3.545,8596,2765,5831,2.582,8.027,5573,2015,3558,1.882,5.204,3023,2.823,10.408,0,0,0
1980,Utility Patent Granted,23,568,2336,302093,309451,178,7.517,242,10.220,46637,6666,39971,2.154,15.071,60898,11227,49671,3.628,19.679,-14261,-4.608,30.142,13,13,215
1980,Utility Patent Granted,31-33,6313,34078,10374760,10480706,1501,4.383,1834,5.356,835996,164027,671969,1.565,7.977,1054651,213514,841137,2.037,10.063,-218655,-2.086,15.953,139,143,8205
1980,Utility Patent Granted,42,2433,36104,888981,886978,3123,8.687,2817,7.836,127222,48181,79041,5.432,14.343,123846,56889,66957,6.414,13.963,3376,0.381,27.925,37,37,483
1980,Utility Patent Granted,44-45,979,56296,1001426,1007144,3620,6.427,3686,6.544,119379,64022,55357,6.357,11.853,131468,38004,93464,3.773,13.054,-12089,-1.200,23.706,22,49,484
1980,Utility Patent Granted,48-49,712,6695,416397,419722,513,7.774,320,4.850,43094,11625,31469,2.770,10.267,49405,11605,37800,2.765,11.771,-6311,-1.504,20.535,D,D,D
1980,Utility Patent Granted,51,314,12377,1097162,1086119,296,2.401,202,1.638,280591,13474,267117,1.241,25.834,257755,9710,248045,0.894,23.732,22836,2.103,47.463,7,7,114
1980,Utility Patent Granted,52,308,15727,385078,376982,1284,8.151,1334,8.469,58017,24473,33544,6.492,15.390,42498,14792,27706,3.924,11.273,15519,4.117,22.546,7,7,44
1980,Utility Patent Granted,53,389,2896,61876,62639,521,19.105,183,6.711,12618,5118,7500,8.171,20.144,14238,4564,9674,7.286,22.730,-1620,-2.586,40.288,10,10,23
1980,Utility Patent Granted,54,1220,3467,465792,454097,455,13.442,291,8.597,59268,16814,42454,3.703,13.052,36126,11149,24977,2.455,7.956,23142,5.096,15.911,43,45,447
1980,Utility Patent Granted,55,1755,13163,1556806,1536628,1203,9.223,963,7.383,221251,54030,167221,3.516,14.398,178986,55859,123127,3.635,11.648,42265,2.751,23.296,4,4,85
1980,Utility Patent Granted,56,449,3259,228722,225769,318,9.779,304,9.348,38981,12777,26204,5.659,17.266,33227,10571,22656,4.682,14.717,5754,2.549,29.435,13,18,362
1980,Utility Patent Granted,61,92,277,217117,212418,23,8.410,16,5.850,17607,218,17389,0.103,8.289,8270,343,7927,0.161,3.893,9337,4.396,7.787,D,D,D
1980,Utility Patent Granted,62,141,1203,177568,169765,128,10.926,65,5.548,27994,7444,20550,4.385,16.490,12268,2634,9634,1.552,7.226,15726,9.263,14.453,3,3,8
1980,Utility Patent Granted,71,101,668,64002,62346,241,42.806,31,5.506,6746,1923,4823,3.084,10.820,3101,667,2434,1.070,4.974,3645,5.846,9.948,D,D,D
1980,Utility Patent Granted,72,211,13658,419982,406275,1583,11.867,946,7.092,86449,52194,34255,12.847,21.278,58206,24141,34065,5.942,14.327,28243,6.952,28.654,8,8,37
1980,Utility Patent Granted,81,493,4233,114770,113020,386,9.211,301,7.183,16300,5458,10842,4.829,14.422,12942,3659,9283,3.237,11.451,3358,2.971,22.902,7,7,36
1981,No Utility Patent Granted,11,19131,19392,152929,155775,2779,14.085,3455,17.511,38999,14160,24839,9.090,25.035,44716,18040,26676,11.581,28.706,-5717,-3.670,50.071,2486,2489,11514
1981,No Utility Patent Granted,21,23601,26212,548842,511463,5780,23.380,2799,11.322,161836,64553,97283,12.621,31.642,86102,35643,50459,6.969,16.834,75734,14.807,33.669,2071,2089,24337
1981,No Utility Patent Granted,22,5882,10637,592661,583420,577,5.468,407,3.857,35507,7084,28423,1.214,6.086,17345,4432,12913,0.760,2.973,18162,3.113,5.946,257,258,1349
1981,No Utility Patent Granted,23,420372,423989,3931678,4018694,62010,14.310,80727,18.629,974689,295012,679677,7.341,24.254,1147019,335887,811132,8.358,28.542,-172330,-4.288,48.508,60911,60946,257171
1981,No Utility Patent Granted,31-33,267129,288437,8227953,8290953,33874,11.919,25399,8.937,1158094,449260,708834,5.419,13.968,1283304,360088,923216,4.343,15.478,-125210,-1.510,27.936,19550,19682,223201
1981,No Utility Patent Granted,42,256781,296713,3315078,3277581,35110,11.994,27166,9.280,565967,220943,345024,6.741,17.268,491635,164264,327371,5.012,15.000,74332,2.268,30.000,20325,20735,107076
1981,No Utility Patent Granted,44-45,742389,965502,8880554,8908256,109892,11.397,107370,11.135,1435046,635270,799776,7.131,16.109,1489328,511454,977874,5.741,16.719,-54282,-0.609,32.218,77926,80652,330219
1981,No Utility Patent Granted,48-49,93109,108777,2067584,2098052,16041,14.755,15918,14.642,302035,113964,188071,5.432,14.396,363181,106778,256403,5.089,17.310,-61146,-2.914,28.792,12375,12423,64419
1981,No Utility Patent Granted,51,45107,58182,1332536,1289639,9180,16.230,5943,10.507,256387,87841,168546,6.811,19.881,173436,59568,113868,4.619,13.448,82951,6.432,26.897,4121,4197,33449
1981,No Utility Patent Granted,52,156278,239202,4437821,4314609,23244,9.828,17869,7.555,684576,201243,483333,4.664,15.866,438407,155027,283380,3.593,10.161,246169,5.705,20.322,11336,11438,66263
1981,No Utility Patent Granted,53,175865,184966,1083918,1069480,26592,14.305,28454,15.306,255981,114621,141360,10.717,23.935,227734,96316,131418,9.006,21.294,28247,2.641,42.588,22595,22717,70056
1981,No Utility Patent Granted,54,276531,291838,2258093,2182652,47075,16.519,33343,11.700,491351,204405,286946,9.365,22.512,339505,127315,212190,5.833,15.555,151846,6.957,31.109,25202,25377,89865
1981,No Utility Patent Granted,55,19688,27121,1142569,1115895,3227,12.237,1725,6.542,216855,80424,136431,7.207,19.433,161901,33308,128593,2.985,14.509,54954,4.925,29.017,560,571,5749
1981,No Utility Patent Granted,56,134094,146529,2108375,2085046,28608,20.100,20201,14.194,504688,196174,308514,9.409,24.205,458537,137921,320616,6.615,21.992,46151,2.213,43.983,15679,15791,91163
1981,No Utility Patent Granted,61,31844,33748,1239321,1211516,3733,11.115,3407,10.144,156996,25438,131558,2.100,12.959,100965,21655,79310,1.787,8.334,56031,4.625,16.668,2638,2662,14299
1981,No Utility Patent Granted,62,360499,392182,6620611,6437171,43125,11.267,24288,6.345,901478,322781,578697,5.014,14.004,531541,178358,353183,2.771,8.257,369937,5.747,16.515,18021,18202,122728
1981,No Utility Patent Granted,71,47735,49565,681517,668425,7822,16.051,6157,12.634,146133,58189,87944,8.705,21.862,119642,36184,83458,5.413,17.899,26491,3.963,35.798,4581,4602,25217
1981,No Utility Patent Granted,72,292199,344016,5345650,5295973,54235,15.838,51063,14.912,1188972,658919,530053,12.442,22.450,1089293,441080,648213,8.329,20.568,99679,1.882,41.137,38383,39124,313740
1981,No Utility Patent Granted,81,447735,481144,3289191,3264465,53953,11.234,52192,10.867,597257,218883,378374,6.705,18.296,548483,183212,365271,5.612,16.802,48774,1.494,33.603,38646,39088,134456
1981,Utility Patent Granted,11,88,420,26098,26824,31,7.355,34,8.066,2522,617,1905,2.300,9.402,4010,1336,2674,4.981,14.950,-1488,-5.547,18.804,0,0,0
1981,Utility Patent Granted,21,304,3785,408338,395894,396,10.566,322,8.591,70668,15303,55365,3.865,17.850,46036,12211,33825,3.084,11.628,24632,6.222,23.257,3,3,49
1981,Utility Patent Granted,22,75,1656,129770,128677,51,3.071,60,3.613,8520,2398,6122,1.864,6.621,6129,1986,4143,1.543,4.763,2391,1.858,9.526,D,D,D
1981,Utility Patent Granted,23,525,2483,343911,330700,253,10.346,178,7.279,72295,15924,56371,4.815,21.861,45253,6950,38303,2.102,13.684,27042,8.177,27.368,19,19,260
1981,Utility Patent Granted,31-33,6247,33771,9948692,10152498,1629,4.812,1787,5.279,736579,196422,540157,1.935,7.255,1144432,249028,895404,2.453,11.272,-407853,-4.017,14.510,152,169,8466
1981,Utility Patent Granted,42,2399,36687,900883,893025,3285,9.020,2747,7.543,144454,58111,86343,6.507,16.176,128004,44198,83806,4.949,14.334,16450,1.842,28.668,47,68,802
1981,Utility Patent Granted,44-45,978,63487,1347284,1348042,6812,10.972,4007,6.454,180319,101782,78537,7.550,13.376,181288,40280,141008,2.988,13.448,-969,-0.072,26.753,21,21,255
1981,Utility Patent Granted,48-49,740,7214,435724,437913,636,8.961,403,5.678,47386,14446,32940,3.299,10.821,51325,9841,41484,2.247,11.720,-3939,-0.899,21.642,3,3,164
1981,Utility Patent Granted,51,316,12120,1113184,1107706,228,1.860,500,4.080,237026,8288,228738,0.748,21.398,227682,10542,217140,0.952,20.554,9344,0.844,41.109,7,7,62
1981,Utility Patent Granted,52,307,17560,471125,461377,1534,8.673,1788,10.109,72178,26585,45593,5.762,15.644,54285,19027,35258,4.124,11.766,17893,3.878,23.532,3,3,17
1981,Utility Patent Granted,53,388,2113,57270,56553,267,12.892,183,8.836,11503,5045,6458,8.921,20.340,9763,4655,5108,8.231,17.264,1740,3.077,34.527,10,10,95
1981,Utility Patent Granted,54,1260,3793,496020,484870,504,13.653,301,8.154,68700,12851,55849,2.650,14.169,46098,11209,34889,2.312,9.507,22602,4.661,19.015,42,43,433
1981,Utility Patent Granted,55,1775,14238,1625725,1597289,1707,12.302,982,7.077,240776,76874,163902,4.813,15.074,184591,33171,151420,2.077,11.557,56185,3.518,23.113,5,5,88
1981,Utility Patent Granted,56,507,3728,245215,247386,476,13.166,251,6.942,44845,17644,27201,7.132,18.128,48377,7606,40771,3.075,19.555,-3532,-1.428,36.255,9,9,47
1981,Utility Patent Granted,61,83,287,210553,207354,25,9.009,6,2.162,9832,160,9672,0.077,4.742,3370,278,3092,0.134,1.625,6462,3.116,3.250,0,0,0
1981,Utility Patent Granted,62,148,1239,171040,170050,130,10.788,62,5.145,19620,7482,12138,4.400,11.538,16950,2149,14801,1.264,9.968,2670,1.570,19.935,3,3,31
1981,Utility Patent Granted,71,104,698,63799,63554,67,9.867,29,4.271,5529,1641,3888,2.582,8.700,4857,1071,3786,1.685,7.642,672,1.057,15.285,0,0,0
1981,Utility Patent Granted,72,210,13796,413142,405973,1333,9.818,895,6.592,66273,37731,28542,9.294,16.324,52165,18543,33622,4.568,12.849,14108,3.475,25.699,7,7,30
1981,Utility Patent Granted,81,506,4254,115659,115137,420,9.807,477,11.138,18177,5586,12591,4.852,15.787,17228,5696,11532,4.947,14.963,949,0.824,29.926,9,9,65
1982,No Utility Patent Granted,11,17876,18168,145640,147636,2571,13.818,3447,18.526,40633,15778,24855,10.687,27.522,44554,16316,28238,11.052,30.178,-3921,-2.656,55.045,2415,2420,11377
1982,No Utility Patent Granted,21,26054,28844,587934,563945,6139,22.270,3584,13.001,171680,65987,105693,11.701,30.443,124616,48064,76552,8.523,22.097,47064,8.345,44.194,2751,2771,32185
1982,No Utility Patent Granted,22,5782,10563,570358,562028,419,3.965,426,4.032,35781,6336,29445,1.127,6.366,19221,4119,15102,0.733,3.420,16560,2.946,6.840,282,282,1590
1982,No Utility Patent Granted,23,388499,392549,3552568,3720850,54003,13.266,83035,20.398,858771,256799,601972,6.902,23.080,1196111,358361,837750,9.631,32.146,-337340,-9.066,46.160,58273,58306,267213
1982,No Utility Patent Granted,31-33,268071,289510,7942764,8090492,29382,10.157,28901,9.991,1042885,303891,738994,3.756,12.890,1337737,385198,952539,4.761,16.535,-294852,-3.644,25.781,22289,22445,249009
1982,No Utility Patent Granted,42,260694,301322,3314652,3315287,34472,11.496,31570,10.528,561234,185596,375638,5.598,16.929,562848,186129,376719,5.614,16.977,-1614,-0.049,33.857,22993,23381,126993
1982,No Utility Patent Granted,44-45,725559,947442,8681086,8727901,107755,11.310,118354,12.422,1472125,606907,865218,6.954,16.867,1562222,571607,990615,6.549,17.899,-90097,-1.032,33.734,85224,87867,361886
1982,No Utility Patent Granted,48-49,91703,108027,2043132,2074587,15586,14.392,16127,14.891,291849,93620,198229,4.513,14.068,354126,100450,253676,4.842,17.070,-62277,-3.002,28.136,12445,12539,66908
1982,No Utility Patent Granted,51,46293,59600,1318872,1314090,8911,15.213,6864,11.718,218191,80097,138094,6.095,16.604,207650,57618,150032,4.385,15.802,10541,0.802,31.604,4915,4994,37979
1982,No Utility Patent Granted,52,156214,239945,4312741,4256711,21356,8.936,19433,8.132,566958,158232,408726,3.717,13.319,452833,133915,318918,3.146,10.638,114125,2.681,21.276,12768,12890,69559
1982,No Utility Patent Granted,53,168843,177584,1059460,1068050,24407,13.532,29970,16.616,238192,98883,139309,9.258,22.302,254594,105843,148751,9.910,23.837,-16402,-1.536,44.603,23796,23874,80399
1982,No Utility Patent Granted,54,278299,293879,2169003,2129758,47894,16.554,38787,13.406,491462,202338,289124,9.501,23.076,415495,158356,257139,7.435,19.509,75967,3.567,39.018,29485,29646,119839
1982,No Utility Patent Granted,55,20307,27870,1193483,1168739,2994,10.930,2041,7.451,248562,97941,150621,8.380,21.268,196437,44129,152308,3.776,16.808,52125,4.460,33.615,637,650,8409
1982,No Utility Patent Granted,56,145582,159369,2213371,2182338,29889,19.216,22238,14.297,546969,191756,355213,8.787,25.063,485505,156750,328755,7.183,22.247,61464,2.816,44.494,17122,17180,100284
1982,No Utility Patent Granted,61,31584,33826,1271133,1264552,3659,10.836,3544,10.495,143853,26446,117407,2.091,11.376,131043,22529,108514,1.782,10.363,12810,1.013,20.726,2731,2743,15132
1982,No Utility Patent Granted,62,374859,409162,6840315,6726340,44204,11.008,28996,7.221,892194,298604,593590,4.439,13.264,664315,202257,462058,3.007,9.876,227879,3.388,19.753,22086,22324,149035
1982,No Utility Patent Granted,71,48830,50935,704945,693009,8653,17.233,7205,14.349,155195,56411,98784,8.140,22.394,131233,42865,88368,6.185,18.937,23962,3.458,37.873,5490,5513,33586
1982,No Utility Patent Granted,72,288070,341298,5357092,5338705,52275,15.285,53702,15.702,1224900,637686,587214,11.945,22.944,1186555,491419,695136,9.205,22.226,38345,0.718,44.451,41513,42175,347883
1982,No Utility Patent Granted,81,449538,484188,3341496,3326470,55056,11.386,53730,11.112,624977,215603,409374,6.481,18.788,592562,182486,410076,5.486,17.814,32415,0.974,35.627,39560,39854,132428
1982,Utility Patent Granted,11,80,446,24087,24794,29,6.554,22,4.972,2097,300,1797,1.210,8.458,3445,307,3138,1.238,13.895,-1348,-5.437,16.916,0,0,0
1982,Utility Patent Granted,21,314,3967,427415,423003,647,16.656,482,12.408,87478,24558,62920,5.806,20.680,78356,24892,53464,5.885,18.524,9122,2.156,37.047,3,3,19
1982,Utility Patent Granted,22,77,1677,177240,173490,30,1.798,13,0.779,12149,1125,11024,0.648,7.003,5010,673,4337,0.388,2.888,7139,4.115,5.776,0,0,0
1982,Utility Patent Granted,23,509,2559,338195,336234,290,11.390,264,10.369,65295,8614,56681,2.562,19.420,61799,11516,50283,3.425,18.380,3496,1.040,36.760,15,15,131
1982,Utility Patent Granted,31-33,6344,33848,9390391,9697865,1353,3.958,2019,5.907,633051,148448,484603,1.531,6.528,1248286,221378,1026908,2.283,12.872,-615235,-6.344,13.055,167,179,5468
1982,Utility Patent Granted,42,2489,36846,895461,905354,3411,9.212,3776,10.198,168148,61046,107102,6.743,18.573,188891,67873,121018,7.497,20.864,-20743,-2.291,37.145,52,61,871
1982,Utility Patent Granted,44-45,955,76729,1455302,1453692,11557,15.687,5442,7.387,229107,110336,118771,7.590,15.760,228114,55370,172744,3.809,15.692,993,0.068,31.384,23,33,122
1982,Utility Patent Granted,48-49,767,7498,395844,398799,903,12.409,461,6.335,54139,21360,32779,5.356,13.576,60278,9973,50305,2.501,15.115,-6139,-1.539,27.151,4,4,10
1982,Utility Patent Granted,51,357,12558,1132921,1132603,387,3.102,223,1.787,107851,17667,90184,1.560,9.522,109226,9273,99953,0.819,9.644,-1375,-0.121,19.045,D,D,D
1982,Utility Patent Granted,52,317,16767,454281,467621,915,5.230,2369,13.542,46867,19082,27785,4.081,10.022,73729,27264,46465,5.830,15.767,-26862,-5.744,20.045,3,3,20
1982,Utility Patent Granted,53,417,3330,64509,65753,296,9.009,207,6.300,10969,4188,6781,6.369,16.682,13335,4439,8896,6.751,20.280,-2366,-3.598,33.364,7,7,22
1982,Utility Patent Granted,54,1128,4266,490807,491064,614,14.779,391,9.411,82926,28073,54853,5.717,16.887,83288,30176,53112,6.145,16.961,-362,-0.074,33.774,44,44,2303
1982,Utility Patent Granted,55,1824,14950,1614148,1625320,1666,11.296,1264,8.570,273921,84934,188987,5.226,16.853,295822,72211,223611,4.443,18.201,-21901,-1.347,33.707,7,7,78
1982,Utility Patent Granted,56,687,4766,346161,347500,515,11.072,286,6.149,57411,17989,39422,5.177,16.521,60080,12634,47446,3.636,17.289,-2669,-0.768,33.042,5,5,95
1982,Utility Patent Granted,61,87,300,223833,219644,44,15.068,28,9.589,13917,698,13219,0.318,6.336,4903,267,4636,0.122,2.232,9014,4.104,4.465,D,D,D
1982,Utility Patent Granted,62,154,1711,245735,237417,206,12.295,135,8.057,30794,13753,17041,5.793,12.970,13604,5546,8058,2.336,5.730,17190,7.240,11.460,6,6,49
1982,Utility Patent Granted,71,127,946,64969,64552,232,27.586,22,2.616,4667,2277,2390,3.527,7.230,3889,549,3340,0.850,6.025,778,1.205,12.049,3,3,6
1982,Utility Patent Granted,72,204,15552,486739,465848,1719,11.204,1300,8.473,120964,47395,73569,10.174,25.966,77710,28642,49068,6.148,16.681,43254,9.285,33.363,10,10,117
1982,Utility Patent Granted,81,547,4054,116069,119104,472,11.666,456,11.270,20457,9529,10928,8.001,17.176,26078,7502,18576,6.299,21.895,-5621,-4.719,34.352,11,11,86
1983,No Utility Patent Granted,11,18036,18393,148080,147917,2881,15.674,2857,15.543,40491,14805,25686,10.009,27.374,40191,15213,24978,10.285,27.171,300,0.203,54.343,2057,2063,10483
1983,No Utility Patent Granted,21,25145,28103,465342,536566,3942,13.753,5060,17.654,78446,32834,45612,6.119,14.620,221261,62789,158472,11.702,41.236,-142815,-26.616,29.240,3924,3950,41922
1983,No Utility Patent Granted,22,5584,10375,545392,539891,511,4.956,381,3.695,37088,8860,28228,1.641,6.870,26201,3982,22219,0.738,4.853,10887,2.017,9.706,226,229,1048
1983,No Utility Patent Granted,23,391143,395224,3544302,3592855,63413,16.074,61994,15.714,926602,280412,646190,7.805,25.790,1023606,282067,741539,7.851,28.490,-97004,-2.700,51.580,43890,43937,205472
1983,No Utility Patent Granted,31-33,268593,290130,7731815,7943330,28879,9.955,28784,9.923,1005280,288051,717229,3.626,12.656,1428721,383593,1045128,4.829,17.986,-423441,-5.331,25.311,21927,22102,243146
1983,No Utility Patent Granted,42,263430,305460,3249649,3293879,35364,11.641,32033,10.544,504602,174377,330225,5.294,15.319,592420,193109,399311,5.863,17.985,-87818,-2.666,30.639,23222,23739,129378
1983,No Utility Patent Granted,44-45,730103,955506,8749427,8726089,114860,12.057,109170,11.459,1519214,652328,866886,7.476,17.410,1475136,555016,920120,6.360,16.905,44078,0.505,33.810,75719,78503,328606
1983,No Utility Patent Granted,48-49,92461,109198,2016271,2040684,16624,15.276,15876,14.589,321973,112153,209820,5.496,15.778,369669,118691,250978,5.816,18.115,-47696,-2.337,31.555,11554,11674,64052
1983,No Utility Patent Granted,51,47502,64159,1694188,1642485,9119,14.423,7255,11.475,428195,100224,327971,6.102,26.070,323826,73961,249865,4.503,19.716,104369,6.354,39.431,4865,4972,37543
1983,No Utility Patent Granted,52,164744,249749,4482065,4319794,32314,13.262,20117,8.256,844938,295843,549095,6.849,19.560,521833,181698,340135,4.206,12.080,323105,7.480,24.160,12355,12542,99559
1983,No Utility Patent Granted,53,169882,179092,1078505,1073778,26630,14.921,25404,14.234,248044,108716,139328,10.125,23.100,238829,102847,135982,9.578,22.242,9215,0.858,44.484,19489,19581,71652
1983,No Utility Patent Granted,54,313248,330455,2428606,2388679,57172,17.879,35818,11.201,509907,215791,294116,9.034,21.347,429612,148499,281113,6.217,17.985,80295,3.361,35.971,26264,26521,106516
1983,No Utility Patent Granted,55,20875,28237,1198895,1204736,3068,10.930,2734,9.740,231512,68391,163121,5.677,19.217,241981,61540,180441,5.108,20.086,-10469,-0.869,38.434,641,657,7147
1983,No Utility Patent Granted,56,140836,154050,2104269,2094157,29843,19.812,23009,15.275,523806,188008,335798,8.978,25.013,502839,167753,335086,8.011,24.012,20967,1.001,48.023,17545,17656,110698
1983,No Utility Patent Granted,61,32587,34831,1238166,1214569,4281,12.491,3165,9.235,145171,32912,112259,2.710,11.952,98037,20324,77713,1.673,8.072,47134,3.881,16.144,2394,2435,14006
1983,No Utility Patent Granted,62,391593,428624,7092619,6958475,46251,11.040,26859,6.411,921145,360553,560592,5.181,13.238,651406,195116,456290,2.804,9.361,269739,3.876,18.723,19598,19938,129752
1983,No Utility Patent Granted,71,52341,54570,704979,703467,10172,19.191,7038,13.278,144876,60511,84365,8.602,20.595,142148,45224,96924,6.429,20.207,2728,0.388,40.414,5301,5339,32340
1983,No Utility Patent Granted,72,297840,353904,5523000,5452604,60658,17.424,49089,14.101,1276177,691207,584970,12.677,23.405,1130696,481836,648860,8.837,20.737,145481,2.668,41.474,36634,37318,319337
1983,No Utility Patent Granted,81,456374,491279,3337304,3312444,61078,12.576,49838,10.262,602072,223884,378188,6.759,18.176,553353,187700,365653,5.667,16.705,48719,1.471,33.411,36032,36511,132785
1983,Utility Patent Granted,11,84,355,20574,22041,22,6.215,20,5.650,2181,492,1689,2.232,9.895,5121,1027,4094,4.659,23.234,-2940,-13.339,19.790,0,0,0
1983,Utility Patent Granted,21,307,3561,323829,367867,376,10.245,594,16.185,41249,17623,23626,4.791,11.213,129778,25530,104248,6.940,35.279,-88529,-24.065,22.426,6,7,391
1983,Utility Patent Granted,22,84,1715,206389,207641,74,4.311,77,4.486,14717,6139,8578,2.957,7.088,16765,2110,14655,1.016,8.074,-2048,-0.986,14.175,0,0,0
1983,Utility Patent Granted,23,502,2413,245121,274779,172,7.124,175,7.248,31923,9003,22920,3.276,11.618,91069,8923,82146,3.247,33.143,-59146,-21.525,23.235,16,16,206
1983,Utility Patent Granted,31-33,6256,32703,8454204,8839965,1164,3.519,1909,5.772,561035,110118,450917,1.246,6.347,1332626,226564,1106062,2.563,15.075,-771591,-8.728,12.693,152,158,8262
1983,Utility Patent Granted,42,2439,34569,825034,847864,2421,6.902,3438,9.801,127781,41397,86384,4.883,15.071,173555,53662,119893,6.329,20.470,-45774,-5.399,30.142,56,60,815
1983,Utility Patent Granted,44-45,941,74278,1380412,1416518,4903,6.552,6022,8.047,160740,63296,97444,4.468,11.348,232375,98737,133638,6.970,16.405,-71635,-5.057,22.695,17,32,724
1983,Utility Patent Granted,48-49,765,6956,355358,364834,469,6.636,692,9.791,44017,14430,29587,3.955,12.065,62942,12680,50262,3.476,17.252,-18925,-5.187,24.130,D,D,D
1983,Utility Patent Granted,51,346,7432,753347,826479,678,7.830,3132,36.170,280245,15925,264320,1.927,33.908,435001,237553,197448,28.743,52.633,-154756,-18.725,67.817,6,6,37
1983,Utility Patent Granted,52,325,17683,494684,497842,1483,8.332,1716,9.641,60600,21916,38684,4.402,12.173,66666,23272,43394,4.675,13.391,-6066,-1.218,24.345,12,12,73
1983,Utility Patent Granted,53,420,3159,61241,60611,279,8.708,369,11.517,13942,5388,8554,8.890,23.003,13120,4603,8517,7.594,21.646,822,1.356,43.293,10,10,89
1983,Utility Patent Granted,54,1342,4817,514675,524335,653,13.749,518,10.906,58872,23641,35231,4.509,11.228,78966,19920,59046,3.799,15.060,-20094,-3.832,22.456,30,30,496
1983,Utility Patent Granted,55,1808,14332,1552169,1575832,1096,7.497,1671,11.430,213639,66552,147087,4.223,13.557,261709,59545,202164,3.779,16.608,-48070,-3.050,27.114,3,3,235
1983,Utility Patent Granted,56,448,3849,302296,297436,291,7.475,379,9.735,56708,15024,41684,5.051,19.066,46335,13390,32945,4.502,15.578,10373,3.487,31.156,18,18,104
1983,Utility Patent Granted,61,90,214,267633,264623,11,4.955,27,12.162,14223,151,14072,0.057,5.375,8090,128,7962,0.048,3.057,6133,2.318,6.114,D,D,D
1983,Utility Patent Granted,62,160,1794,258260,256170,217,12.222,180,10.138,27180,11246,15934,4.390,10.610,22723,7227,15496,2.821,8.870,4457,1.740,17.741,5,5,39
1983,Utility Patent Granted,71,125,899,71873,68509,111,12.286,120,13.282,11286,3538,7748,5.164,16.474,4228,1629,2599,2.378,6.171,7058,10.302,12.343,3,3,13
1983,Utility Patent Granted,72,190,14765,464826,463302,1422,9.697,1221,8.326,89317,44727,44590,9.654,19.278,88573,23676,64897,5.110,19.118,744,0.161,38.236,6,6,116
1983,Utility Patent Granted,81,508,5117,116193,113509,989,20.314,492,10.106,24838,9977,14861,8.790,21.882,19652,5822,13830,5.129,17.313,5186,4.569,34.626,12,14,192
1984,No Utility Patent Granted,11,18808,19155,159806,154469,3229,17.181,2508,13.344,45599,16661,28938,10.786,29.520,35147,11926,23221,7.721,22.753,10452,6.766,45.507,1818,1823,9134
1984,No Utility Patent Granted,21,25053,27795,489165,472562,3907,14.009,4097,14.690,128689,33183,95506,7.022,27.232,96578,37115,59463,7.854,20.437,32111,6.795,40.874,3195,3212,25812
1984,No Utility Patent Granted,22,5655,10327,576265,575089,633,6.201,396,3.879,31086,8444,22642,1.468,5.405,28782,5102,23680,0.887,5.005,2304,0.401,10.010,230,230,1079
1984,No Utility Patent Granted,23,421675,425751,4003481,3748109,81030,19.699,52196,12.689,1305674,375299,930375,10.013,34.836,794651,244801,549850,6.531,21.201,511023,13.634,42.403,38701,38733,187993
1984,No Utility Patent Granted,31-33,274684,296668,8509882,8141391,33022,11.258,26337,8.979,1595789,358519,1237270,4.404,19.601,861108,315136,545972,3.871,10.577,734681,9.024,21.154,20678,20830,206507
1984,No Utility Patent Granted,42,269198,311535,3470677,3361218,36242,11.746,30278,9.813,645793,182971,462822,5.444,19.213,427310,162831,264479,4.844,12.713,218483,6.500,25.426,22746,23216,116651
1984,No Utility Patent Granted,44-45,740728,970057,9356353,9080782,117544,12.203,103848,10.781,1759423,689477,1069946,7.593,19.375,1208489,488401,720088,5.378,13.308,550934,6.067,26.616,75059,77416,309616
1984,No Utility Patent Granted,48-49,95885,113272,2131049,2061023,18798,16.894,14799,13.300,416779,117716,299063,5.712,20.222,278040,96231,181809,4.669,13.490,138739,6.732,26.981,11154,11248,59398
1984,No Utility Patent Granted,51,49611,71013,2055550,1988746,12477,18.222,7397,10.803,470800,273176,197624,13.736,23.673,331165,67365,263800,3.387,16.652,139635,7.021,33.304,5049,5136,36829
1984,No Utility Patent Granted,52,169110,256625,4349367,4278136,30223,11.956,22530,8.913,751762,253947,497815,5.936,17.572,608556,245003,363553,5.727,14.225,143206,3.347,28.450,14979,15126,165666
1984,No Utility Patent Granted,53,177271,186843,1170746,1121897,32061,17.540,23948,13.102,303641,129169,174472,11.513,27.065,205895,96071,109824,8.563,18.352,97746,8.713,36.705,18787,18894,71299
1984,No Utility Patent Granted,54,333811,351357,2697045,2562748,59157,17.353,38265,11.224,644411,237032,407379,9.249,25.145,374594,152558,222036,5.953,14.617,269817,10.528,29.234,28477,28698,112825
1984,No Utility Patent Granted,55,21532,29553,1282716,1242398,3296,11.387,2083,7.196,248105,75244,172861,6.056,19.970,167899,42860,125039,3.450,13.514,80206,6.456,27.028,707,723,8319
1984,No Utility Patent Granted,56,151003,164697,2455808,2287336,32257,20.248,21486,13.487,705203,209940,495263,9.178,30.831,366922,135812,231110,5.938,16.041,338281,14.789,32.083,16590,16704,94752
1984,No Utility Patent Granted,61,33731,36089,1249680,1225125,4553,12.847,3255,9.185,148731,27330,121401,2.231,12.140,99891,21613,78278,1.764,8.154,48840,3.987,16.307,2511,2535,15651
1984,No Utility Patent Granted,62,404754,443404,7375927,7231072,43426,9.961,28576,6.554,929580,358902,570678,4.963,12.855,637886,210536,427350,2.912,8.821,291694,4.034,17.643,21321,21659,144474
1984,No Utility Patent Granted,71,54016,56303,771034,749486,10025,18.105,8162,14.740,169608,61209,108399,8.167,22.630,126766,45809,80957,6.112,16.914,42842,5.716,33.827,6292,6345,33738
1984,No Utility Patent Granted,72,302390,361164,5899966,5728384,59408,16.587,53382,14.905,1376571,706755,669816,12.338,24.031,1035664,499302,536362,8.716,18.080,340907,5.951,36.159,40447,41122,331499
1984,No Utility Patent Granted,81,503276,538404,3631878,3488758,95651,18.574,48807,9.477,779404,320834,458570,9.196,22.340,493370,175056,318314,5.018,14.142,286034,8.199,28.283,36555,37070,126355
1984,Utility Patent Granted,11,74,312,18367,18971,10,3.115,28,8.723,2139,191,1948,1.007,11.275,3362,814,2548,4.291,17.722,-1223,-6.447,22.551,D,D,D
1984,Utility Patent Granted,21,327,3923,310276,318785,561,14.669,364,9.518,45943,11404,34539,3.577,14.412,62792,15760,47032,4.944,19.697,-16849,-5.285,28.824,4,17,1264
1984,Utility Patent Granted,22,88,1913,180040,177804,106,5.643,37,1.970,10705,3231,7474,1.817,6.021,6163,592,5571,0.333,3.466,4542,2.555,6.932,D,D,D
1984,Utility Patent Granted,23,535,2545,285647,296267,288,11.585,170,6.838,52099,12052,40047,4.068,17.585,73551,5660,67891,1.910,24.826,-21452,-7.241,35.170,19,21,270
1984,Utility Patent Granted,31-33,6489,32319,8828172,8641448,1195,3.669,1700,5.219,1005820,169132,836688,1.957,11.639,631158,200494,430664,2.320,7.304,374662,4.336,14.608,122,128,3360
1984,Utility Patent Granted,42,2512,35077,866253,849319,3286,9.425,2865,8.217,161758,68469,93289,8.062,19.046,126886,45295,81591,5.333,14.940,34872,4.106,29.879,41,50,618
1984,Utility Patent Granted,44-45,972,75772,1398776,1367014,6016,8.039,4138,5.530,190603,69316,121287,5.071,13.943,125261,40749,84512,2.981,9.163,65342,4.780,18.326,24,25,117
1984,Utility Patent Granted,48-49,747,6674,389923,385760,575,8.508,744,11.008,60412,15485,44927,4.014,15.661,51703,20850,30853,5.405,13.403,8709,2.258,26.806,8,13,1692
1984,Utility Patent Granted,51,354,5452,482200,507411,1300,23.532,1445,26.156,150565,77357,73208,15.245,29.673,204058,117529,86529,23.163,40.216,-53493,-10.542,59.346,D,D,D
1984,Utility Patent Granted,52,327,17420,518821,522347,1407,8.034,1595,9.107,60063,23218,36845,4.445,11.499,67125,20557,46568,3.936,12.851,-7062,-1.352,22.997,22,23,417
1984,Utility Patent Granted,53,416,5003,105831,86790,1764,41.321,296,6.934,57702,45917,11785,52.906,66.485,16374,5159,11215,5.944,18.866,41328,47.618,37.732,9,9,14
1984,Utility Patent Granted,54,1416,5275,532587,528181,735,14.304,462,8.991,77946,28578,49368,5.411,14.757,69484,19999,49485,3.786,13.155,8462,1.602,26.311,46,46,914
1984,Utility Patent Granted,55,1866,14038,1569112,1555189,1051,7.454,1175,8.333,223955,61073,162882,3.927,14.401,195720,41709,154011,2.682,12.585,28235,1.816,25.170,6,8,222
1984,Utility Patent Granted,56,471,4129,304403,300363,368,8.996,291,7.114,55391,13768,41623,4.584,18.441,46574,10612,35962,3.533,15.506,8817,2.935,31.012,10,10,148
1984,Utility Patent Granted,61,92,240,274996,277149,20,8.264,24,9.917,13942,258,13684,0.093,5.031,18220,954,17266,0.344,6.574,-4278,-1.544,10.061,0,0,0
1984,Utility Patent Granted,62,177,2123,292570,285656,314,15.579,99,4.912,30981,11156,19825,3.905,10.846,17221,3944,13277,1.381,6.029,13760,4.817,12.057,4,5,22
1984,Utility Patent Granted,71,117,928,48686,47910,129,14.365,69,7.684,5869,2849,3020,5.947,12.250,4154,974,3180,2.033,8.670,1715,3.580,17.341,D,D,D
1984,Utility Patent Granted,72,219,14692,489148,463115,1776,12.480,854,6.001,98990,51767,47223,11.178,21.375,46319,19159,27160,4.137,10.002,52671,11.373,20.003,6,26,866
1984,Utility Patent Granted,81,506,5351,122665,119675,597,11.314,448,8.490,23294,9172,14122,7.664,19.464,16837,4885,11952,4.082,14.069,6457,5.395,28.138,10,10,45
1985,No Utility Patent Granted,11,18844,19172,160383,159996,2987,15.609,2915,15.233,43333,15380,27953,9.613,27.084,42540,14535,28005,9.085,26.588,793,0.496,53.176,2111,2115,10288
1985,No Utility Patent Granted,21,24931,27820,467249,470305,3907,14.001,4077,14.610,93040,32905,60135,6.997,19.783,99625,39770,59855,8.456,21.183,-6585,-1.400,39.566,3277,3302,29964
1985,No Utility Patent Granted,22,5678,10168,589656,585848,577,5.689,525,5.176,34506,6683,27823,1.141,5.890,26925,6913,20012,1.180,4.596,7581,1.294,9.192,317,317,1933
1985,No Utility Patent Granted,23,442866,446997,4365657,4188719,83766,19.197,62466,14.316,1342824,393196,949628,9.387,32.058,988487,341690,646797,8.157,23.599,354337,8.459,47.198,46357,46397,264647
1985,No Utility Patent Granted,31-33,278452,300614,8481057,8480341,33348,11.178,28787,9.649,1286620,350913,935707,4.138,15.172,1283608,483719,799889,5.704,15.136,3012,0.036,30.273,22517,22753,315250
1985,No Utility Patent Granted,42,271364,314352,3584863,3536248,37191,11.876,34806,11.114,637407,192105,445302,5.432,18.025,540377,242059,298318,6.845,15.281,97030,2.744,30.562,26561,27161,176017
1985,No Utility Patent Granted,44-45,734085,975214,10197111,9992261,117506,12.005,124662,12.736,1850006,714837,1135169,7.154,18.514,1438561,675599,762962,6.761,14.397,411445,4.118,28.794,88287,92156,423550
1985,No Utility Patent Granted,48-49,98055,116305,2283836,2235558,19520,16.966,17017,14.791,432187,122611,309576,5.485,19.332,335274,130157,205117,5.822,14.997,96913,4.335,29.995,12898,12999,80531
1985,No Utility Patent Granted,51,50354,70219,1856050,1843922,9997,14.367,8723,12.536,341888,120983,220905,6.561,18.541,321004,104014,216990,5.641,17.409,20884,1.133,34.818,6062,6183,56331
1985,No Utility Patent Granted,52,168403,257724,4458203,4360413,29777,11.622,26736,10.435,771410,230065,541345,5.276,17.691,578753,224849,353904,5.157,13.273,192658,4.418,26.546,18166,18325,130997
1985,No Utility Patent Granted,53,182499,194659,1286223,1237044,35339,18.464,28807,15.051,345887,152472,193415,12.326,27.961,246974,120017,126957,9.702,19.965,98913,7.996,39.930,22975,23075,92398
1985,No Utility Patent Granted,54,350373,368868,2904679,2793663,62734,17.415,45440,12.614,694036,263839,430197,9.444,24.843,470585,213663,256922,7.648,16.845,223451,7.998,33.689,34706,34938,163547
1985,No Utility Patent Granted,55,21815,30537,1415235,1364165,2905,9.590,2413,7.966,281021,73264,207757,5.371,20.600,178607,55734,122873,4.086,13.093,102414,7.507,26.186,969,980,10509
1985,No Utility Patent Granted,56,159421,174284,2804591,2637238,34673,20.440,25365,14.953,818649,240205,578444,9.108,31.042,481600,181553,300047,6.884,18.262,337049,12.780,36.523,19989,20154,132877
1985,No Utility Patent Granted,61,33987,36411,1279057,1267911,4359,12.032,3991,11.017,167471,27086,140385,2.136,13.208,144486,49038,95448,3.868,11.396,22985,1.813,22.791,3100,3131,31048
1985,No Utility Patent Granted,62,413403,453484,7652410,7491252,44793,9.990,34608,7.718,1144065,455265,688800,6.077,15.272,821523,325275,496248,4.342,10.966,322542,4.306,21.933,26756,27175,240911
1985,No Utility Patent Granted,71,55871,58199,782797,775382,10481,18.311,8560,14.955,185440,64762,120678,8.352,23.916,171513,79043,92470,10.194,22.120,13927,1.796,44.240,6627,6680,42808
1985,No Utility Patent Granted,72,301174,361010,6160873,6032445,60065,16.637,60096,16.646,1502200,778469,723731,12.905,24.902,1239791,628290,611501,10.415,20.552,262409,4.350,41.104,45823,46782,410708
1985,No Utility Patent Granted,81,511709,547408,3793782,3714633,69631,12.823,60879,11.211,738484,252658,485826,6.802,19.880,580790,235658,345132,6.344,15.635,157694,4.245,31.270,44820,45412,173200
1985,Utility Patent Granted,11,65,293,16842,17292,7,2.329,22,7.321,1696,212,1484,1.226,9.808,2501,477,2024,2.759,14.463,-805,-4.655,19.616,0,0,0
1985,Utility Patent Granted,21,318,3685,294803,299581,358,9.542,492,13.113,46801,9682,37119,3.232,15.622,56294,18010,38284,6.012,18.791,-9493,-3.169,31.244,3,3,50
1985,Utility Patent Granted,22,91,2042,174931,174280,62,3.029,72,3.517,9812,2285,7527,1.311,5.630,8524,1416,7108,0.812,4.891,1288,0.739,9.782,0,0,0
1985,Utility Patent Granted,23,558,2599,288319,292021,227,8.706,244,9.358,90845,47989,42856,16.433,31.109,98837,14737,84100,5.047,33.846,-7992,-2.737,62.218,22,23,1786
1985,Utility Patent Granted,31-33,6712,31642,8785772,8819886,1292,4.030,2131,6.647,800807,188101,612706,2.133,9.080,865768,320328,545440,3.632,9.816,-64961,-0.737,18.159,243,265,20110
1985,Utility Patent Granted,42,2633,34571,886081,876855,3007,8.658,3324,9.571,159887,56247,103640,6.415,18.234,142131,54333,87798,6.196,16.209,17756,2.025,32.418,73,96,1725
1985,Utility Patent Granted,44-45,1011,63751,988200,975851,5309,8.345,5044,7.929,139712,56565,83147,5.796,14.317,116824,45430,71394,4.655,11.971,22888,2.345,23.943,29,30,654
1985,Utility Patent Granted,48-49,760,6095,337364,335620,472,7.674,584,9.494,42659,11694,30965,3.484,12.711,39521,18178,21343,5.416,11.776,3138,0.935,23.551,5,5,18
1985,Utility Patent Granted,51,376,8378,759978,741056,1503,18.964,598,7.545,149564,73350,76214,9.898,20.183,111044,17101,93943,2.308,14.985,38520,5.198,29.969,5,8,466
1985,Utility Patent Granted,52,321,18237,597327,594059,1340,7.202,2078,11.168,87669,24354,63315,4.100,14.758,81358,28951,52407,4.873,13.695,6311,1.062,27.391,22,22,815
1985,Utility Patent Granted,53,417,3603,98356,91997,697,19.412,672,18.716,33694,22990,10704,24.990,36.625,23012,10066,12946,10.942,25.014,10682,11.611,50.028,11,11,80
1985,Utility Patent Granted,54,1538,5345,579235,565821,668,12.736,468,8.923,89728,22633,67095,4.000,15.858,62336,14457,47879,2.555,11.017,27392,4.841,22.034,51,54,704
1985,Utility Patent Granted,55,1935,13214,1587767,1563768,1213,9.066,1545,11.547,262399,67427,194972,4.312,16.780,217255,66815,150440,4.273,13.893,45144,2.887,27.786,12,13,804
1985,Utility Patent Granted,56,498,4000,344740,318586,465,11.887,289,7.388,99582,24775,74807,7.777,31.258,48348,11409,36939,3.581,15.176,51234,16.082,30.352,11,11,41
1985,Utility Patent Granted,61,109,304,271526,270709,64,22.776,18,6.406,17424,647,16777,0.239,6.436,16448,346,16102,0.128,6.076,976,0.361,12.152,D,D,D
1985,Utility Patent Granted,62,202,2464,346023,338745,353,14.754,210,8.777,36737,11433,25304,3.375,10.845,22135,6140,15995,1.813,6.534,14602,4.311,13.069,7,7,25
1985,Utility Patent Granted,71,122,897,54470,54397,108,12.027,110,12.249,9060,4224,4836,7.765,16.655,9083,2223,6860,4.087,16.698,-23,-0.042,33.311,4,4,5
1985,Utility Patent Granted,72,230,15769,518571,507150,1825,11.829,1144,7.415,91934,51023,40911,10.061,18.128,69544,27387,42157,5.400,13.713,22390,4.415,27.425,3,90,1104
1985,Utility Patent Granted,81,517,5151,124807,123833,523,10.130,547,10.595,19923,5852,14071,4.726,16.089,18099,7444,10655,6.011,14.616,1824,1.473,29.231,11,11,258
1986,No Utility Patent Granted,11,18458,18770,161802,163370,2825,14.915,3166,16.716,41651,15029,26622,9.199,25.495,44909,17027,27882,10.422,27.489,-3258,-1.994,50.990,2291,2292,11200
1986,No Utility Patent Granted,21,23906,26602,412684,439259,3215,11.826,4381,16.116,73765,28284,45481,6.439,16.793,126757,41427,85330,9.431,28.857,-52992,-12.064,33.586,3383,3417,26562
1986,No Utility Patent Granted,22,5832,9958,539935,536979,636,6.445,456,4.621,39501,11728,27773,2.184,7.356,33015,3985,29030,0.742,6.148,6486,1.208,12.297,276,276,1548
1986,No Utility Patent Granted,23,462154,466118,4562223,4462373,83793,18.356,64524,14.135,1314241,391949,922292,8.783,29.452,1113124,352601,760523,7.902,24.945,201117,4.507,49.889,47447,47499,261864
1986,No Utility Patent Granted,31-33,277841,300028,8252509,8254441,32295,10.785,31101,10.387,1271046,365904,905142,4.433,15.398,1276411,433141,843270,5.247,15.463,-5365,-0.065,30.797,24141,24311,282242
1986,No Utility Patent Granted,42,273780,318411,3622216,3593883,39292,12.432,34574,10.939,644793,215961,428832,6.009,17.941,587966,217381,370585,6.049,16.360,56827,1.581,32.720,25848,26324,145327
1986,No Utility Patent Granted,44-45,734938,979742,10375412,10196984,128446,13.213,113215,11.646,1970315,849584,1120731,8.332,19.323,1613561,590608,1022953,5.792,15.824,356754,3.499,31.648,80926,83874,371758
1986,No Utility Patent Granted,48-49,99450,117724,2237839,2212977,20027,17.180,17723,15.203,431403,146298,285105,6.611,19.494,380377,134601,245776,6.082,17.188,51026,2.306,34.377,13210,13416,83119
1986,No Utility Patent Granted,51,50527,69468,1824612,1801598,10160,14.725,9224,13.368,336989,121399,215590,6.738,18.705,293293,95679,197614,5.311,16.280,43696,2.425,32.559,6233,6336,50988
1986,No Utility Patent Granted,52,171385,265081,4758788,4632408,28968,11.039,23632,9.006,816432,232239,584193,5.013,17.624,563186,193801,369385,4.184,12.158,253246,5.467,24.315,14983,15210,105960
1986,No Utility Patent Granted,53,188996,203120,1373926,1325440,37178,18.708,28384,14.283,373593,159324,214269,12.020,28.186,273782,123603,150179,9.325,20.656,99811,7.530,41.312,22114,22289,90740
1986,No Utility Patent Granted,54,367138,387560,3106194,2993559,64192,16.976,45326,11.987,728286,273815,454471,9.147,24.328,501831,198615,303216,6.635,16.764,226455,7.565,33.527,34146,34338,149708
1986,No Utility Patent Granted,55,22462,31470,1467154,1430255,3840,12.439,2640,8.552,305664,101704,203960,7.111,21.371,229529,51651,177878,3.611,16.048,76135,5.323,32.096,897,952,9873
1986,No Utility Patent Granted,56,169353,185719,3067700,2939079,37483,20.825,26022,14.458,842655,290597,552058,9.887,28.671,585254,192799,392455,6.560,19.913,257401,8.758,39.826,19933,20045,132250
1986,No Utility Patent Granted,61,34557,37223,1300036,1287834,4720,12.828,3864,10.501,154587,30398,124189,2.360,12.004,130201,28995,101206,2.251,10.110,24386,1.894,20.220,2974,3018,19938
1986,No Utility Patent Granted,62,423145,467630,7935268,7790450,48259,10.479,34073,7.399,1137366,432629,704737,5.553,14.599,843441,265398,578043,3.407,10.827,293925,3.773,21.653,25571,25914,196957
1986,No Utility Patent Granted,71,57594,60429,816190,799152,10837,18.256,8699,14.655,186186,74034,112152,9.264,23.298,151951,54818,97133,6.860,19.014,34235,4.284,38.028,6643,6671,38587
1986,No Utility Patent Granted,72,304329,370632,6549470,6383184,65104,17.762,56926,15.531,1638067,926563,711504,14.516,25.662,1306809,576702,730107,9.035,20.473,331258,5.190,40.945,42750,43659,401696
1986,No Utility Patent Granted,81,522316,560550,3918521,3855419,69582,12.551,57258,10.328,729112,271622,457490,7.045,18.911,603247,213298,389949,5.532,15.647,125865,3.265,31.293,41571,42167,155193
1986,Utility Patent Granted,11,68,309,12164,12213,19,6.109,23,7.395,2629,494,2135,4.045,21.527,2622,1044,1578,8.549,21.470,7,0.057,42.940,0,0,0
1986,Utility Patent Granted,21,322,3525,274228,285423,228,6.253,471,12.916,38852,10964,27888,3.841,13.612,61921,12087,49834,4.235,21.695,-23069,-8.082,27.224,7,7,231
1986,Utility Patent Granted,22,98,2515,233535,233147,155,6.254,82,3.308,12056,4961,7095,2.128,5.171,10955,1837,9118,0.788,4.699,1101,0.472,9.398,0,0,0
1986,Utility Patent Granted,23,536,2435,253627,256227,166,6.714,241,9.747,49788,14607,35181,5.701,19.431,54671,11561,43110,4.512,21.337,-4883,-1.906,38.862,22,22,144
1986,Utility Patent Granted,31-33,6841,31641,8556596,8678762,1368,4.294,1809,5.678,660350,175891,484459,2.027,7.609,901475,246619,654856,2.842,10.387,-241125,-2.778,15.218,203,216,14101
1986,Utility Patent Granted,42,2817,34928,918726,919288,2539,7.187,3341,9.457,133087,40011,93076,4.352,14.477,133255,49928,83327,5.431,14.495,-168,-0.018,28.954,62,112,1033
1986,Utility Patent Granted,44-45,1044,75207,1193036,1185634,5940,7.944,5067,6.777,171222,64969,106253,5.480,14.441,157858,59022,98836,4.978,13.314,13364,1.127,26.628,27,31,133
1986,Utility Patent Granted,48-49,787,7120,438907,435875,570,8.093,417,5.920,54294,15892,38402,3.646,12.456,48848,9581,39267,2.198,11.207,5446,1.249,22.414,3,3,82
1986,Utility Patent Granted,51,395,9708,822284,831142,652,6.611,962,9.754,95389,20219,75170,2.433,11.477,115050,29225,85825,3.516,13.842,-19661,-2.366,22.954,8,8,21
1986,Utility Patent Granted,52,334,17546,540461,534336,2642,15.654,1304,7.726,100908,46384,54524,8.681,18.885,88641,26166,62475,4.897,16.589,12267,2.296,33.178,6,6,55
1986,Utility Patent Granted,53,428,3846,101692,98791,621,16.338,531,13.970,21576,5790,15786,5.861,21.840,16436,5622,10814,5.691,16.637,5140,5.203,33.274,5,5,13
1986,Utility Patent Granted,54,1619,5220,602831,601511,592,11.369,566,10.870,78550,21409,57141,3.559,13.059,75222,17097,58125,2.842,12.506,3328,0.553,25.011,66,67,1199
1986,Utility Patent Granted,55,2041,13308,1604773,1610347,1215,9.075,1376,10.277,235614,69967,165647,4.345,14.631,247357,62317,185040,3.870,15.360,-11743,-0.729,29.263,5,5,197
1986,Utility Patent Granted,56,519,4009,347193,341681,378,9.467,346,8.665,53313,14636,38677,4.284,15.603,42215,11528,30687,3.374,12.355,11098,3.248,24.710,17,17,183
1986,Utility Patent Granted,61,122,339,296419,290318,41,12.112,40,11.817,25573,644,24929,0.222,8.809,13669,416,13253,0.143,4.708,11904,4.100,9.417,4,4,4
1986,Utility Patent Granted,62,212,3278,461463,454354,614,19.971,207,6.733,52308,18762,33546,4.129,11.513,38129,4781,33348,1.052,8.392,14179,3.121,16.784,4,4,25
1986,Utility Patent Granted,71,114,881,64614,60807,75,8.418,95,10.662,12010,2987,9023,4.912,19.751,4753,1759,2994,2.893,7.817,7257,11.935,15.633,4,4,29
1986,Utility Patent Granted,72,233,15142,519681,496689,2028,13.728,1290,8.732,110895,65482,45413,13.184,22.327,63481,30018,33463,6.044,12.781,47414,9.546,25.562,11,14,155
1986,Utility Patent Granted,81,539,4477,134649,130257,508,11.555,347,7.893,24861,10388,14473,7.975,19.086,16058,4642,11416,3.564,12.328,8803,6.758,24.656,14,17,112
1987,No Utility Patent Granted,11,18347,18682,158145,155638,3089,16.678,2767,14.940,46040,16885,29155,10.849,29.582,40503,15197,25306,9.764,26.024,5537,3.558,52.048,2057,2059,11576
1987,No Utility Patent Granted,21,21319,24029,351128,386508,2884,11.402,5415,21.408,66008,30090,35918,7.785,17.078,136362,51295,85067,13.271,35.281,-70354,-18.202,34.156,4017,4052,31795
1987,No Utility Patent Granted,22,5738,9844,527591,522985,588,6.005,485,4.953,34984,11625,23359,2.223,6.689,25753,3527,22226,0.674,4.924,9231,1.765,9.848,312,314,1601
1987,No Utility Patent Granted,23,485095,489464,4718009,4625464,90165,18.875,66650,13.952,1345020,424903,920117,9.186,29.079,1160191,373724,786467,8.080,25.083,184829,3.996,50.165,49878,49920,282256
1987,No Utility Patent Granted,31-33,278795,300714,8162650,8140197,33674,11.243,31283,10.444,1278307,382474,895833,4.699,15.704,1233911,456153,777758,5.604,15.158,44396,0.545,30.316,23788,23995,285866
1987,No Utility Patent Granted,42,276822,322546,3735415,3691760,39935,12.422,37806,11.760,700176,235596,464580,6.382,18.966,613475,236400,377075,6.403,16.617,86701,2.349,33.235,26530,27167,157910
1987,No Utility Patent Granted,44-45,728877,986566,10778058,10589949,129568,13.184,121905,12.405,2097842,898782,1199060,8.487,19.810,1720525,700327,1020198,6.613,16.247,377317,3.563,32.494,82488,85536,409502
1987,No Utility Patent Granted,48-49,102411,121953,2462992,2407807,21702,18.048,18292,15.212,522932,172437,350495,7.162,21.718,412238,182265,229973,7.570,17.121,110694,4.597,34.242,13077,13234,90187
1987,No Utility Patent Granted,51,45873,59792,1481685,1483555,9400,15.646,9975,16.603,265942,117363,148579,7.911,17.926,270214,120738,149476,8.138,18.214,-4272,-0.288,35.852,6916,7072,68946
1987,No Utility Patent Granted,52,173552,268169,4800592,4686021,32627,12.359,24285,9.199,848998,276174,572824,5.894,18.118,614605,199619,414986,4.260,13.116,234393,5.002,26.231,15831,16188,99907
1987,No Utility Patent Granted,53,193064,210306,1445452,1417050,38253,18.492,31366,15.163,384896,179174,205722,12.644,27.162,328322,146826,181496,10.361,23.169,56574,3.992,46.339,24732,24948,106685
1987,No Utility Patent Granted,54,384665,407776,3389470,3281254,65794,16.455,49926,12.486,797737,295105,502632,8.994,24.312,578078,242402,335676,7.387,17.618,219659,6.694,35.235,37149,37363,173066
1987,No Utility Patent Granted,55,22408,31305,1486300,1464189,3912,12.620,3299,10.642,321649,104390,217259,7.130,21.968,277471,75849,201622,5.180,18.950,44178,3.017,37.901,990,1008,12541
1987,No Utility Patent Granted,56,179454,196776,3236075,3131114,40197,21.030,28921,15.131,919799,347502,572297,11.098,29.376,710950,235373,475577,7.517,22.706,208849,6.670,45.412,22104,22260,151997
1987,No Utility Patent Granted,61,34670,38041,1335513,1311301,4569,12.110,3945,10.456,169986,33230,136756,2.534,12.963,121606,29975,91631,2.286,9.274,48380,3.689,18.547,3008,3032,19649
1987,No Utility Patent Granted,62,430217,480139,8761129,8531980,48857,10.294,37807,7.966,1693254,879593,813661,10.309,19.846,1238828,336044,902784,3.939,14.520,454426,5.326,29.040,28053,28386,226336
1987,No Utility Patent Granted,71,58638,62361,890157,870664,11206,18.244,9332,15.193,213650,81910,131740,9.408,24.539,174780,61880,112900,7.107,20.074,38870,4.464,40.149,7186,7215,45193
1987,No Utility Patent Granted,72,308713,376142,6624768,6501561,67742,18.242,58155,15.660,1639843,925856,713987,14.241,25.222,1397249,649408,747841,9.988,21.491,242594,3.731,42.982,43984,44888,444532
1987,No Utility Patent Granted,81,527671,568450,3939489,3887706,69776,12.376,60448,10.722,748778,277277,471501,7.132,19.260,644900,239564,405336,6.162,16.588,103878,2.672,33.176,44243,44721,170081
1987,Utility Patent Granted,11,74,295,12713,14863,20,6.515,44,14.332,1078,298,780,2.005,7.253,5627,3581,2046,24.093,37.859,-4549,-30.606,14.506,D,D,D
1987,Utility Patent Granted,21,302,3193,227679,246000,407,12.233,675,20.289,31972,11338,20634,4.609,12.997,69028,24553,44475,9.981,28.060,-37056,-15.063,25.994,12,12,179
1987,Utility Patent Granted,22,106,2549,246699,249774,66,2.577,90,3.514,10855,2333,8522,0.934,4.346,17312,4448,12864,1.781,6.931,-6457,-2.585,8.692,D,D,D
1987,Utility Patent Granted,23,563,2598,247008,252366,314,12.105,306,11.796,62536,17036,45500,6.751,24.780,73728,35697,38031,14.145,29.215,-11192,-4.435,49.560,14,14,191
1987,Utility Patent Granted,31-33,7222,32023,8359785,8518250,1452,4.456,2571,7.891,619333,152823,466510,1.794,7.271,940760,304198,636562,3.571,11.044,-321427,-3.773,14.541,208,232,14715
1987,Utility Patent Granted,42,2964,34726,936423,945593,3420,9.642,4908,13.837,182918,71422,111496,7.553,19.344,198630,88772,109858,9.388,21.006,-15712,-1.662,38.689,102,123,1476
1987,Utility Patent Granted,44-45,1020,73389,1145488,1142845,6776,9.255,6423,8.773,197232,89332,107900,7.817,17.258,190831,83155,107676,7.276,16.698,6401,0.560,33.396,38,42,451
1987,Utility Patent Granted,48-49,841,6724,389564,391897,658,9.709,764,11.273,55240,17884,37356,4.563,14.096,59951,22675,37276,5.786,15.298,-4711,-1.202,28.191,6,7,40
1987,Utility Patent Granted,51,355,16280,1057432,1059306,2780,17.957,1183,7.641,245316,156624,88692,14.786,23.158,246815,44043,202772,4.158,23.300,-1499,-0.142,46.316,10,31,1309
1987,Utility Patent Granted,52,338,21150,692908,683871,1456,6.862,1593,7.508,108124,45144,62980,6.601,15.811,92641,18925,73716,2.767,13.547,15483,2.264,27.093,12,14,114
1987,Utility Patent Granted,53,432,2682,55103,63767,430,13.977,1219,39.623,11216,3764,7452,5.903,17.589,30660,23993,6667,37.626,48.082,-19444,-30.492,35.178,15,15,71
1987,Utility Patent Granted,54,1812,5707,619013,629659,777,13.702,704,12.415,92639,24879,67760,3.951,14.713,114977,37529,77448,5.960,18.260,-22338,-3.548,29.425,72,74,2105
1987,Utility Patent Granted,55,2097,13219,1538100,1586959,1418,10.498,1995,14.770,233926,68581,165345,4.322,14.741,333198,102822,230376,6.479,20.996,-99272,-6.255,29.481,11,28,1350
1987,Utility Patent Granted,56,538,4600,320735,332190,598,12.947,636,13.769,69670,37383,32287,11.253,20.973,90983,42726,48257,12.862,27.389,-21313,-6.416,41.946,17,137,5786
1987,Utility Patent Granted,61,114,400,302459,299681,73,19.135,36,9.436,14626,560,14066,0.187,4.881,8319,897,7422,0.299,2.776,6307,2.105,5.552,3,4,6
1987,Utility Patent Granted,62,225,2831,481965,466635,380,13.303,431,15.088,72756,19438,53318,4.166,15.592,41657,18125,23532,3.884,8.927,31099,6.665,17.854,13,13,1089
1987,Utility Patent Granted,71,101,942,48745,48248,61,6.421,77,8.105,7453,2918,4535,6.048,15.447,6196,2632,3564,5.455,12.842,1257,2.605,25.684,10,11,49
1987,Utility Patent Granted,72,252,23133,781236,751821,4651,21.627,1397,6.496,180357,79127,101230,10.525,23.989,120212,37319,82893,4.964,15.989,60145,8.000,31.979,11,11,87
1987,Utility Patent Granted,81,602,4675,135509,140720,671,14.581,525,11.408,20623,9486,11137,6.741,14.655,30854,12546,18308,8.916,21.926,-10231,-7.270,29.311,16,17,365
1988,No Utility Patent Granted,11,18688,19028,166425,162933,3108,16.464,2806,14.865,47314,18149,29165,11.139,29.039,40530,17631,22899,10.821,24.875,6784,4.164,49.751,2061,2064,11124
1988,No Utility Patent Granted,21,20963,23737,366599,364388,3091,12.884,3599,15.001,83615,26605,57010,7.301,22.947,79121,32242,46879,8.848,21.713,4494,1.233,43.427,2635,2668,18070
1988,No Utility Patent Granted,22,5930,10089,498662,499558,793,7.947,573,5.742,30721,10142,20579,2.030,6.150,33141,11597,21544,2.321,6.634,-2420,-0.484,12.299,242,249,2171
1988,No Utility Patent Granted,23,495295,499717,4862713,4809895,83579,16.893,73673,14.891,1295318,384255,911063,7.989,26.930,1188745,384090,804655,7.985,24.715,106573,2.216,49.429,55926,56004,294471
1988,No Utility Patent Granted,31-33,284297,306876,8604109,8460345,34409,11.302,29579,9.715,1441161,468328,972833,5.536,17.034,1153166,426295,726871,5.039,13.630,287995,3.404,27.260,23153,23328,283531
1988,No Utility Patent Granted,42,281014,328847,3847973,3805674,39263,12.034,34109,10.454,700066,229406,470660,6.028,18.395,615694,236721,378973,6.220,16.178,84372,2.217,32.357,25257,25982,162644
1988,No Utility Patent Granted,44-45,734550,1002055,11285339,11106467,126109,12.658,114628,11.505,2133633,926357,1207276,8.341,19.211,1777543,690174,1087369,6.214,16.005,356090,3.206,32.009,77837,81493,391339
1988,No Utility Patent Granted,48-49,104202,125116,2582373,2519576,21859,17.713,18442,14.944,557381,200447,356934,7.956,22.122,427176,162117,265059,6.434,16.954,130205,5.168,33.909,13462,13667,94765
1988,No Utility Patent Granted,51,47358,62236,1524966,1516599,9871,16.046,8432,13.707,273151,109599,163552,7.227,18.011,255855,102236,153619,6.741,16.870,17296,1.140,33.741,5583,5751,52168
1988,No Utility Patent Granted,52,173007,270556,4442838,4447878,34449,12.917,26747,10.029,749871,282439,467432,6.350,16.859,756618,258414,498204,5.810,17.011,-6747,-0.152,33.718,16117,16359,114306
1988,No Utility Patent Granted,53,197483,217844,1542659,1502697,35949,16.775,28867,13.470,407361,198799,208562,13.229,27.109,326799,142109,184690,9.457,21.748,80562,5.361,43.495,21966,22279,99182
1988,No Utility Patent Granted,54,399394,424436,3619123,3505827,68759,16.513,52680,12.651,840571,326072,514499,9.301,23.976,614332,245887,368445,7.014,17.523,226239,6.453,35.046,39475,39853,171292
1988,No Utility Patent Granted,55,23387,33867,1512288,1508592,5652,17.303,3247,9.940,359278,133981,225297,8.881,23.815,351494,89660,261834,5.943,23.299,7784,0.516,46.599,856,902,14441
1988,No Utility Patent Granted,56,188504,208351,3540782,3406025,41185,20.301,30222,14.897,1061350,392869,668481,11.535,31.161,788769,279174,509595,8.196,23.158,272581,8.003,46.316,23146,23407,180686
1988,No Utility Patent Granted,61,35844,39556,1373741,1358978,5065,13.034,3671,9.447,160630,33246,127384,2.446,11.820,131950,27140,104810,1.997,9.710,28680,2.110,19.419,2752,2799,19836
1988,No Utility Patent Granted,62,438008,492934,8970884,8826716,48967,10.065,36086,7.418,1303194,496720,806474,5.627,14.764,1016626,382632,633994,4.335,11.518,286568,3.247,23.035,26392,26897,247746
1988,No Utility Patent Granted,71,62668,66450,928967,911040,13113,20.332,9201,14.266,220576,83090,137486,9.120,24.211,184305,69079,115226,7.582,20.230,36271,3.981,40.460,6950,7039,47859
1988,No Utility Patent Granted,72,314735,388483,6875327,6781885,66316,17.326,54846,14.330,1639429,872439,766990,12.864,24.174,1458324,603800,854524,8.903,21.503,181105,2.670,43.006,40769,41792,408434
1988,No Utility Patent Granted,81,537381,580385,4054044,3998726,69184,12.046,57068,9.936,757335,280911,476424,7.025,18.939,646863,222068,424795,5.553,16.177,110472,2.763,32.353,41584,42120,154104
1988,Utility Patent Granted,11,69,205,12518,11900,31,13.136,93,39.407,3487,2569,918,21.589,29.304,1968,1007,961,8.463,16.539,1519,12.765,33.077,D,D,D
1988,Utility Patent Granted,21,281,2762,210273,214729,335,11.677,549,19.136,36567,9485,27082,4.417,17.029,45899,18032,27867,8.398,21.375,-9332,-4.346,34.059,10,10,770
1988,Utility Patent Granted,22,113,2538,272462,272747,151,5.971,133,5.259,18706,8070,10636,2.959,6.858,19198,6195,13003,2.271,7.039,-492,-0.180,13.717,D,D,D
1988,Utility Patent Granted,23,557,2632,211587,221349,250,9.575,208,7.966,35516,10452,25064,4.722,16.045,54997,9646,45351,4.358,24.846,-19481,-8.801,32.090,24,25,180
1988,Utility Patent Granted,31-33,7566,32766,8456608,8416437,1927,5.888,1854,5.665,842547,251848,590699,2.992,10.011,766593,252131,514462,2.996,9.108,75954,0.902,18.217,203,218,10382
1988,Utility Patent Granted,42,3036,34568,933354,933870,3672,10.619,3695,10.686,166800,67251,99549,7.201,17.861,170781,74838,95943,8.014,18.287,-3981,-0.426,35.722,95,110,2891
1988,Utility Patent Granted,44-45,1093,76721,1065885,1059452,8510,11.404,4313,5.780,192501,88486,104015,8.352,18.170,177979,48974,129005,4.623,16.799,14522,1.371,33.598,30,50,418
1988,Utility Patent Granted,48-49,823,6994,418794,412830,581,8.232,709,10.045,66715,15710,51005,3.805,16.160,54803,20244,34559,4.904,13.275,11912,2.885,26.550,11,12,285
1988,Utility Patent Granted,51,374,15211,1051930,1044408,1018,6.480,2015,12.827,106085,39404,66681,3.773,10.157,92258,26709,65549,2.557,8.834,13827,1.324,17.667,7,7,18
1988,Utility Patent Granted,52,347,24772,808564,827337,2796,11.441,2129,8.712,114100,38671,75429,4.674,13.791,149442,28881,120561,3.491,18.063,-35342,-4.272,27.582,11,11,177
1988,Utility Patent Granted,53,429,2642,42467,42553,479,19.065,220,8.756,11176,4531,6645,10.648,26.264,11011,3132,7879,7.360,25.876,165,0.388,51.752,13,14,218
1988,Utility Patent Granted,54,1967,6354,647668,647856,902,14.517,621,9.994,94291,28849,65442,4.453,14.554,94361,35128,59233,5.422,14.565,-70,-0.011,29.109,81,82,1278
1988,Utility Patent Granted,55,2157,13580,1552780,1542971,2552,19.164,2025,15.207,287996,81266,206730,5.267,18.665,268444,99469,168975,6.447,17.398,19552,1.267,34.796,13,18,195
1988,Utility Patent Granted,56,574,4479,331527,315624,765,17.631,485,11.178,83020,39123,43897,12.395,26.303,51097,29777,21320,9.434,16.189,31923,10.114,32.378,14,15,249
1988,Utility Patent Granted,61,120,407,322271,319676,77,19.568,50,12.706,18905,2719,16186,0.851,5.914,13215,390,12825,0.122,4.134,5690,1.780,8.268,3,3,84
1988,Utility Patent Granted,62,228,3259,470370,470373,517,16.441,288,9.159,42727,9275,33452,1.972,9.084,43203,13006,30197,2.765,9.185,-476,-0.101,18.167,9,9,159
1988,Utility Patent Granted,71,115,983,54697,52005,83,8.431,86,8.735,10012,3375,6637,6.490,19.252,4458,2116,2342,4.069,8.572,5554,10.680,17.145,6,6,36
1988,Utility Patent Granted,72,256,22476,778487,758023,2819,12.415,3278,14.437,151447,65306,86141,8.615,19.979,113171,42335,70836,5.585,14.930,38276,5.049,29.860,5,5,428
1988,Utility Patent Granted,81,660,4702,144694,139812,601,12.823,571,12.183,27526,9147,18379,6.542,19.688,17436,6966,10470,4.982,12.471,10090,7.217,24.942,13,13,161
1989,No Utility Patent Granted,11,18996,19368,167266,166618,3002,15.627,2686,13.982,43511,16735,26776,10.044,26.114,42168,14306,27862,8.586,25.308,1343,0.806,50.617,2002,2003,10794
1989,No Utility Patent Granted,21,20261,23103,364014,371802,2671,11.381,3403,14.500,71585,27137,44448,7.299,19.254,86631,33692,52939,9.062,23.300,-15046,-4.047,38.507,2549,2587,22026
1989,No Utility Patent Granted,22,6207,10068,485920,484169,736,7.421,435,4.386,28457,10591,17866,2.187,5.877,25103,3930,21173,0.812,5.185,3354,0.693,10.370,287,287,1740
1989,No Utility Patent Granted,23,503727,508256,5004982,4932970,80158,15.901,71875,14.258,1312583,375932,936651,7.621,26.608,1167621,371784,795837,7.537,23.670,144962,2.939,47.339,54854,54936,287563
1989,No Utility Patent Granted,31-33,286940,309491,8747355,8633902,33442,10.864,30121,9.785,1361562,376608,984954,4.362,15.770,1134584,435127,699457,5.040,13.141,226978,2.629,26.282,23400,23631,270501
1989,No Utility Patent Granted,42,283286,333180,3964906,3897145,38348,11.587,33881,10.238,696794,216549,480245,5.557,17.880,560928,224271,336657,5.755,14.393,135866,3.486,28.787,25466,26218,154128
1989,No Utility Patent Granted,44-45,736290,1022816,11891626,11704025,120806,11.871,110524,10.860,2101074,889931,1211143,7.604,17.952,1731061,658307,1072754,5.625,14.790,370013,3.161,29.581,78117,82687,403936
1989,No Utility Patent Granted,48-49,106369,128013,2540261,2507979,20479,16.174,17692,13.973,487835,161002,326833,6.420,19.451,424013,162339,261674,6.473,16.907,63822,2.545,33.813,13081,13312,88240
1989,No Utility Patent Granted,51,48986,61145,1428870,1408785,9927,16.462,8239,13.663,249077,101883,147194,7.232,17.680,209263,91451,117812,6.491,14.854,39814,2.826,29.708,5641,5797,50030
1989,No Utility Patent Granted,52,174862,274040,4502995,4461556,40876,15.108,33899,12.530,789469,346440,443029,7.765,17.695,719042,275727,443315,6.180,16.116,70427,1.579,32.233,15583,15813,127432
1989,No Utility Patent Granted,53,200250,220742,1575543,1552301,34580,15.818,30314,13.867,378232,160241,217991,10.323,24.366,330513,137423,193090,8.853,21.292,47719,3.074,42.584,23299,23742,101638
1989,No Utility Patent Granted,54,410452,435944,3857888,3718661,65264,15.203,51970,12.106,876619,313074,563545,8.419,23.574,598958,255772,343186,6.878,16.107,277661,7.467,32.214,39460,39871,172124
1989,No Utility Patent Granted,55,24300,35484,1607217,1561031,4920,14.256,2977,8.626,351616,149455,202161,9.574,22.525,260311,61578,198733,3.945,16.676,91305,5.849,33.351,944,973,13821
1989,No Utility Patent Granted,56,197853,219749,3887843,3723838,41757,19.498,30580,14.279,1101494,388740,712754,10.439,29.580,775765,264801,510964,7.111,20.832,325729,8.747,41.665,23787,24020,182079
1989,No Utility Patent Granted,61,37146,41100,1405474,1380061,5128,12.689,3755,9.291,173257,37048,136209,2.685,12.554,122789,33383,89406,2.419,8.897,50468,3.657,17.795,2817,2888,24441
1989,No Utility Patent Granted,62,446016,505088,9339977,9126282,48589,9.738,36358,7.287,1257947,422145,835802,4.626,13.784,832156,333525,498631,3.655,9.118,425791,4.666,18.236,27500,28158,214560
1989,No Utility Patent Granted,71,65124,69380,977873,955875,12216,17.926,9753,14.311,219019,77467,141552,8.104,22.913,174303,65089,109214,6.809,18.235,44716,4.678,36.470,7517,7629,48445
1989,No Utility Patent Granted,72,320541,397748,7117662,7011150,64574,16.417,55774,14.179,1578227,819566,758661,11.689,22.510,1367544,618078,749466,8.816,19.505,210683,3.005,39.011,41899,43260,426725
1989,No Utility Patent Granted,81,548112,593647,4218158,4136187,68590,11.674,56358,9.592,778890,281357,497533,6.802,18.831,615015,223092,391923,5.394,14.869,163875,3.962,29.738,42272,43250,166544
1989,Utility Patent Granted,11,70,209,11962,13173,18,8.738,12,5.825,1046,459,587,3.484,7.940,3581,565,3016,4.289,27.184,-2535,-19.244,15.881,D,D,D
1989,Utility Patent Granted,21,280,2612,195405,197522,283,10.653,372,14.003,30295,10731,19564,5.433,15.338,35143,15758,19385,7.978,17.792,-4848,-2.454,30.675,4,4,66
1989,Utility Patent Granted,22,110,2804,280210,284938,81,2.831,195,6.816,11880,2364,9516,0.830,4.169,21082,6984,14098,2.451,7.399,-9202,-3.229,8.339,0,0,0
1989,Utility Patent Granted,23,599,2302,199558,204283,205,8.624,355,14.935,45352,12020,33332,5.884,22.201,55085,20888,34197,10.225,26.965,-9733,-4.764,44.401,25,27,259
1989,Utility Patent Granted,31-33,8060,33337,8566859,8539617,1528,4.559,1885,5.624,778851,201446,577405,2.359,9.120,724262,219972,504290,2.576,8.481,54589,0.639,16.962,201,228,10566
1989,Utility Patent Granted,42,3256,34189,956997,956374,3345,9.702,3922,11.376,174019,61331,112688,6.413,18.196,173031,85606,87425,8.951,18.092,988,0.103,36.185,96,131,1582
1989,Utility Patent Granted,44-45,1138,67610,849407,847999,6039,8.991,5153,7.672,152025,60784,91241,7.168,17.927,150869,46404,104465,5.472,17.791,1156,0.136,35.582,37,59,431
1989,Utility Patent Granted,48-49,827,6951,555680,540564,691,10.044,549,7.980,96677,35335,61342,6.537,17.884,69132,20716,48416,3.832,12.789,27545,5.096,25.578,4,4,94
1989,Utility Patent Granted,51,406,20351,1204496,1202886,3464,17.936,1388,7.187,197994,59862,138132,4.977,16.460,194476,59282,135194,4.928,16.167,3518,0.292,32.335,9,10,1674
1989,Utility Patent Granted,52,360,28260,845778,844904,2879,10.218,2710,9.618,149128,54845,94283,6.491,17.650,146942,61971,84971,7.335,17.392,2186,0.259,34.783,10,10,34
1989,Utility Patent Granted,53,458,4129,56112,55133,605,15.150,334,8.364,13425,4241,9184,7.692,24.350,11170,3536,7634,6.414,20.260,2255,4.090,40.521,10,18,178
1989,Utility Patent Granted,54,2195,7560,698736,695707,1146,15.384,925,12.417,118336,46935,71401,6.746,17.009,112683,40956,71727,5.887,16.197,5653,0.813,32.394,83,86,829
1989,Utility Patent Granted,55,2266,14309,1574649,1565627,1858,13.170,1456,10.320,266005,85153,180852,5.439,16.990,249276,62205,187071,3.973,15.922,16729,1.069,31.844,12,16,750
1989,Utility Patent Granted,56,623,5251,339415,329488,1049,21.016,530,10.618,78676,30580,48096,9.281,23.878,59413,26533,32880,8.053,18.032,19263,5.846,36.064,14,15,422
1989,Utility Patent Granted,61,131,419,354406,345355,44,10.641,33,7.981,30450,6435,24015,1.863,8.817,11847,879,10968,0.255,3.430,18603,5.387,6.861,3,3,5
1989,Utility Patent Granted,62,257,3716,517365,512699,594,16.511,357,9.924,51437,10860,40577,2.118,10.033,39990,4969,35021,0.969,7.800,11447,2.233,15.600,7,7,41
1989,Utility Patent Granted,71,132,784,56516,55414,74,9.579,51,6.602,7659,1853,5806,3.344,13.821,5101,619,4482,1.117,9.205,2558,4.616,18.411,4,4,50
1989,Utility Patent Granted,72,274,23204,822488,789560,2622,11.545,1638,7.212,162715,68878,93837,8.724,20.608,94511,35897,58614,4.546,11.970,68204,8.638,23.940,8,13,586
1989,Utility Patent Granted,81,710,4929,164122,156900,814,17.222,409,8.653,35437,11794,23643,7.517,22.586,21306,8814,12492,5.618,13.579,14131,9.006,27.159,15,48,689
1990,No Utility Patent Granted,11,19637,20017,171278,169614,3298,16.743,2660,13.504,45232,18690,26542,11.019,26.668,41946,15415,26531,9.088,24.730,3286,1.937,49.461,1933,1945,10315
1990,No Utility Patent Granted,21,20089,22594,357328,350238,2710,11.917,3003,13.206,77416,25674,51742,7.330,22.104,63188,25752,37436,7.353,18.041,14228,4.062,36.083,2201,2235,16440
1990,No Utility Patent Granted,22,6324,10330,520211,515703,761,7.454,520,5.093,34105,14081,20024,2.730,6.613,25530,4839,20691,0.938,4.951,8575,1.663,9.901,339,339,2056
1990,No Utility Patent Granted,23,513338,517741,5086133,5035451,81526,15.892,72074,14.049,1310753,376174,934579,7.471,26.030,1209705,375426,834279,7.456,24.024,101048,2.007,48.048,55010,55077,299176
1990,No Utility Patent Granted,31-33,288879,311714,8632499,8671528,32279,10.402,29475,9.499,1152950,360173,792777,4.154,13.296,1234107,368277,865830,4.247,14.232,-81157,-0.936,26.592,23458,23649,253261
1990,No Utility Patent Granted,42,285567,336786,4015884,3981513,37366,11.160,33415,9.980,653243,208937,444306,5.248,16.407,585491,219394,366097,5.510,14.705,67752,1.702,29.410,25411,26232,157877
1990,No Utility Patent Granted,44-45,732560,1025258,12046961,11963519,114677,11.203,111400,10.883,1908987,799542,1109445,6.683,15.957,1746489,642915,1103574,5.374,14.598,162498,1.358,29.197,79821,84097,414335
1990,No Utility Patent Granted,48-49,108025,129892,2625584,2578984,20121,15.619,17982,13.959,515794,170505,345289,6.611,20.000,421992,161137,260855,6.248,16.363,93802,3.637,32.725,13482,13682,90604
1990,No Utility Patent Granted,51,50140,62058,1467154,1434441,9535,15.537,8158,13.293,268679,99512,169167,6.937,18.731,202720,88069,114651,6.140,14.132,65959,4.598,28.265,5686,5781,47254
1990,No Utility Patent Granted,52,177434,285426,4714967,4676370,34398,12.226,26255,9.332,770646,280329,490317,5.995,16.480,692727,227891,464836,4.873,14.813,77919,1.666,29.627,15473,15590,99369
1990,No Utility Patent Granted,53,201818,223440,1618013,1593685,33344,15.031,30138,13.586,373029,161324,211705,10.123,23.407,324385,142898,181487,8.967,20.354,48644,3.052,40.709,23144,23550,99869
1990,No Utility Patent Granted,54,421871,448681,4046180,3952253,64448,14.576,51391,11.623,824404,294517,529887,7.452,20.859,637811,242111,395700,6.126,16.138,186593,4.721,32.276,39635,39953,178249
1990,No Utility Patent Granted,55,25323,37782,1658192,1630712,5235,14.256,3116,8.485,317608,105291,212317,6.457,19.477,262949,65312,197637,4.005,16.125,54659,3.352,32.250,1026,1052,12082
1990,No Utility Patent Granted,56,206680,230188,4219746,4070037,42317,18.810,31892,14.176,1145084,401099,743985,9.855,28.134,846902,292975,553927,7.198,20.808,298182,7.326,41.616,24968,25259,194980
1990,No Utility Patent Granted,61,38667,42794,1486359,1455962,5436,12.938,3881,9.237,190780,51059,139721,3.507,13.103,130423,40942,89481,2.812,8.958,60357,4.146,17.916,2896,2944,21535
1990,No Utility Patent Granted,62,455085,519274,9903022,9668919,48244,9.412,34853,6.800,1264532,404760,859772,4.186,13.078,794781,272042,522739,2.814,8.220,469751,4.858,16.440,26931,27496,180710
1990,No Utility Patent Granted,71,65439,69836,1040499,1008678,10596,15.233,10047,14.443,225671,76800,148871,7.614,22.373,162069,61856,100213,6.132,16.067,63602,6.305,32.135,7775,7852,46882
1990,No Utility Patent Granted,72,324460,404953,7343262,7251428,62776,15.626,56326,14.021,1544007,792131,751876,10.924,21.292,1361600,591176,770424,8.153,18.777,182407,2.515,37.554,42894,44073,420781
1990,No Utility Patent Granted,81,557547,604832,4363890,4292619,67233,11.219,56157,9.371,767040,267326,499714,6.228,17.869,624374,213041,411333,4.963,14.545,142666,3.324,29.091,42746,43437,161417
1990,Utility Patent Granted,11,71,236,12093,12089,26,11.354,12,5.240,848,257,591,2.126,7.015,846,160,686,1.324,6.998,2,0.017,13.996,D,D,D
1990,Utility Patent Granted,21,266,2820,210769,212172,272,9.562,321,11.285,26409,5437,20972,2.563,12.447,29086,10880,18206,5.128,13.709,-2677,-1.262,24.894,3,3,4
1990,Utility Patent Granted,22,104,2884,256800,255951,222,7.861,102,3.612,16764,5124,11640,2.002,6.550,15142,1978,13164,0.773,5.916,1622,0.634,11.832,0,0,0
1990,Utility Patent Granted,23,609,2427,237753,228500,248,10.312,204,8.482,60530,9445,51085,4.133,26.490,41795,8455,33340,3.700,18.291,18735,8.199,36.582,29,29,565
1990,Utility Patent Granted,31-33,8255,33734,8434481,8532694,1476,4.368,1583,4.685,592541,157817,434724,1.850,6.944,785921,191458,594463,2.244,9.211,-193380,-2.266,13.889,208,213,7505
1990,Utility Patent Granted,42,3381,35017,1015114,994546,3473,9.996,2929,8.430,174219,64681,109538,6.504,17.517,132379,45723,86656,4.597,13.310,41840,4.207,26.621,106,114,1590
1990,Utility Patent Granted,44-45,1166,69626,926886,901562,5567,8.045,4713,6.811,187871,63529,124342,7.047,20.838,135133,41325,93808,4.584,14.989,52738,5.850,29.978,41,43,293
1990,Utility Patent Granted,48-49,831,7295,584412,573212,487,6.721,388,5.355,62416,13487,48929,2.353,10.889,39827,12008,27819,2.095,6.948,22589,3.941,13.896,6,6,59
1990,Utility Patent Granted,51,406,20841,1264577,1250754,1801,8.647,1777,8.531,156570,51086,105484,4.084,12.518,130158,32253,97905,2.579,10.406,26412,2.112,20.813,9,10,190
1990,Utility Patent Granted,52,375,25639,769148,759268,2911,11.485,2326,9.177,137418,56301,81117,7.415,18.099,117917,27856,90061,3.669,15.530,19501,2.568,31.061,11,12,449
1990,Utility Patent Granted,53,452,4662,65293,63500,424,9.192,325,7.046,14568,6293,8275,9.910,22.942,10799,3454,7345,5.439,17.006,3769,5.935,34.013,14,15,201
1990,Utility Patent Granted,54,2346,7991,735543,717276,1160,14.872,778,9.974,114566,38240,76326,5.331,15.972,78974,18708,60266,2.608,11.010,35592,4.962,22.021,91,96,1358
1990,Utility Patent Granted,55,2324,14254,1599777,1583895,1568,11.055,1428,10.068,241531,79564,161967,5.023,15.249,208922,50842,158080,3.210,13.190,32609,2.059,26.381,8,11,279
1990,Utility Patent Granted,56,666,5351,355680,345354,550,10.307,520,9.745,72151,20251,51900,5.864,20.892,50688,15073,35615,4.365,14.677,21463,6.215,29.354,15,17,175
1990,Utility Patent Granted,61,135,424,360033,355388,35,8.353,25,5.967,20761,3428,17333,0.965,5.842,11630,179,11451,0.050,3.272,9131,2.569,6.545,D,D,D
1990,Utility Patent Granted,62,277,3400,495395,482384,290,8.542,280,8.247,45999,8425,37574,1.747,9.536,19626,5926,13700,1.228,4.069,26373,5.467,8.137,11,11,159
1990,Utility Patent Granted,71,152,673,62500,58923,53,7.726,79,11.516,10995,1409,9586,2.391,18.660,3681,1294,2387,2.196,6.247,7314,12.413,12.494,8,8,37
1990,Utility Patent Granted,72,287,23157,799778,792070,2567,11.225,1992,8.710,141599,62540,79059,7.896,17.877,124785,39256,85529,4.956,15.754,16814,2.123,31.509,14,14,268
1990,Utility Patent Granted,81,706,5356,169250,169011,550,10.507,307,5.865,26140,7077,19063,4.187,15.466,25054,7559,17495,4.473,14.824,1086,0.643,29.648,16,16,209
1991,No Utility Patent Granted,11,20070,20399,171697,173519,2889,14.156,2909,14.254,43135,15652,27483,9.020,24.859,47041,16188,30853,9.329,27.110,-3906,-2.251,49.718,2076,2081,11948
1991,No Utility Patent Granted,21,20769,23286,352930,354325,2794,11.969,2910,12.466,73495,30227,43268,8.531,20.742,76497,27349,49148,7.719,21.590,-3002,-0.847,41.485,2152,2183,18367
1991,No Utility Patent Granted,22,6391,10983,486402,487665,1129,10.531,604,5.634,38341,20292,18049,4.161,7.862,40830,7572,33258,1.553,8.373,-2489,-0.510,15.724,399,401,3213
1991,No Utility Patent Granted,23,509825,514028,4500960,4799365,71122,13.700,81372,15.674,949843,289575,660268,6.034,19.791,1549458,443559,1105899,9.242,32.285,-599615,-12.494,39.582,58983,59078,338778
1991,No Utility Patent Granted,31-33,288642,310965,7974317,8246703,28632,9.154,32245,10.309,958166,294414,663752,3.570,11.619,1502551,552074,950477,6.694,18.220,-544385,-6.601,23.238,25321,25614,395682
1991,No Utility Patent Granted,42,274371,325410,3729780,3798191,36828,11.319,36720,11.286,547124,191179,355945,5.033,14.405,685726,273425,412301,7.199,18.054,-138602,-3.649,28.810,27162,27946,196059
1991,No Utility Patent Granted,44-45,713648,1011491,11712939,11890712,105097,10.309,121145,11.883,1694806,747897,946909,6.290,14.253,2051268,768480,1282788,6.463,17.251,-356462,-2.998,28.506,82733,87665,483340
1991,No Utility Patent Granted,48-49,108051,130846,2521180,2532999,20029,15.352,19259,14.762,469291,166255,303036,6.564,18.527,492059,189200,302859,7.469,19.426,-22768,-0.899,37.054,13852,14085,104608
1991,No Utility Patent Granted,51,49722,64408,1499246,1503771,10134,15.950,8388,13.202,228493,101988,126505,6.782,15.195,237754,92653,145101,6.161,15.811,-9261,-0.616,30.389,5937,6065,55806
1991,No Utility Patent Granted,52,175063,310832,4786466,4852046,52129,17.419,28995,9.689,915896,503667,412229,10.381,18.876,1050059,288791,761268,5.952,21.642,-134163,-2.765,37.753,16268,16799,144243
1991,No Utility Patent Granted,53,192412,221266,1511189,1537239,35457,16.152,31965,14.561,360623,191860,168763,12.481,23.459,412012,177176,234836,11.526,26.802,-51389,-3.343,46.918,24327,24756,118528
1991,No Utility Patent Granted,54,420510,450277,3968119,3981827,63847,14.319,55103,12.358,729377,283096,446281,7.110,18.318,758448,296751,461697,7.453,19.048,-29071,-0.730,36.635,42213,42603,212877
1991,No Utility Patent Granted,55,26084,39483,1635634,1630973,4968,12.854,3299,8.536,287089,101753,185336,6.239,17.602,276639,60460,216179,3.707,16.962,10450,0.641,33.923,1169,1200,13290
1991,No Utility Patent Granted,56,212181,237433,4146833,4168740,40423,17.232,34725,14.803,1029101,402623,626478,9.658,24.686,1072900,386035,686865,9.260,25.737,-43799,-1.051,49.372,26570,26898,272693
1991,No Utility Patent Granted,61,41152,45554,1539549,1518689,5542,12.337,4274,9.515,175425,45002,130423,2.963,11.551,134577,34785,99792,2.290,8.861,40848,2.690,17.723,3158,3239,26616
1991,No Utility Patent Granted,62,458935,530212,10220920,10074076,48327,9.207,37665,7.176,1252574,410385,842189,4.074,12.434,957704,368700,589004,3.660,9.507,294870,2.927,19.013,28746,29305,254655
1991,No Utility Patent Granted,71,62672,67124,1033317,1027798,9390,13.957,9694,14.409,197073,73159,123914,7.118,19.174,186585,69487,117098,6.761,18.154,10488,1.020,36.308,7515,7646,53350
1991,No Utility Patent Granted,72,323838,407410,7222734,7313432,59669,14.700,56699,13.968,1379296,749334,629962,10.246,18.860,1558600,638638,919962,8.732,21.311,-179304,-2.452,37.720,42718,44172,455793
1991,No Utility Patent Granted,81,564632,613350,4353880,4362606,62667,10.256,58043,9.499,701978,245511,456467,5.628,16.091,719322,240844,478478,5.521,16.488,-17344,-0.398,32.182,43251,43946,183342
1991,Utility Patent Granted,11,70,269,12149,12152,15,5.505,22,8.073,1500,504,996,4.148,12.344,1572,461,1111,3.794,12.937,-72,-0.593,24.688,0,0,0
1991,Utility Patent Granted,21,263,2761,217335,217335,239,8.548,309,11.052,26643,7929,18714,3.648,12.259,26467,9175,17292,4.222,12.178,176,0.081,24.356,8,8,582
1991,Utility Patent Granted,22,107,2897,288691,289680,98,3.373,115,3.958,15401,3279,12122,1.132,5.317,17208,3703,13505,1.278,5.940,-1807,-0.624,10.633,D,D,D
1991,Utility Patent Granted,23,625,2712,254762,257911,319,11.950,234,8.766,51083,14068,37015,5.455,19.806,57568,8694,48874,3.371,22.321,-6485,-2.514,39.613,32,32,328
1991,Utility Patent Granted,31-33,8498,34101,8112264,8333031,1182,3.426,1982,5.745,474990,112106,362884,1.345,5.700,918187,186908,731279,2.243,11.019,-443197,-5.319,11.400,346,368,28806
1991,Utility Patent Granted,42,3582,36594,1032509,1039674,3488,9.545,3384,9.261,161158,66635,94523,6.409,15.501,175075,60962,114113,5.864,16.839,-13917,-1.339,31.002,107,120,3263
1991,Utility Patent Granted,44-45,1172,66635,882319,890072,5312,8.004,4773,7.192,132678,52935,79743,5.947,14.906,150575,43520,107055,4.889,16.917,-17897,-2.011,29.813,47,51,625
1991,Utility Patent Granted,48-49,874,7618,673658,668898,659,8.728,524,6.940,66913,23721,43192,3.546,10.003,58070,12620,45450,1.887,8.681,8843,1.322,17.363,10,10,125
1991,Utility Patent Granted,51,430,22575,1209604,1225687,4672,21.729,2524,11.739,207434,116831,90603,9.532,16.924,241189,54380,186809,4.437,19.678,-33755,-2.754,33.848,12,12,331
1991,Utility Patent Granted,52,397,23778,771720,746418,3317,14.031,3041,12.864,181531,111411,70120,14.926,24.320,133909,41436,92473,5.551,17.940,47622,6.380,35.880,12,12,816
1991,Utility Patent Granted,53,489,5105,78036,78374,732,14.858,375,7.612,16437,9455,6982,12.064,20.973,17467,6146,11321,7.842,22.287,-1030,-1.314,41.945,18,18,80
1991,Utility Patent Granted,54,2445,9060,732351,736606,1026,11.368,956,10.593,96875,28152,68723,3.822,13.152,105500,30733,74767,4.172,14.322,-8625,-1.171,26.303,129,136,1958
1991,Utility Patent Granted,55,2423,15075,1611990,1619393,1901,12.857,1323,8.948,231055,81580,149475,5.038,14.268,245512,47900,197612,2.958,15.161,-14457,-0.893,28.536,9,11,213
1991,Utility Patent Granted,56,680,6038,381316,380010,1234,21.714,524,9.220,72425,32583,39842,8.574,19.059,69149,17093,52056,4.498,18.197,3276,0.862,36.393,23,23,408
1991,Utility Patent Granted,61,147,380,381078,378881,53,13.520,77,19.643,21118,598,20520,0.158,5.574,17200,2360,14840,0.623,4.540,3918,1.034,9.079,D,D,D
1991,Utility Patent Granted,62,286,3039,479975,471838,320,10.622,267,8.863,39310,4555,34755,0.965,8.331,22510,4275,18235,0.906,4.771,16800,3.561,9.541,20,20,359
1991,Utility Patent Granted,71,145,714,64128,62985,63,8.917,48,6.794,7109,1461,5648,2.320,11.287,4899,1296,3603,2.058,7.778,2210,3.509,15.556,16,17,133
1991,Utility Patent Granted,72,289,22843,721016,724991,2554,11.364,1817,8.085,102148,54142,48006,7.468,14.090,109973,28497,81476,3.931,15.169,-7825,-1.079,28.179,18,18,263
1991,Utility Patent Granted,81,727,7478,175315,177744,1812,26.716,421,6.207,33042,20916,12126,11.767,18.590,37432,7205,30227,4.054,21.060,-4390,-2.470,37.179,22,26,186
1992,No Utility Patent Granted,11,20209,20526,173641,171167,3015,14.760,2818,13.795,44861,14847,30014,8.674,26.209,40022,13806,26216,8.066,23.382,4839,2.827,46.764,2109,2116,10872
1992,No Utility Patent Granted,21,19562,21836,308579,322808,2282,10.223,3254,14.578,52722,20676,32046,6.405,16.332,81557,30658,50899,9.497,25.265,-28835,-8.933,32.665,2311,2338,17653
1992,No Utility Patent Granted,22,5599,10572,457836,457147,872,8.396,500,4.814,48027,25297,22730,5.534,10.506,46891,5950,40941,1.302,10.257,1136,0.248,20.515,299,300,1409
1992,No Utility Patent Granted,23,497862,501960,4255967,4337269,72719,14.393,79255,15.687,1017082,290913,726169,6.707,23.450,1179488,356367,823121,8.216,27.194,-162406,-3.744,46.900,57530,57590,269518
1992,No Utility Patent Granted,31-33,281265,302633,7865189,7878987,26984,8.859,30920,10.151,1057246,281075,776171,3.567,13.419,1084685,366523,718162,4.652,13.767,-27439,-0.348,26.837,23960,24137,243627
1992,No Utility Patent Granted,42,287194,337920,3835433,3832071,36582,10.833,36124,10.697,605002,190340,414662,4.967,15.788,598704,209843,388861,5.476,15.624,6298,0.164,31.247,24521,25466,135350
1992,No Utility Patent Granted,44-45,691359,983134,11477715,11536018,104111,10.511,118824,11.996,1724443,734709,989734,6.369,14.948,1845422,688441,1156981,5.968,15.997,-120979,-1.049,29.897,74140,78582,371862
1992,No Utility Patent Granted,48-49,109175,132584,2420473,2442869,19722,14.970,18040,13.693,421627,138788,282839,5.681,17.260,470417,152948,317469,6.261,19.257,-48790,-1.997,34.519,12884,13058,83849
1992,No Utility Patent Granted,51,49825,65202,1494715,1564493,9110,14.096,7959,12.315,238717,92398,146319,5.906,15.258,379020,122515,256505,7.831,24.226,-140303,-8.968,30.517,5218,5376,62947
1992,No Utility Patent Granted,52,173906,318097,4687189,4727849,32839,10.393,28586,9.047,769885,254602,515283,5.385,16.284,851613,283368,568245,5.994,18.013,-81728,-1.729,32.568,14092,14535,111109
1992,No Utility Patent Granted,53,192734,223663,1479914,1496382,30287,13.588,28758,12.902,323676,137196,186480,9.169,21.631,354686,143318,211368,9.578,23.703,-31010,-2.072,43.261,20531,21162,95021
1992,No Utility Patent Granted,54,429598,459395,3890091,3878722,61584,13.550,51811,11.399,739811,263637,476174,6.797,19.074,713379,304851,408528,7.860,18.392,26432,0.681,36.784,37016,37340,225374
1992,No Utility Patent Granted,55,25909,38592,1636148,1630174,3597,9.203,4584,11.728,300330,86217,214113,5.289,18.423,288311,76755,211556,4.708,17.686,12019,0.737,35.372,878,904,14089
1992,No Utility Patent Granted,56,211518,239104,4345013,4257305,39436,16.612,36015,15.171,1136497,411806,724691,9.673,26.695,956812,350049,606763,8.222,22.475,179685,4.221,44.949,26782,27032,223298
1992,No Utility Patent Granted,61,41418,46506,1570882,1548200,5528,12.042,4330,9.432,173992,35763,138229,2.310,11.238,128030,32909,95121,2.126,8.270,45962,2.969,16.539,3141,3201,23998
1992,No Utility Patent Granted,62,466517,542884,10774668,10516857,48340,9.008,35831,6.677,1530676,492682,1037994,4.685,14.555,1016533,310007,706526,2.948,9.666,514143,4.889,19.331,25265,25766,197200
1992,No Utility Patent Granted,71,63461,67964,1071345,1049581,9635,14.303,8431,12.516,230164,78971,151193,7.524,21.929,185795,72977,112818,6.953,17.702,44369,4.227,35.404,6109,6165,43355
1992,No Utility Patent Granted,72,328738,411930,7312404,7251632,60105,14.660,56229,13.715,1482699,730252,752447,10.070,20.446,1365734,617388,748346,8.514,18.833,116965,1.613,37.667,39085,40130,386496
1992,No Utility Patent Granted,81,573844,624228,4400061,4383771,62534,10.060,57326,9.222,732040,236800,495240,5.402,16.699,698938,230767,468171,5.264,15.944,33102,0.755,31.888,40106,40640,163327
1992,Utility Patent Granted,11,74,263,13268,13156,21,7.865,29,10.861,1976,598,1378,4.546,15.020,1738,447,1291,3.398,13.211,238,1.809,26.422,0,0,0
1992,Utility Patent Granted,21,287,2814,211767,220091,328,11.427,441,15.363,35339,11152,24187,5.067,16.057,51115,14769,36346,6.710,23.224,-15776,-7.168,32.113,3,3,414
1992,Utility Patent Granted,22,118,3055,314859,315665,255,8.497,147,4.898,34247,16008,18239,5.071,10.849,35607,17534,18073,5.555,11.280,-1360,-0.431,21.698,D,D,D
1992,Utility Patent Granted,23,619,2766,253833,263750,185,6.578,278,9.884,43079,6931,36148,2.628,16.333,62612,10509,52103,3.984,23.739,-19533,-7.406,32.667,27,28,734
1992,Utility Patent Granted,31-33,8625,33998,7989890,8090273,907,2.626,1987,5.753,576791,125450,451341,1.551,7.129,776328,223821,552507,2.767,9.596,-199537,-2.466,14.259,193,204,6737
1992,Utility Patent Granted,42,3722,34387,989776,1016632,2511,7.074,4726,13.315,182577,60329,122248,5.934,17.959,235646,100981,134665,9.933,23.179,-53069,-5.220,35.918,107,173,2069
1992,Utility Patent Granted,44-45,1143,66916,852810,869283,4482,6.616,6141,9.065,124462,42034,82428,4.835,14.318,153077,57840,95237,6.654,17.610,-28615,-3.292,28.636,50,57,332
1992,Utility Patent Granted,48-49,898,8191,741734,728112,887,11.060,545,6.796,91573,36626,54947,5.030,12.577,62831,12814,50017,1.760,8.629,28742,3.947,17.259,6,6,84
1992,Utility Patent Granted,51,455,22344,1149605,1170922,2164,9.606,2531,11.235,151295,57516,93779,4.912,12.921,193153,73682,119471,6.293,16.496,-41858,-3.575,25.842,12,16,138
1992,Utility Patent Granted,52,424,18916,669846,666898,2045,10.886,1784,9.497,104456,36725,67731,5.507,15.663,99471,31471,68000,4.719,14.915,4985,0.747,29.831,8,8,117
1992,Utility Patent Granted,53,525,5419,90341,89680,488,9.017,474,8.758,18201,7597,10604,8.471,20.295,16529,5934,10595,6.617,18.431,1672,1.864,36.862,15,15,148
1992,Utility Patent Granted,54,2541,10316,775498,773738,1319,13.001,977,9.630,121288,40410,80878,5.223,15.676,116760,33758,83002,4.363,15.090,4528,0.585,30.181,104,106,1880
1992,Utility Patent Granted,55,2487,14865,1577324,1601481,1283,8.571,1492,9.967,271729,68766,202963,4.294,16.967,320891,96253,224638,6.010,20.037,-49162,-3.070,33.935,9,18,208
1992,Utility Patent Granted,56,708,5034,369210,369941,701,14.229,486,9.865,66182,26078,40104,7.049,17.890,68694,21614,47080,5.843,18.569,-2512,-0.679,35.780,19,19,576
1992,Utility Patent Granted,61,159,381,404727,397173,23,6.013,26,6.797,26365,551,25814,0.139,6.638,11025,743,10282,0.187,2.776,15340,3.862,5.552,D,D,D
1992,Utility Patent Granted,62,313,3456,507448,499120,422,12.644,185,5.543,46952,11012,35940,2.206,9.407,31092,6737,24355,1.350,6.229,15860,3.178,12.459,11,11,65
1992,Utility Patent Granted,71,151,757,71085,70777,50,6.649,40,5.319,7934,2929,5005,4.138,11.210,7232,781,6451,1.103,10.218,702,0.992,20.436,10,10,224
1992,Utility Patent Granted,72,298,25021,815104,805763,2558,10.430,1569,6.397,122152,65166,56986,8.087,15.160,103609,28388,75221,3.523,12.858,18543,2.301,25.717,12,12,52
1992,Utility Patent Granted,81,691,7602,177788,178005,537,7.066,532,7.000,26808,8978,17830,5.044,15.060,27240,8902,18338,5.001,15.303,-432,-0.243,30.121,15,16,85
1993,No Utility Patent Granted,11,20655,20977,172631,173292,3024,14.502,2775,13.308,42106,13823,28283,7.977,24.298,43390,14656,28734,8.457,25.039,-1284,-0.741,48.595,2007,2009,10622
1993,No Utility Patent Granted,21,18983,21351,310253,313512,2301,10.657,2782,12.885,54843,18348,36495,5.852,17.493,61331,22411,38920,7.148,19.563,-6488,-2.069,34.986,2058,2077,15356
1993,No Utility Patent Granted,22,5911,10734,446289,449102,618,5.816,403,3.792,30313,8437,21876,1.879,6.750,36198,5657,30541,1.260,8.060,-5885,-1.310,13.499,217,221,1339
1993,No Utility Patent Granted,23,502577,506699,4308682,4275050,78882,15.703,70127,13.961,1090953,309687,781266,7.244,25.519,1023588,313143,710445,7.325,23.943,67365,1.576,47.887,51759,51800,240716
1993,No Utility Patent Granted,31-33,283583,305156,7989188,7920109,28954,9.515,27248,8.954,1107904,287301,820603,3.627,13.988,970703,304879,665824,3.849,12.256,137201,1.732,24.512,21464,21665,209016
1993,No Utility Patent Granted,42,291258,340890,3887713,3853203,36151,10.657,32832,9.678,604948,175519,429429,4.555,15.700,535531,190008,345523,4.931,13.898,69417,1.802,27.797,24220,24807,130340
1993,No Utility Patent Granted,44-45,692290,986016,11829146,11685962,100430,10.178,101947,10.331,1864483,753570,1110913,6.449,15.955,1586630,583223,1003407,4.991,13.577,277853,2.378,27.154,66226,69626,318361
1993,No Utility Patent Granted,48-49,113402,136776,2482134,2451971,20550,15.243,16637,12.340,435571,131708,303863,5.372,17.764,372767,134623,238144,5.490,15.203,62804,2.561,30.405,12114,12303,79496
1993,No Utility Patent Granted,51,51650,68807,1579231,1563873,9041,13.315,7227,10.644,250778,88623,162155,5.667,16.036,220379,84975,135404,5.434,14.092,30399,1.944,28.184,4764,4927,48669
1993,No Utility Patent Granted,52,179482,319174,4648151,4663185,33307,10.437,33192,10.401,769611,255675,513936,5.483,16.504,808689,349684,459005,7.499,17.342,-39078,-0.838,33.008,13039,13862,73972
1993,No Utility Patent Granted,53,197623,228563,1524945,1502301,30321,13.405,25588,11.312,335704,130518,205186,8.688,22.346,290493,114920,175573,7.650,19.337,45211,3.009,38.673,18676,19077,76667
1993,No Utility Patent Granted,54,445098,473553,4068382,3987523,64013,13.729,49455,10.606,781065,269458,511607,6.758,19.588,619814,207435,412379,5.202,15.544,161251,4.044,31.088,35426,37213,146154
1993,No Utility Patent Granted,55,25810,37481,1605617,1622651,3305,8.688,4421,11.622,293538,84131,209407,5.185,18.090,328099,98028,230071,6.041,20.220,-34561,-2.130,36.180,842,884,11474
1993,No Utility Patent Granted,56,220192,247094,4727632,4533284,41060,16.911,32463,13.371,1303905,407285,896620,8.984,28.763,913287,326386,586901,7.200,20.146,390618,8.617,40.293,24161,24619,218635
1993,No Utility Patent Granted,61,43040,48122,1610465,1581955,5786,12.235,4123,8.718,191491,41426,150065,2.619,12.105,135226,31672,103554,2.002,8.548,56265,3.557,17.096,2909,2989,22272
1993,No Utility Patent Granted,62,474104,554067,11124926,10931371,47634,8.685,36431,6.642,1427676,407176,1020500,3.725,13.060,1044678,339564,705114,3.106,9.557,382998,3.504,19.113,26519,27122,182948
1993,No Utility Patent Granted,71,65632,70202,1118236,1088901,9777,14.144,7624,11.029,233505,83620,149885,7.679,21.444,174172,51686,122486,4.747,15.995,59333,5.449,31.990,5620,5684,36339
1993,No Utility Patent Granted,72,337530,418273,7393982,7325918,57904,13.966,50577,12.199,1430385,694295,736090,9.477,19.525,1292916,530161,762755,7.237,17.649,137469,1.876,35.297,36349,37550,345819
1993,No Utility Patent Granted,81,580911,630293,4491228,4435696,59777,9.533,53247,8.492,737413,216489,520924,4.881,16.625,627150,192358,434792,4.337,14.139,110263,2.486,28.277,38619,39349,138156
1993,Utility Patent Granted,11,70,251,13162,12683,17,6.719,21,8.300,2752,1193,1559,9.407,21.699,1757,500,1257,3.942,13.854,995,7.845,27.707,0,0,0
1993,Utility Patent Granted,21,282,2594,170602,185166,294,11.105,401,15.146,26195,11177,15018,6.036,14.147,55376,14922,40454,8.059,29.906,-29181,-15.759,28.294,4,4,23
1993,Utility Patent Granted,22,128,3338,312842,316739,276,8.395,175,5.323,29088,8803,20285,2.779,9.184,36890,4769,32121,1.506,11.647,-7802,-2.463,18.367,0,0,0
1993,Utility Patent Granted,23,607,2657,242252,247902,166,6.173,230,8.553,38836,4624,34212,1.865,15.666,50602,6186,44416,2.495,20.412,-11766,-4.746,31.332,19,19,105
1993,Utility Patent Granted,31-33,8691,33496,7887036,7959281,952,2.821,1442,4.274,548055,101697,446358,1.278,6.886,691032,157289,533743,1.976,8.682,-142977,-1.796,13.771,182,192,4908
1993,Utility Patent Granted,42,3850,35027,1005657,1001267,3079,8.786,3113,8.883,161082,51606,109476,5.154,16.088,152207,45967,106240,4.591,15.201,8875,0.886,30.403,106,131,1734
1993,Utility Patent Granted,44-45,1129,60779,804688,797202,2815,4.559,4751,7.694,131576,32453,99123,4.071,16.505,116271,36341,79930,4.559,14.585,15305,1.920,29.170,33,49,464
1993,Utility Patent Granted,48-49,894,8185,722147,733447,480,5.819,608,7.371,60038,9647,50391,1.315,8.186,85194,16740,68454,2.282,11.616,-25156,-3.430,16.371,6,6,63
1993,Utility Patent Granted,51,482,20034,1092771,1104636,2099,10.324,2693,13.246,150982,50890,100092,4.607,13.668,173538,53229,120309,4.819,15.710,-22556,-2.042,27.336,6,6,118
1993,Utility Patent Granted,52,412,17881,616666,638490,1205,6.552,2226,12.103,102454,19363,83091,3.033,16.046,142818,47701,95117,7.471,22.368,-40364,-6.322,32.093,7,7,559
1993,Utility Patent Granted,53,502,5530,87070,90066,323,5.702,593,10.468,17463,3068,14395,3.406,19.389,23186,7069,16117,7.849,25.743,-5723,-6.354,38.778,15,21,49
1993,Utility Patent Granted,54,2665,11153,785949,799187,1374,12.507,1040,9.467,120458,43670,76788,5.464,15.073,146996,34252,112744,4.286,18.393,-26538,-3.321,30.145,113,125,1144
1993,Utility Patent Granted,55,2498,14000,1555846,1568910,1182,8.209,1980,13.751,236174,47780,188394,3.045,15.053,262790,60930,201860,3.884,16.750,-26616,-1.696,30.107,11,11,446
1993,Utility Patent Granted,56,729,5697,405678,391877,704,12.441,627,11.081,86801,24901,61900,6.354,22.150,59917,14800,45117,3.777,15.290,26884,6.860,30.580,19,19,213
1993,Utility Patent Granted,61,163,394,408491,398451,41,10.553,30,7.722,30547,10497,20050,2.634,7.666,9300,477,8823,0.120,2.334,21247,5.332,4.668,4,4,14
1993,Utility Patent Granted,62,317,3278,571816,562312,313,9.382,429,12.860,47202,7641,39561,1.359,8.394,28495,8693,19802,1.546,5.067,18707,3.327,10.135,10,15,246
1993,Utility Patent Granted,71,158,798,84998,83815,65,8.286,38,4.844,8159,1981,6178,2.364,9.735,5582,438,5144,0.523,6.660,2577,3.075,13.320,6,6,41
1993,Utility Patent Granted,72,315,25152,838317,849694,1589,6.213,2438,9.532,117073,44437,72636,5.230,13.778,139354,45583,93771,5.365,16.401,-22281,-2.622,27.557,14,14,110
1993,Utility Patent Granted,81,715,7626,173450,178602,344,4.404,713,9.129,17943,3522,14421,1.972,10.046,28617,9282,19335,5.197,16.023,-10674,-5.976,20.093,10,11,28
1994,No Utility Patent Granted,11,21306,21650,174576,173009,3358,15.767,2653,12.457,42581,14342,28239,8.290,24.612,39081,12786,26295,7.390,22.589,3500,2.023,45.178,1986,1986,9380
1994,No Utility Patent Granted,21,18704,21112,306872,308119,2165,10.156,2574,12.075,58711,19727,38984,6.402,19.055,61539,23796,37743,7.723,19.972,-2828,-0.918,38.109,1885,1904,13405
1994,No Utility Patent Granted,22,5894,11020,458647,464208,659,6.018,519,4.740,26809,12683,14126,2.732,5.775,37902,4431,33471,0.955,8.165,-11093,-2.390,11.550,265,280,1436
1994,No Utility Patent Granted,23,519333,523497,4535312,4433595,83495,16.210,66649,12.940,1173722,329448,844274,7.431,26.473,970661,301708,668953,6.805,21.893,203061,4.580,43.787,49382,49428,234219
1994,No Utility Patent Granted,31-33,285118,306939,8274627,8175529,28922,9.445,27445,8.963,1175535,320437,855098,3.919,14.379,979210,333156,646054,4.075,11.977,196325,2.401,23.955,21698,21897,230813
1994,No Utility Patent Granted,42,295557,346434,4014510,3969662,37420,10.864,33442,9.709,627057,180854,446203,4.556,15.796,537493,194403,343090,4.897,13.540,89564,2.256,27.080,24902,25670,135700
1994,No Utility Patent Granted,44-45,691993,989124,12174686,12014915,100750,10.188,100374,10.150,1886798,786410,1100388,6.545,15.704,1571773,574778,996995,4.784,13.082,315025,2.622,26.164,67657,71126,313527
1994,No Utility Patent Granted,48-49,117378,140684,2548734,2506579,21952,15.843,17699,12.774,445674,148057,297617,5.907,17.780,362761,136949,225812,5.464,14.472,82913,3.308,28.945,12971,13261,77195
1994,No Utility Patent Granted,51,53832,69238,1535732,1512640,9947,14.612,7616,11.188,258612,85575,173037,5.657,17.097,210687,85100,125587,5.626,13.928,47925,3.168,27.857,5109,5288,44850
1994,No Utility Patent Granted,52,178841,324399,4702458,4635222,39686,12.421,29916,9.363,851573,366960,484613,7.917,18.372,709301,286034,423267,6.171,15.302,142272,3.069,30.605,14931,15586,94293
1994,No Utility Patent Granted,53,201415,233473,1559972,1539299,31179,13.492,26421,11.433,328912,139612,189300,9.070,21.368,289231,117514,171717,7.634,18.790,39681,2.578,37.580,19289,19909,82807
1994,No Utility Patent Granted,54,460795,490241,4172491,4097694,66328,13.765,49574,10.288,792702,285063,507639,6.957,19.345,641616,217391,424225,5.305,15.658,151086,3.687,31.316,36615,37015,152993
1994,No Utility Patent Granted,55,25848,37620,1594455,1589476,3625,9.651,3506,9.334,269773,89966,179807,5.660,16.972,260332,82343,177989,5.181,16.378,9441,0.594,32.757,944,997,11935
1994,No Utility Patent Granted,56,229299,256795,5125066,4912115,42942,17.071,32447,12.899,1406111,441158,964953,8.981,28.625,979542,351550,627992,7.157,19.941,426569,8.684,39.883,25052,25422,245978
1994,No Utility Patent Granted,61,45006,50197,1647578,1623956,6302,12.809,4307,8.754,181573,36239,145334,2.232,11.181,134439,30716,103723,1.891,8.278,47134,2.902,16.557,3135,3294,24066
1994,No Utility Patent Granted,62,477902,563807,11310991,11177778,48302,8.638,39051,6.984,1297943,412208,885735,3.688,11.612,1031611,336577,695034,3.011,9.229,266332,2.383,18.458,29261,30159,215275
1994,No Utility Patent Granted,71,67940,72750,1180957,1153160,10363,14.486,7935,11.092,243119,91179,151940,7.907,21.083,187164,61602,125562,5.342,16.231,55955,4.852,32.461,5915,6029,44850
1994,No Utility Patent Granted,72,343094,429166,7733256,7627421,59667,14.019,52579,12.353,1529374,802477,726897,10.521,20.051,1316344,548846,767498,7.196,17.258,213030,2.793,34.516,39639,40963,382483
1994,No Utility Patent Granted,81,588405,637412,4560124,4530891,60624,9.559,54187,8.544,724728,231462,493266,5.109,15.995,664508,204456,460052,4.512,14.666,60220,1.329,29.332,39100,39892,145577
1994,Utility Patent Granted,11,73,253,14356,14424,29,11.694,19,7.661,2103,953,1150,6.607,14.580,2256,723,1533,5.012,15.641,-153,-1.061,29.160,0,0,0
1994,Utility Patent Granted,21,280,2682,181761,179152,365,13.860,268,10.177,29077,9732,19345,5.432,16.230,23640,5803,17837,3.239,13.196,5437,3.035,26.391,D,D,D
1994,Utility Patent Granted,22,120,3150,282322,286433,181,5.821,100,3.216,17313,3956,13357,1.381,6.044,25385,3729,21656,1.302,8.862,-8072,-2.818,12.089,D,D,D
1994,Utility Patent Granted,23,660,2679,219344,222993,200,7.470,197,7.358,37748,6522,31226,2.925,16.928,44798,7130,37668,3.197,20.089,-7050,-3.162,33.856,15,15,100
1994,Utility Patent Granted,31-33,8941,33767,7787249,7845502,1097,3.228,1540,4.531,570758,118215,452543,1.507,7.275,687653,175097,512556,2.232,8.765,-116895,-1.490,14.550,206,212,7588
1994,Utility Patent Granted,42,4009,34951,1003771,1008276,2937,8.389,3054,8.723,151233,49537,101696,4.913,14.999,159842,49955,109887,4.954,15.853,-8609,-0.854,29.998,92,112,1709
1994,Utility Patent Granted,44-45,1170,62001,883184,858903,4824,7.834,3985,6.471,156251,54113,102138,6.300,18.192,106858,33657,73201,3.919,12.441,49393,5.751,24.882,30,32,166
1994,Utility Patent Granted,48-49,922,9216,761098,755222,885,9.760,588,6.485,70822,16283,54539,2.156,9.378,59221,15055,44166,1.993,7.842,11601,1.536,15.683,3,3,38
1994,Utility Patent Granted,51,520,22363,1168665,1177100,2437,10.950,2221,9.980,167919,59602,108317,5.063,14.265,187860,64176,123684,5.452,15.960,-19941,-1.694,28.531,18,21,688
1994,Utility Patent Granted,52,411,19493,656856,664987,3875,19.930,3775,19.416,143251,62405,80846,9.384,21.542,160802,73420,87382,11.041,24.181,-17551,-2.639,43.084,9,9,54
1994,Utility Patent Granted,53,520,6278,83356,89278,914,15.114,453,7.491,15715,6897,8818,7.725,17.602,28125,9571,18554,10.721,31.503,-12410,-13.900,35.205,15,23,129
1994,Utility Patent Granted,54,2854,12011,799009,809514,1361,11.432,1149,9.651,97863,22362,75501,2.762,12.089,118631,37148,81483,4.589,14.655,-20768,-2.565,24.178,110,113,762
1994,Utility Patent Granted,55,2588,13783,1558490,1578768,1148,8.242,1441,10.345,204840,54626,150214,3.460,12.975,245911,67402,178509,4.269,15.576,-41071,-2.601,25.949,7,7,722
1994,Utility Patent Granted,56,727,6856,456229,458645,879,12.865,832,12.177,68683,21087,47596,4.598,14.975,74321,32588,41733,7.105,16.204,-5638,-1.229,29.950,37,40,846
1994,Utility Patent Granted,61,163,399,432971,430867,30,7.634,18,4.580,17407,426,16981,0.099,4.040,13326,1510,11816,0.350,3.093,4081,0.947,6.186,D,D,D
1994,Utility Patent Granted,62,332,4459,680993,676401,705,16.673,244,5.770,45915,12919,32996,1.910,6.788,36124,8614,27510,1.274,5.341,9791,1.448,10.681,6,6,71
1994,Utility Patent Granted,71,150,803,87482,84872,75,9.554,39,4.968,9247,2394,6853,2.821,10.895,4240,625,3615,0.736,4.996,5007,5.899,9.992,3,6,56
1994,Utility Patent Granted,72,313,22867,804414,778233,1823,8.050,1380,6.094,126359,64762,61597,8.322,16.237,74111,26170,47941,3.363,9.523,52248,6.714,19.046,12,12,41
1994,Utility Patent Granted,81,736,7626,172021,173170,605,7.977,522,6.882,26698,7627,19071,4.404,15.417,28583,11170,17413,6.450,16.506,-1885,-1.089,30.834,12,13,42
1995,No Utility Patent Granted,11,21832,22180,172393,171466,3325,15.177,2782,12.698,38047,12946,25101,7.550,22.189,36198,13365,22833,7.795,21.111,1849,1.078,42.222,2083,2086,10686
1995,No Utility Patent Granted,21,18351,20994,320510,319144,2135,10.093,2453,11.596,57526,19383,38143,6.073,18.025,54602,19096,35506,5.984,17.109,2924,0.916,34.218,1823,1841,13318
1995,No Utility Patent Granted,22,6026,10868,391176,394955,681,6.343,419,3.902,23656,8727,14929,2.210,5.990,31285,3624,27661,0.918,7.921,-7629,-1.932,11.979,233,234,1246
1995,No Utility Patent Granted,23,540960,545316,4883692,4719199,88162,16.497,66364,12.418,1237361,350742,886619,7.432,26.220,907676,293503,614173,6.219,19.234,329685,6.986,38.467,49969,50043,231256
1995,No Utility Patent Granted,31-33,286588,308435,8544806,8367314,28919,9.418,26149,8.516,1227383,299854,927529,3.584,14.669,869700,305259,564441,3.648,10.394,357683,4.275,20.788,21085,21203,207935
1995,No Utility Patent Granted,42,301244,352841,4202005,4102367,38448,11.004,31589,9.041,684190,194255,489935,4.735,16.678,484746,181400,303346,4.422,11.816,199444,4.862,23.633,24080,24870,132576
1995,No Utility Patent Granted,44-45,693921,986227,12541707,12302688,103347,10.504,98730,10.034,2005269,852624,1152645,6.930,16.299,1522386,620259,902127,5.042,12.374,482883,3.925,24.749,64839,68603,303965
1995,No Utility Patent Granted,48-49,122659,146411,2646438,2575412,23683,16.528,17448,12.176,487995,162579,325416,6.313,18.948,347174,126514,220660,4.912,13.480,140821,5.468,26.961,13227,13459,78817
1995,No Utility Patent Granted,51,56488,71853,1552319,1513730,10930,15.570,7624,10.860,281552,103727,177825,6.852,18.600,204720,81291,123429,5.370,13.524,76832,5.076,27.048,5299,5475,45905
1995,No Utility Patent Granted,52,180338,327813,4615445,4634768,35337,10.887,28861,8.892,642468,247462,395006,5.339,13.862,678041,220089,457952,4.749,14.629,-35573,-0.768,27.724,14412,15647,92177
1995,No Utility Patent Granted,53,203720,236024,1554572,1535581,31132,13.313,26785,11.454,314661,138018,176643,8.988,20.491,275839,110705,165134,7.209,17.963,38822,2.528,35.926,20044,20606,81164
1995,No Utility Patent Granted,54,479996,511530,4294686,4192940,70629,14.091,50049,9.985,815740,281931,533809,6.724,19.455,612540,208091,404449,4.963,14.609,203200,4.846,29.218,37135,37566,149218
1995,No Utility Patent Granted,55,25930,37699,1615764,1589273,3591,9.596,3033,8.105,293926,105495,188431,6.638,18.494,241458,73486,167972,4.624,15.193,52468,3.301,30.386,984,1019,14086
1995,No Utility Patent Granted,56,241106,269678,5536424,5290600,46275,17.608,32547,12.384,1491669,542275,949394,10.250,28.195,998028,340448,657580,6.435,18.864,493641,9.331,37.728,25245,25741,236242
1995,No Utility Patent Granted,61,46990,52294,1678688,1654285,6474,12.648,4255,8.313,180080,39020,141060,2.359,10.886,131058,27061,103997,1.636,7.922,49022,2.963,15.845,3213,3316,21534
1995,No Utility Patent Granted,62,480939,573888,11723190,11550945,50822,8.932,40995,7.205,1428565,482954,945611,4.181,12.368,1085754,364503,721251,3.156,9.400,342811,2.968,18.799,31052,32038,244122
1995,No Utility Patent Granted,71,70357,74905,1218370,1186837,10393,14.113,7868,10.684,244032,92858,151174,7.824,20.562,180987,56260,124727,4.740,15.250,63045,5.312,30.499,5898,5991,42630
1995,No Utility Patent Granted,72,349612,439493,8152143,7977435,62639,14.426,52062,11.990,1658517,860477,798040,10.786,20.790,1311000,561759,749241,7.042,16.434,347517,4.356,32.868,39490,40869,389624
1995,No Utility Patent Granted,81,597372,646726,4702467,4630976,62536,9.742,52930,8.246,750061,240692,509369,5.197,16.197,606016,194210,411806,4.194,13.086,144045,3.110,26.172,39327,40240,146039
1995,Utility Patent Granted,11,73,281,15847,16578,42,15.385,26,9.524,2866,1879,987,11.334,17.288,4403,1101,3302,6.641,26.559,-1537,-9.271,34.576,0,0,0
1995,Utility Patent Granted,21,274,2335,163917,166362,179,7.447,316,13.147,24227,5348,18879,3.215,14.563,29425,11088,18337,6.665,17.687,-5198,-3.125,29.126,3,3,5
1995,Utility Patent Granted,22,123,3684,330169,336888,302,8.337,179,4.941,18181,5370,12811,1.594,5.397,31855,2404,29451,0.714,9.456,-13674,-4.059,10.794,D,D,D
1995,Utility Patent Granted,23,656,2602,195745,196149,209,8.074,182,7.031,28832,7675,21157,3.913,14.699,29573,5366,24207,2.736,15.077,-741,-0.378,29.398,27,27,255
1995,Utility Patent Granted,31-33,8972,33852,7905908,7866770,1259,3.708,1469,4.326,641941,107145,534796,1.362,8.160,562447,135295,427152,1.720,7.150,79494,1.011,14.299,176,186,6162
1995,Utility Patent Granted,42,4149,35666,1028264,1021217,3187,8.950,3076,8.638,160628,59919,100709,5.867,15.729,147341,44726,102615,4.380,14.428,13287,1.301,28.856,134,153,2282
1995,Utility Patent Granted,44-45,1157,69050,1004676,999968,4908,7.097,5117,7.399,141075,52199,88876,5.220,14.108,132809,43971,88838,4.397,13.281,8266,0.827,26.563,46,89,1083
1995,Utility Patent Granted,48-49,959,10012,846494,824581,808,8.123,678,6.816,101912,18033,83879,2.187,12.359,59146,14909,44237,1.808,7.173,42766,5.186,14.346,6,7,171
1995,Utility Patent Granted,51,562,23457,1266459,1249524,2628,11.309,2190,9.424,199971,82687,117284,6.617,16.004,167529,37744,129785,3.021,13.407,32442,2.596,26.815,14,14,1513
1995,Utility Patent Granted,52,422,23547,684376,691403,3188,13.849,2132,9.262,99918,39541,60377,5.719,14.451,113337,27938,85399,4.041,16.392,-13419,-1.941,28.903,7,7,70
1995,Utility Patent Granted,53,513,9158,139568,131142,1618,18.765,547,6.344,40871,14366,26505,10.955,31.165,24248,7150,17098,5.452,18.490,16623,12.676,36.980,12,91,983
1995,Utility Patent Granted,54,3049,12119,888615,883813,1799,15.328,1034,8.810,134536,48373,86163,5.473,15.222,125784,35808,89976,4.052,14.232,8752,0.990,28.464,108,115,2330
1995,Utility Patent Granted,55,2682,14153,1599490,1593217,1325,9.336,1404,9.893,231312,64285,167027,4.035,14.519,219027,55745,163282,3.499,13.747,12285,0.771,27.495,14,15,561
1995,Utility Patent Granted,56,784,8229,567416,554625,1140,14.317,607,7.623,106215,36773,69442,6.630,19.151,78784,20967,57817,3.780,14.205,27431,4.946,28.410,25,28,238
1995,Utility Patent Granted,61,178,557,454390,450846,69,12.580,52,9.480,18906,1881,17025,0.417,4.193,12049,1295,10754,0.287,2.673,6857,1.521,5.345,6,9,25
1995,Utility Patent Granted,62,327,4496,586220,587545,694,16.140,302,7.023,45726,18799,26927,3.200,7.783,47599,14577,33022,2.481,8.101,-1873,-0.319,15.565,16,18,5953
1995,Utility Patent Granted,71,165,1388,118076,111958,267,20.949,40,3.138,21797,11019,10778,9.842,19.469,9030,3199,5831,2.857,8.066,12767,11.403,16.131,4,4,14
1995,Utility Patent Granted,72,332,23769,680706,700530,2603,11.104,1951,8.322,107318,55544,51774,7.929,15.320,146242,46574,99668,6.648,20.876,-38924,-5.556,30.639,17,18,301
1995,Utility Patent Granted,81,764,8167,184752,181208,585,7.201,499,6.142,32455,12566,19889,6.935,17.910,24079,5837,18242,3.221,13.288,8376,4.622,26.576,21,36,787
1996,No Utility Patent Granted,11,21973,22319,173157,173147,3141,14.119,2996,13.467,36149,12808,23341,7.397,20.878,36190,11784,24406,6.806,20.901,-41,-0.024,41.755,2260,2266,8912
1996,No Utility Patent Granted,21,17632,20421,311039,314415,1946,9.413,2450,11.851,49877,13369,36508,4.252,15.863,56736,22631,34105,7.198,18.045,-6859,-2.182,31.727,1820,1837,15237
1996,No Utility Patent Granted,22,6093,11341,414613,420617,598,5.282,559,4.938,23929,6815,17114,1.620,5.689,35805,6182,29623,1.470,8.512,-11876,-2.823,11.378,262,270,1677
1996,No Utility Patent Granted,23,552274,556644,5018864,4931961,81632,14.812,70563,12.804,1160952,329641,831311,6.684,23.539,986914,301496,685418,6.113,20.011,174038,3.529,40.021,53055,53105,239170
1996,No Utility Patent Granted,31-33,285682,307137,8331946,8363940,27265,8.880,27042,8.808,1028978,288163,740815,3.445,12.303,1091732,349543,742189,4.179,13.053,-62754,-0.750,24.605,21643,21867,238313
1996,No Utility Patent Granted,42,304205,356191,4196564,4167059,39502,11.174,34126,9.654,647625,206705,440920,4.960,15.542,588885,209692,379193,5.032,14.132,58740,1.410,28.264,25607,26386,154029
1996,No Utility Patent Granted,44-45,683173,984750,12713279,12594676,102779,10.462,97994,9.975,1930449,814926,1115523,6.470,15.328,1702833,607922,1094911,4.827,13.520,227616,1.807,27.041,66955,70380,330201
1996,No Utility Patent Granted,48-49,125773,150750,2722220,2679767,23048,15.484,19248,12.931,472326,166357,305969,6.208,17.626,386860,144782,242078,5.403,14.436,85466,3.189,28.873,14364,14651,86197
1996,No Utility Patent Granted,51,59238,74917,1598966,1565038,11943,16.349,8213,11.243,282185,111243,170942,7.108,18.031,215513,77002,138511,4.920,13.770,66672,4.260,27.541,5859,6079,50275
1996,No Utility Patent Granted,52,183873,328551,4578602,4522513,34587,10.652,26900,8.284,702357,251906,450451,5.570,15.530,590360,187445,402915,4.145,13.054,111997,2.476,26.108,13583,14674,74287
1996,No Utility Patent Granted,53,204485,238495,1560600,1552247,30496,12.857,27903,11.764,305406,128340,177066,8.268,19.675,288313,119444,168869,7.695,18.574,17093,1.101,37.148,20250,21124,87234
1996,No Utility Patent Granted,54,497998,532218,4561300,4460975,73295,14.039,52999,10.152,867746,304759,562987,6.832,19.452,667632,226624,441008,5.080,14.966,200114,4.486,29.932,39683,40116,160963
1996,No Utility Patent Granted,55,25609,38131,1630263,1621588,3561,9.416,2940,7.774,287629,93560,194069,5.770,17.737,268663,67413,201250,4.157,16.568,18966,1.170,33.136,982,1023,14607
1996,No Utility Patent Granted,56,242357,271948,5740759,5547096,45150,16.915,35104,13.151,1548414,542483,1005931,9.780,27.914,1164098,377236,786862,6.801,20.986,384316,6.928,41.971,27049,27415,258195
1996,No Utility Patent Granted,61,48771,54202,1636119,1623537,6761,12.709,4751,8.931,169948,41676,128272,2.567,10.468,145194,39055,106139,2.406,8.943,24754,1.525,17.886,3645,3723,29922
1996,No Utility Patent Granted,62,479532,578136,11741071,11653397,51103,8.890,44528,7.746,1413966,508833,905133,4.366,12.134,1235930,413212,822718,3.546,10.606,178036,1.528,21.211,33043,34193,257917
1996,No Utility Patent Granted,71,71916,76865,1272625,1248993,10524,13.893,8290,10.944,244423,92153,152270,7.378,19.570,197126,61163,135963,4.897,15.783,47297,3.787,31.566,6257,6318,47585
1996,No Utility Patent Granted,72,354307,448980,8347382,8242274,63697,14.349,53572,12.068,1638992,912703,726289,11.073,19.885,1426728,592251,834477,7.186,17.310,212264,2.575,34.620,40926,42144,405159
1996,No Utility Patent Granted,81,604260,655261,4800126,4745278,61655,9.467,53682,8.243,739697,236836,502861,4.991,15.588,628558,196159,432399,4.134,13.246,111139,2.342,26.492,39978,40779,147437
1996,Utility Patent Granted,11,69,320,15567,15506,36,11.613,16,5.161,2188,722,1466,4.656,14.111,2074,619,1455,3.992,13.376,114,0.735,26.752,D,D,D
1996,Utility Patent Granted,21,274,2206,155784,158148,222,10.045,230,10.407,23432,5014,18418,3.170,14.817,28005,11158,16847,7.055,17.708,-4573,-2.892,29.633,4,17,1665
1996,Utility Patent Granted,22,117,3640,277547,285995,585,16.944,210,6.083,25820,17801,8019,6.224,9.028,42663,2683,39980,0.938,14.917,-16843,-5.889,18.056,0,0,0
1996,Utility Patent Granted,23,661,2667,188547,193882,240,8.915,290,10.773,25904,7024,18880,3.623,13.361,37254,5684,31570,2.932,19.215,-11350,-5.854,26.721,23,26,598
1996,Utility Patent Granted,31-33,8878,34124,7826434,7881725,1228,3.583,1532,4.470,552260,120073,432187,1.523,7.007,664138,155901,508237,1.978,8.426,-111878,-1.419,14.014,224,239,9084
1996,Utility Patent Granted,42,4281,37050,1046742,1041808,3624,9.817,3354,9.086,164665,50315,114350,4.830,15.806,154219,56771,97448,5.449,14.803,10446,1.003,29.606,103,123,2855
1996,Utility Patent Granted,44-45,1119,64898,925430,934446,4635,7.140,4672,7.197,155334,65766,89568,7.038,16.623,172601,45503,127098,4.870,18.471,-17267,-1.848,33.246,45,50,346
1996,Utility Patent Granted,48-49,973,9328,879251,866376,783,8.383,808,8.651,111574,22104,89470,2.551,12.878,86212,43445,42767,5.015,9.951,25362,2.927,19.902,6,10,111
1996,Utility Patent Granted,51,601,24382,1286936,1273707,3781,15.618,3437,14.197,246370,102992,143378,8.086,19.343,220351,75272,145079,5.910,17.300,26019,2.043,34.600,22,56,789
1996,Utility Patent Granted,52,415,30853,835331,822981,4594,15.148,3543,11.682,162866,79143,83723,9.617,19.790,136523,46919,89604,5.701,16.589,26343,3.201,33.178,3,3,4
1996,Utility Patent Granted,53,509,8823,106032,119325,420,4.746,473,5.345,20639,4569,16070,3.829,17.296,45157,5767,39390,4.833,37.844,-24518,-20.547,34.593,16,16,148
1996,Utility Patent Granted,54,3282,11794,890756,881269,1410,12.140,1051,9.049,140511,48140,92371,5.463,15.944,122399,36902,85497,4.187,13.889,18112,2.055,27.778,145,156,3547
1996,Utility Patent Granted,55,2685,13850,1588741,1587432,1257,9.008,1464,10.492,224244,56264,167980,3.544,14.126,223059,56730,166329,3.574,14.052,1185,0.075,28.103,22,33,1311
1996,Utility Patent Granted,56,763,9525,576360,574463,1855,20.254,1122,12.251,105923,39326,66597,6.846,18.439,102600,44001,58599,7.660,17.860,3323,0.578,35.720,21,32,522
1996,Utility Patent Granted,61,184,614,474856,474380,74,12.191,60,9.885,16825,1086,15739,0.229,3.547,16107,1495,14612,0.315,3.395,718,0.151,6.791,4,4,13
1996,Utility Patent Granted,62,331,5137,650350,639120,790,15.295,846,16.379,59615,22615,37000,3.538,9.328,36569,9797,26772,1.533,5.722,23046,3.606,11.444,12,17,181
1996,Utility Patent Granted,71,155,1131,105740,102057,34,2.966,65,5.669,19505,8336,11169,8.168,19.112,12161,1034,11127,1.013,11.916,7344,7.196,23.832,3,3,11
1996,Utility Patent Granted,72,324,23515,669409,669876,1513,6.393,1816,7.673,84890,29971,54919,4.474,12.673,86683,33682,53001,5.028,12.940,-1793,-0.268,25.345,17,41,331
1996,Utility Patent Granted,81,767,8016,186298,180131,1493,19.850,504,6.701,37573,15010,22563,8.333,20.859,24327,8031,16296,4.458,13.505,13246,7.354,27.010,30,37,1352
1997,No Utility Patent Granted,11,21997,22337,179917,177068,2962,13.253,2988,13.369,41654,15232,26422,8.602,23.524,35799,13606,22193,7.684,20.218,5855,3.307,40.435,2248,2259,10194
1997,No Utility Patent Granted,21,17392,20011,305744,298158,2283,11.409,2282,11.404,73055,26678,46377,8.948,24.502,57141,23479,33662,7.875,19.165,15914,5.337,38.329,1586,1610,13188
1997,No Utility Patent Granted,22,6034,11136,382110,386489,617,5.541,615,5.523,30182,8920,21262,2.308,7.809,38828,7043,31785,1.822,10.046,-8646,-2.237,15.619,309,313,2793
1997,No Utility Patent Granted,23,569358,573424,5318120,5167579,84027,14.838,69808,12.327,1270690,344414,926276,6.665,24.590,969947,324085,645862,6.272,18.770,300743,5.820,37.540,52623,52691,247834
1997,No Utility Patent Granted,31-33,284281,304611,8342729,8268386,26971,8.842,27837,9.126,1133441,284719,848722,3.443,13.708,986121,358617,627504,4.337,11.926,147320,1.782,23.853,21948,22170,243388
1997,No Utility Patent Granted,42,307911,359040,4264390,4207727,38710,10.808,36924,10.310,720402,208673,511729,4.959,17.121,607955,237784,370171,5.651,14.449,112447,2.672,28.897,26384,27241,158454
1997,No Utility Patent Granted,44-45,671498,972235,12649531,12515523,103240,10.579,110621,11.335,2143278,792730,1350548,6.334,17.125,1878840,701557,1177283,5.605,15.012,264438,2.113,30.024,69034,74059,355026
1997,No Utility Patent Granted,48-49,129204,155244,2872758,2814705,24101,15.686,20913,13.611,536833,193188,343645,6.864,19.072,422624,163787,258837,5.819,15.015,114209,4.058,30.030,15300,15573,97626
1997,No Utility Patent Granted,51,61146,79234,1756452,1705852,12968,16.681,9985,12.844,374823,140208,234615,8.219,21.973,273414,108772,164642,6.376,16.028,101409,5.945,32.056,6728,6941,61765
1997,No Utility Patent Granted,52,190504,325690,4633183,4559291,43076,13.464,31562,9.865,914614,350157,564457,7.680,20.060,760688,311399,449289,6.830,16.684,153926,3.376,33.369,13889,14815,81053
1997,No Utility Patent Granted,53,206154,244859,1611408,1587496,33033,13.592,29367,12.084,363792,148912,214880,9.380,22.916,315148,143209,171939,9.021,19.852,48644,3.064,39.704,20888,21604,96530
1997,No Utility Patent Granted,54,514679,548694,4693332,4557890,78546,14.571,59259,10.993,1005091,348114,656977,7.638,22.052,736441,291276,445165,6.391,16.157,268650,5.894,32.315,43262,43862,200065
1997,No Utility Patent Granted,55,25202,37273,1583902,1584303,4056,10.812,4541,12.104,317009,103850,213159,6.555,20.009,316053,113840,202213,7.185,19.949,956,0.060,39.898,1272,1365,22320
1997,No Utility Patent Granted,56,251679,283451,6298909,6050783,47102,16.879,38309,13.728,1814020,646645,1167375,10.687,29.980,1317718,474204,843514,7.837,21.778,496302,8.202,43.555,28881,29290,296311
1997,No Utility Patent Granted,61,50031,55803,1727451,1685596,6727,12.242,5023,9.141,209409,42672,166737,2.532,12.423,125183,31567,93616,1.873,7.427,84226,4.997,14.853,3780,3831,24409
1997,No Utility Patent Granted,62,481299,587901,11854652,11729846,57649,9.874,49484,8.476,1758478,624631,1133847,5.325,14.991,1507962,527331,980631,4.496,12.856,250516,2.136,25.712,34484,35672,318464
1997,No Utility Patent Granted,71,74719,79914,1410857,1379652,10383,13.107,8994,11.353,273391,95291,178100,6.907,19.816,211002,78808,132194,5.712,15.294,62389,4.522,30.588,6617,6674,58520
1997,No Utility Patent Granted,72,357174,461483,8633124,8535137,67258,14.695,59684,13.040,1778491,957136,821355,11.214,20.837,1577844,649085,928759,7.605,18.486,200647,2.351,36.973,44048,45568,432076
1997,No Utility Patent Granted,81,598530,646843,4723881,4671666,61230,9.490,57995,8.988,764402,235539,528863,5.042,16.363,660452,227865,432587,4.878,14.137,103950,2.225,28.275,41773,42670,158946
1997,Utility Patent Granted,11,73,350,15752,16129,8,2.238,23,6.434,1893,365,1528,2.263,11.737,2725,985,1740,6.107,16.896,-832,-5.159,23.474,D,D,D
1997,Utility Patent Granted,21,246,2277,173057,175139,147,6.216,323,13.658,27934,8558,19376,4.886,15.950,31771,15169,16602,8.661,18.141,-3837,-2.191,31.899,8,8,135
1997,Utility Patent Granted,22,115,3739,304258,307957,276,7.358,300,7.998,24109,9083,15026,2.949,7.829,31144,5653,25491,1.836,10.113,-7035,-2.284,15.657,D,D,D
1997,Utility Patent Granted,23,605,2592,195060,194828,159,6.001,274,10.342,41475,5117,36358,2.626,21.288,41120,13639,27481,7.001,21.106,355,0.182,42.212,26,27,365
1997,Utility Patent Granted,31-33,8919,34042,7979045,7994784,1050,3.043,1987,5.758,645299,123933,521366,1.550,8.072,671090,220067,451023,2.753,8.394,-25791,-0.323,16.143,216,219,9220
1997,Utility Patent Granted,42,4345,36011,1095581,1089181,2946,7.982,4742,12.848,206790,59011,147779,5.418,18.986,194102,78885,115217,7.243,17.821,12688,1.165,35.642,143,156,2813
1997,Utility Patent Granted,44-45,957,66125,1280263,1267676,6292,9.534,6029,9.136,204276,108530,95746,8.561,16.114,178883,65717,113166,5.184,14.111,25393,2.003,28.222,47,143,919
1997,Utility Patent Granted,48-49,995,9000,871629,874543,829,9.079,1090,11.938,107150,28179,78971,3.222,12.252,112493,30003,82490,3.431,12.863,-5343,-0.611,24.504,9,13,269
1997,Utility Patent Granted,51,654,22737,1253979,1251076,2149,9.301,2885,12.486,223184,82722,140462,6.612,17.839,216039,74415,141624,5.948,17.268,7145,0.571,34.537,25,42,1741
1997,Utility Patent Granted,52,452,43949,995088,998089,6205,13.692,8941,19.730,211079,106694,104385,10.690,21.148,216012,128311,87701,12.856,21.643,-4933,-0.494,42.297,10,12,612
1997,Utility Patent Granted,53,532,9099,126393,116557,1259,14.563,351,4.060,33118,14456,18662,12.403,28.414,14713,4655,10058,3.994,12.623,18405,15.791,25.246,13,15,127
1997,Utility Patent Granted,54,3472,12903,936947,936641,1504,11.722,1360,10.599,176136,52956,123180,5.654,18.805,172699,58688,114011,6.266,18.438,3437,0.367,36.876,164,173,4801
1997,Utility Patent Granted,55,2680,13239,1627542,1637453,981,7.157,1918,13.992,285963,67233,218730,4.106,17.464,304021,116788,187233,7.132,18.567,-18058,-1.103,34.928,23,32,1168
1997,Utility Patent Granted,56,783,11505,697421,682963,3171,29.403,1730,16.042,175117,81064,94053,11.869,25.641,144528,47906,96622,7.014,21.162,30589,4.479,42.324,20,22,437
1997,Utility Patent Granted,61,181,561,471324,472646,47,8.000,100,17.021,16836,745,16091,0.158,3.562,19649,2607,17042,0.552,4.157,-2813,-0.595,7.124,D,D,D
1997,Utility Patent Granted,62,317,7803,941482,929916,2387,34.061,797,11.373,137107,59568,77539,6.406,14.744,113893,46468,67425,4.997,12.248,23214,2.496,24.495,21,21,5275
1997,Utility Patent Granted,71,126,1017,99275,101165,53,4.958,157,14.687,12667,6106,6561,6.036,12.521,17200,5638,11562,5.573,17.002,-4533,-4.481,25.042,6,7,19
1997,Utility Patent Granted,72,306,19793,596192,609128,1747,8.778,1964,9.869,95639,39086,56553,6.417,15.701,120084,47553,72531,7.807,19.714,-24445,-4.013,31.402,18,25,5948
1997,Utility Patent Granted,81,730,9385,194233,196140,796,8.302,1202,12.537,35391,10472,24919,5.339,18.044,39607,22737,16870,11.592,20.193,-4216,-2.149,36.088,20,20,442
1998,No Utility Patent Granted,11,22084,22444,178118,179526,3070,13.700,2998,13.379,37325,13873,23452,7.728,20.791,40078,12959,27119,7.218,22.324,-2753,-1.533,41.582,2256,2256,9568
1998,No Utility Patent Granted,21,17229,19717,305509,303545,1983,10.013,2156,10.887,63679,20348,43331,6.703,20.978,59735,21085,38650,6.946,19.679,3944,1.299,39.358,1501,1556,13909
1998,No Utility Patent Granted,22,6059,10963,349863,350688,806,7.432,569,5.247,34385,17754,16631,5.063,9.805,35881,6023,29858,1.717,10.232,-1496,-0.427,19.610,278,285,2019
1998,No Utility Patent Granted,23,578446,582940,5549705,5446001,80022,13.840,70570,12.205,1244326,344463,899863,6.325,22.848,1036445,313155,723290,5.750,19.031,207881,3.817,38.063,51895,51933,231964
1998,No Utility Patent Granted,31-33,285636,306105,8566976,8487705,26276,8.603,24942,8.166,1126936,309403,817533,3.645,13.277,967562,302444,665118,3.563,11.400,159374,1.878,22.799,19241,19431,203843
1998,No Utility Patent Granted,42,308695,360589,4400510,4345097,35609,9.880,35247,9.780,706779,210857,495922,4.853,16.266,595004,216356,378648,4.979,13.694,111775,2.572,27.387,25879,26769,148116
1998,No Utility Patent Granted,44-45,674818,969718,12951288,12825425,94038,9.694,94757,9.768,1964098,733197,1230901,5.717,15.314,1705620,582709,1122911,4.543,13.299,258478,2.015,26.597,59967,63495,296849
1998,No Utility Patent Granted,48-49,132873,159240,2905225,2852811,23367,14.851,19567,12.436,518539,176668,341871,6.193,18.176,414816,145716,269100,5.108,14.541,103723,3.636,29.081,14297,14642,83687
1998,No Utility Patent Granted,51,62290,80846,1810853,1764911,11926,14.951,9768,12.246,367518,124731,242787,7.067,20.824,274757,104659,170098,5.930,15.568,92761,5.256,31.136,6406,6613,55248
1998,No Utility Patent Granted,52,196584,344017,4769415,4722057,40000,11.804,29682,8.759,874944,306812,568132,6.497,18.529,786702,257185,529517,5.446,16.660,88242,1.869,33.320,13274,13935,72353
1998,No Utility Patent Granted,53,208821,247667,1671381,1652650,30439,12.346,28223,11.447,359336,138864,220472,8.403,21.743,320423,137934,182489,8.346,19.388,38913,2.355,38.777,18849,20104,88918
1998,No Utility Patent Granted,54,538610,573842,5055848,4854071,82104,14.617,57835,10.296,1110790,387764,723026,7.988,22.884,706807,244023,462784,5.027,14.561,403983,8.323,29.122,41067,41454,164946
1998,No Utility Patent Granted,55,25390,37601,1641686,1611322,4172,11.150,3801,10.159,339539,110606,228933,6.864,21.072,279743,95591,184152,5.932,17.361,59796,3.711,34.722,1098,1165,15075
1998,No Utility Patent Granted,56,256999,291140,6998791,6722645,44044,15.319,36798,12.799,1872828,624644,1248184,9.292,27.859,1317421,467887,849534,6.960,19.597,555407,8.262,39.194,27444,27939,247501
1998,No Utility Patent Granted,61,51573,57411,1849006,1807705,6491,11.453,5023,8.863,220468,49467,171001,2.736,12.196,137461,32613,104848,1.804,7.604,83007,4.592,15.208,3579,3622,21668
1998,No Utility Patent Granted,62,486572,596263,12551044,12391425,51650,8.705,45791,7.718,1632790,521913,1110877,4.212,13.177,1310922,421488,889434,3.401,10.579,321868,2.598,21.159,31592,32664,247419
1998,No Utility Patent Granted,71,76390,81254,1441339,1420297,10155,12.613,8671,10.770,257500,85115,172385,5.993,18.130,214528,72805,141723,5.126,15.104,42972,3.026,30.209,6104,6206,49397
1998,No Utility Patent Granted,72,360352,467640,8929523,8853577,57196,12.263,54767,11.742,1689598,783705,905893,8.852,19.084,1536705,624606,912099,7.055,17.357,152893,1.727,34.714,37734,38852,359956
1998,No Utility Patent Granted,81,604653,655684,4864163,4816849,59927,9.180,54104,8.288,755958,239137,516821,4.965,15.694,658510,206964,451546,4.297,13.671,97448,2.023,27.342,38405,39329,140215
1998,Utility Patent Granted,11,69,350,14173,14600,47,13.803,28,8.223,3427,1483,1944,10.158,23.473,4538,2155,2383,14.761,31.083,-1111,-7.610,46.947,0,0,0
1998,Utility Patent Granted,21,224,2440,182880,181592,212,8.607,258,10.475,28843,6358,22485,3.501,15.883,26508,8972,17536,4.941,14.598,2335,1.286,29.195,3,3,10
1998,Utility Patent Granted,22,119,4458,335763,335836,589,13.690,278,6.461,32818,13953,18865,4.155,9.772,33394,4379,29015,1.304,9.944,-576,-0.172,19.544,D,D,D
1998,Utility Patent Granted,23,637,2844,222116,216009,317,11.389,196,7.041,47514,14273,33241,6.608,21.996,34655,6775,27880,3.136,16.043,12859,5.953,32.087,22,25,358
1998,Utility Patent Granted,31-33,9419,35425,8117382,8077253,1312,3.693,1507,4.242,662888,126699,536189,1.569,8.207,582299,145038,437261,1.796,7.209,80589,0.998,14.418,209,232,8706
1998,Utility Patent Granted,42,4583,36653,1164240,1151198,4090,11.167,4033,11.012,210667,67417,143250,5.856,18.300,181483,69027,112456,5.996,15.765,29184,2.535,31.529,147,169,3410
1998,Utility Patent Granted,44-45,1062,74072,1381590,1349699,4475,6.080,3530,4.796,204057,80098,123959,5.935,15.119,141355,44853,96502,3.323,10.473,62702,4.646,20.946,33,34,603
1998,Utility Patent Granted,48-49,996,10521,998450,981726,1909,19.241,710,7.156,122096,56199,65897,5.725,12.437,89453,20385,69068,2.076,9.112,32643,3.325,18.224,4,4,33
1998,Utility Patent Granted,51,787,26907,1380057,1342665,5856,23.251,2415,9.588,297791,137252,160539,10.222,22.179,219787,91498,128289,6.815,16.369,78004,5.810,32.739,29,105,2270
1998,Utility Patent Granted,52,483,39383,1063768,1039172,7808,20.338,5824,15.170,201259,76221,125038,7.335,19.367,154362,60450,93912,5.817,14.854,46897,4.513,29.709,6,102,2513
1998,Utility Patent Granted,53,551,10210,145785,138442,1289,13.111,532,5.411,30235,12179,18056,8.797,21.839,15639,3876,11763,2.800,11.296,14596,10.543,22.593,13,13,28
1998,Utility Patent Granted,54,3986,15180,1150960,1102971,2406,16.267,1627,11.000,241342,109710,131632,9.947,21.881,141936,47090,94846,4.269,12.869,99406,9.013,25.737,147,157,1997
1998,Utility Patent Granted,55,2703,13440,1652551,1648640,1234,9.096,1486,10.954,277162,62155,215007,3.770,16.812,268568,77942,190626,4.728,16.290,8594,0.521,32.581,17,21,1388
1998,Utility Patent Granted,56,854,13800,708411,678593,3489,27.513,1252,9.873,149557,58756,90801,8.659,22.039,87979,34163,53816,5.034,12.965,61578,9.074,25.930,19,19,466
1998,Utility Patent Granted,61,190,577,485970,483450,49,8.696,22,3.904,23897,521,23376,0.108,4.943,18662,3245,15417,0.671,3.860,5235,1.083,7.720,3,3,59
1998,Utility Patent Granted,62,371,9154,1054126,1055453,1445,16.369,792,8.972,88023,32604,55419,3.089,8.340,91319,24616,66703,2.332,8.652,-3296,-0.312,16.680,15,16,64
1998,Utility Patent Granted,71,161,1553,128261,121563,253,16.772,164,10.872,28169,13062,15107,10.745,23.172,14645,4426,10219,3.641,12.047,13524,11.125,24.095,D,D,D
1998,Utility Patent Granted,72,335,16441,524424,516674,869,5.155,1705,10.113,94142,38495,55647,7.451,18.221,74384,31198,43186,6.038,14.397,19758,3.824,28.793,19,19,273
1998,Utility Patent Granted,81,787,8700,176772,179842,1374,16.392,738,8.805,32099,13775,18324,7.660,17.848,37526,8567,28959,4.764,20.866,-5427,-3.018,35.697,17,36,133
1999,No Utility Patent Granted,11,21951,22302,173803,173427,2880,12.927,2834,12.720,36109,11648,24461,6.716,20.821,35349,12721,22628,7.335,20.383,760,0.438,40.765,2111,2113,9281
1999,No Utility Patent Granted,21,16270,18721,260917,276787,1597,8.327,2512,13.098,38859,14542,24317,5.254,14.039,70577,24729,45848,8.934,25.499,-31718,-11.459,28.079,1712,1747,14232
1999,No Utility Patent Granted,22,6047,11159,330261,333207,924,8.388,638,5.792,29809,11192,18617,3.359,8.946,35436,8229,27207,2.470,10.635,-5627,-1.689,17.892,280,302,2275
1999,No Utility Patent Granted,23,591425,596090,5930860,5728736,81268,13.795,67279,11.421,1376797,350814,1025983,6.124,24.033,972099,315653,656446,5.510,16.969,404698,7.064,33.938,49717,49770,241398
1999,No Utility Patent Granted,31-33,281040,301523,8244902,8303063,23111,7.623,26403,8.709,979626,251630,727996,3.031,11.798,1096505,349007,747498,4.203,13.206,-116879,-1.408,23.597,20315,20501,228217
1999,No Utility Patent Granted,42,305215,357932,4419468,4394260,32907,9.165,35110,9.779,649740,187670,462070,4.271,14.786,598538,226369,372169,5.151,13.621,51202,1.165,27.242,25966,27092,158024
1999,No Utility Patent Granted,44-45,668218,959172,13172544,13044455,90187,9.388,93161,9.698,1963757,757936,1205821,5.810,15.054,1702940,583708,1119232,4.475,13.055,260817,1.999,26.110,60869,64476,317060
1999,No Utility Patent Granted,48-49,136166,164186,3142560,3081325,24134,14.886,20022,12.349,558797,216044,342753,7.011,18.135,434012,166363,267649,5.399,14.085,124785,4.050,28.170,14759,15119,92746
1999,No Utility Patent Granted,51,63218,83442,1823753,1774678,14117,17.282,10605,12.983,394052,176370,217682,9.938,22.204,297865,128831,169034,7.259,16.784,96187,5.420,33.568,6830,7133,65764
1999,No Utility Patent Granted,52,200287,331902,4497698,4470672,37868,11.503,32454,9.859,797969,293469,504500,6.564,17.849,752835,346106,406729,7.742,16.839,45134,1.010,33.679,14824,16365,101831
1999,No Utility Patent Granted,53,211147,256204,1739034,1713487,34548,13.649,28358,11.204,370442,171341,199101,10.000,21.619,319941,137891,182050,8.047,18.672,50501,2.947,37.344,19742,20788,89532
1999,No Utility Patent Granted,54,555553,591447,5266229,5118799,79942,13.728,61703,10.596,1070202,350402,719800,6.845,20.907,774623,286353,488270,5.594,15.133,295579,5.774,30.266,44232,44710,190404
1999,No Utility Patent Granted,55,25340,38081,1597998,1607112,4796,12.758,3819,10.159,314044,110841,203203,6.897,19.541,332469,119990,212479,7.466,20.687,-18425,-1.146,39.082,1241,1304,24578
1999,No Utility Patent Granted,56,257597,293833,7471685,7238675,41712,14.279,38292,13.108,1964334,615537,1348797,8.503,27.137,1488892,495796,993096,6.849,20.569,475442,6.568,41.137,28448,28917,294504
1999,No Utility Patent Granted,61,52749,58420,1926274,1891339,6362,11.028,4905,8.502,208895,44699,164196,2.363,11.045,140435,30817,109618,1.629,7.425,68460,3.620,14.850,3564,3636,20727
1999,No Utility Patent Granted,62,485983,599168,12621040,12576566,51544,8.621,49050,8.203,1532183,496620,1035563,3.949,12.183,1441918,537055,904863,4.270,11.465,90265,0.718,22.930,33003,34482,289735
1999,No Utility Patent Granted,71,77570,82790,1481525,1458715,9925,12.080,8668,10.550,251819,78063,173756,5.351,17.263,204806,65178,139628,4.468,14.040,47013,3.223,28.080,6229,6301,47592
1999,No Utility Patent Granted,72,360321,470123,9038880,8949893,55738,11.893,52805,11.267,1645797,822135,823662,9.186,18.389,1468077,583739,884338,6.522,16.403,177720,1.986,32.807,36915,38785,368133
1999,No Utility Patent Granted,81,605523,655404,4947007,4905585,55914,8.542,54305,8.296,722953,223037,499916,4.547,14.737,641425,214121,427304,4.365,13.075,81528,1.662,26.151,38283,39143,143840
1999,Utility Patent Granted,11,78,350,16543,15844,23,6.497,31,8.757,3170,321,2849,2.026,20.008,1785,436,1349,2.752,11.266,1385,8.742,22.533,D,D,D
1999,Utility Patent Granted,21,231,2547,184301,190254,274,10.811,249,9.824,20773,5874,14899,3.087,10.919,32258,7830,24428,4.116,16.955,-11485,-6.037,21.837,4,9,114
1999,Utility Patent Granted,22,115,4775,330174,334140,622,13.335,401,8.597,36153,17975,18178,5.379,10.820,43694,11492,32202,3.439,13.077,-7541,-2.257,21.639,D,D,D
1999,Utility Patent Granted,23,661,2917,232507,233153,228,7.763,268,9.125,40007,8798,31209,3.773,17.159,40732,13326,27406,5.716,17.470,-725,-0.311,34.318,21,21,257
1999,Utility Patent Granted,31-33,9630,36119,8160900,8248637,1233,3.388,1781,4.894,579601,114540,465061,1.389,7.027,750786,190255,560531,2.307,9.102,-171185,-2.075,14.053,278,302,15362
1999,Utility Patent Granted,42,4848,37566,1217645,1212039,3229,8.573,3426,9.096,192584,62297,130287,5.140,15.889,181548,66448,115100,5.482,14.979,11036,0.911,29.957,161,200,3504
1999,Utility Patent Granted,44-45,1136,82213,1451166,1434877,6002,7.330,5335,6.516,212463,93090,119373,6.488,14.807,180388,46687,133701,3.254,12.572,32075,2.235,25.143,48,211,712
1999,Utility Patent Granted,48-49,1016,9283,905197,883593,903,9.641,1070,11.424,115187,27361,87826,3.097,13.036,72662,27210,45452,3.079,8.223,42525,4.813,16.447,6,6,28
1999,Utility Patent Granted,51,877,27949,1437404,1448092,4238,15.149,4291,15.338,279403,105716,173687,7.300,19.295,304546,127915,176631,8.833,21.031,-25143,-1.736,38.589,33,49,1969
1999,Utility Patent Granted,52,509,57979,1426267,1426096,12504,21.694,11821,20.509,312051,137545,174506,9.645,21.881,316363,151883,164480,10.650,22.184,-4312,-0.302,43.763,7,9,1279
1999,Utility Patent Granted,53,546,9270,143412,142871,756,8.275,487,5.331,21441,6944,14497,4.860,15.007,19954,6502,13452,4.551,13.966,1487,1.041,27.933,22,22,111
1999,Utility Patent Granted,54,4417,19398,1313692,1291747,4443,24.510,1901,10.487,270343,112120,158223,8.680,20.928,225581,72841,152740,5.639,17.463,44762,3.465,34.927,197,281,4757
1999,Utility Patent Granted,55,2718,13572,1663452,1678631,1849,13.451,2198,15.990,250370,91217,159153,5.434,14.915,277782,94791,182991,5.647,16.548,-27412,-1.633,29.830,23,31,536
1999,Utility Patent Granted,56,889,13993,738540,731329,1857,13.245,1911,13.631,153644,49018,104626,6.703,21.009,138750,48480,90270,6.629,18.972,14894,2.037,37.945,39,43,807
1999,Utility Patent Granted,61,194,1053,500270,491156,285,30.384,55,5.864,32851,10150,22701,2.067,6.689,14583,2339,12244,0.476,2.969,18268,3.719,5.938,4,5,53
1999,Utility Patent Granted,62,407,9061,1094457,1102302,1380,15.619,929,10.514,110427,33027,77400,2.996,10.018,128792,50390,78402,4.571,11.684,-18365,-1.666,20.036,9,9,370
1999,Utility Patent Granted,71,155,1503,135606,131396,187,12.865,88,6.054,23706,4627,19079,3.521,18.042,14522,3703,10819,2.818,11.052,9184,6.990,22.104,6,6,26
1999,Utility Patent Granted,72,358,14297,572897,588312,713,4.564,3364,21.533,69576,25733,43843,4.374,11.826,103365,63437,39928,10.783,17.570,-33789,-5.743,23.653,16,94,1160
1999,Utility Patent Granted,81,801,10103,187309,186599,1080,10.727,1010,10.032,36217,9138,27079,4.897,19.409,34423,14135,20288,7.575,18.448,1794,0.961,36.895,18,18,185
2000,No Utility Patent Granted,11,21329,21651,175031,172592,2611,11.984,2882,13.228,36851,12406,24445,7.188,21.352,32322,12044,20278,6.978,18.727,4529,2.624,37.455,2102,2103,8803
2000,No Utility Patent Granted,21,16062,18576,274244,271080,1798,9.636,1965,10.531,50828,14676,36152,5.414,18.750,44413,15802,28611,5.829,16.384,6415,2.366,32.767,1362,1392,8947
2000,No Utility Patent Granted,22,6282,11268,308454,307771,1043,9.440,604,5.467,35558,16358,19200,5.315,11.553,34318,7332,26986,2.382,11.151,1240,0.403,22.301,310,326,2089
2000,No Utility Patent Granted,23,599409,604450,6294011,6097576,77832,12.973,68850,11.476,1427837,346663,1081174,5.685,23.416,1033818,325094,708724,5.332,16.955,394019,6.462,33.909,50416,50485,243189
2000,No Utility Patent Granted,31-33,276118,296617,8139236,8114566,22489,7.541,25728,8.627,1023590,261090,762500,3.218,12.614,973299,314564,658735,3.877,11.994,50291,0.620,23.989,19836,20048,208579
2000,No Utility Patent Granted,42,303672,356086,4496801,4442278,33534,9.411,34000,9.542,690426,209996,480430,4.727,15.542,582157,221805,360352,4.993,13.105,108269,2.437,26.210,24868,25902,149033
2000,No Utility Patent Granted,44-45,664988,959645,13464640,13374604,90530,9.426,92115,9.591,1961188,734375,1226813,5.491,14.664,1778963,736813,1042150,5.509,13.301,182225,1.362,26.602,58804,62601,321138
2000,No Utility Patent Granted,48-49,137122,165026,3239890,3165766,23064,14.046,21425,13.048,575746,174831,400915,5.523,18.187,428996,154692,274304,4.886,13.551,146750,4.636,27.102,15685,16108,87912
2000,No Utility Patent Granted,51,65573,84947,1945088,1893457,14075,16.903,10721,12.875,454157,181898,272259,9.607,23.986,350750,120492,230258,6.364,18.524,103407,5.461,37.049,7117,7643,67232
2000,No Utility Patent Granted,52,201735,331565,4330122,4308188,38668,11.799,30993,9.457,708194,265065,443129,6.153,16.438,663352,242000,421352,5.617,15.397,44842,1.041,30.795,15856,17076,93865
2000,No Utility Patent Granted,53,211438,256711,1765229,1740049,30153,11.785,28450,11.119,348432,137001,211431,7.873,20.024,296216,128944,167272,7.410,17.023,52216,3.001,34.047,19398,20363,78207
2000,No Utility Patent Granted,54,566671,604172,5516302,5339152,79176,13.257,65318,10.937,1161395,388527,772868,7.277,21.752,804448,304879,499569,5.710,15.067,356947,6.685,30.134,46870,47406,199278
2000,No Utility Patent Granted,55,25465,38562,1613105,1591012,4490,11.793,3511,9.222,317641,116537,201104,7.325,19.965,274904,86542,188362,5.439,17.279,42737,2.686,34.557,1216,1292,16797
2000,No Utility Patent Granted,56,257240,294083,8067007,7745699,40138,13.681,38754,13.209,2043621,572688,1470933,7.394,26.384,1408673,533827,874846,6.892,18.187,634948,8.197,36.373,28010,28475,264602
2000,No Utility Patent Granted,61,54194,60200,2010651,1966217,6556,11.028,5055,8.503,230252,55783,174469,2.837,11.710,140424,30119,110305,1.532,7.142,89828,4.569,14.284,3608,3681,20671
2000,No Utility Patent Granted,62,489349,605910,12894228,12768780,53403,8.854,47885,7.939,1607741,521475,1086266,4.084,12.591,1355304,515596,839708,4.038,10.614,252437,1.977,21.228,30228,31713,251828
2000,No Utility Patent Granted,71,78552,83794,1595772,1542612,9807,11.759,9017,10.812,303307,86333,216974,5.597,19.662,196455,66812,129643,4.331,12.735,106852,6.927,25.470,6281,6504,47372
2000,No Utility Patent Granted,72,359122,468932,9157966,9040448,52511,11.215,51070,10.907,1615086,736889,878197,8.151,17.865,1377698,532598,845100,5.891,15.239,237388,2.626,30.479,36008,37862,343171
2000,No Utility Patent Granted,81,605171,651246,5044558,4973078,53216,8.167,53962,8.281,748761,212490,536271,4.273,15.056,606194,206388,399806,4.150,12.190,142567,2.867,24.379,37356,38317,137521
2000,Utility Patent Granted,11,79,351,14958,15614,13,3.709,12,3.424,2000,258,1742,1.652,12.809,3254,672,2582,4.304,20.841,-1254,-8.032,25.619,D,D,D
2000,Utility Patent Granted,21,238,2699,175792,179693,326,12.363,202,7.660,30119,10454,19665,5.818,16.761,38611,8766,29845,4.878,21.487,-8492,-4.726,33.523,3,4,400
2000,Utility Patent Granted,22,108,5280,345261,349025,532,10.262,340,6.559,35034,15175,19859,4.348,10.038,43101,6481,36620,1.857,12.349,-8067,-2.311,20.075,D,D,D
2000,Utility Patent Granted,23,721,3569,288272,276732,477,13.790,257,7.430,67408,26494,40914,9.574,24.359,44873,7199,37674,2.601,16.215,22535,8.143,32.431,28,28,205
2000,Utility Patent Granted,31-33,9919,36840,8224373,8268429,1275,3.443,1669,4.506,661971,123654,538317,1.495,8.006,748283,186987,561296,2.261,9.050,-86312,-1.044,16.012,246,255,8866
2000,Utility Patent Granted,42,5146,40101,1331220,1311139,4093,10.249,3759,9.413,247720,86543,161177,6.601,18.893,208140,75282,132858,5.742,15.875,39580,3.019,31.749,157,218,3334
2000,Utility Patent Granted,44-45,1198,81159,1462294,1409935,5788,7.148,5421,6.695,251151,95903,155248,6.802,17.813,146515,49010,97505,3.476,10.392,104636,7.421,20.783,49,55,667
2000,Utility Patent Granted,48-49,1029,10875,984047,962167,1629,15.326,1137,10.697,150245,50220,100025,5.219,15.615,107589,53762,53827,5.588,11.182,42656,4.433,22.364,10,11,411
2000,Utility Patent Granted,51,955,33727,1630330,1582092,6513,20.386,2957,9.255,306990,153040,153950,9.673,19.404,208413,53040,155373,3.353,13.173,98577,6.231,26.347,55,206,6949
2000,Utility Patent Granted,52,567,67096,1684408,1659909,12318,18.500,11294,16.962,385706,174540,211166,10.515,23.237,342218,112429,229789,6.773,20.617,43488,2.620,41.233,11,15,307
2000,Utility Patent Granted,53,563,11447,179886,177553,986,8.839,403,3.613,28063,11884,16179,6.693,15.805,23246,4710,18536,2.653,13.092,4817,2.713,26.185,10,16,88
2000,Utility Patent Granted,54,4849,21685,1480682,1444885,3224,15.242,2159,10.207,292655,109538,183117,7.581,20.255,220874,65425,155449,4.528,15.287,71781,4.968,30.573,268,306,6540
2000,Utility Patent Granted,55,2797,14479,1727926,1717090,1957,13.695,1578,11.043,306391,94720,211671,5.516,17.844,289152,65589,223563,3.820,16.840,17239,1.004,33.679,21,104,3901
2000,Utility Patent Granted,56,986,15796,966274,919225,2287,14.586,2054,13.100,272449,80538,191911,8.762,29.639,177475,54023,123452,5.877,19.307,94974,10.332,38.614,45,49,1789
2000,Utility Patent Granted,61,214,1232,534053,525295,213,18.570,43,3.749,33268,3174,30094,0.604,6.333,16465,374,16091,0.071,3.134,16803,3.199,6.269,3,3,21
2000,Utility Patent Granted,62,439,8417,1113883,1109257,672,7.953,737,8.722,89622,16834,72788,1.518,8.079,81579,22335,59244,2.014,7.354,8043,0.725,14.709,8,8,57
2000,Utility Patent Granted,71,167,1551,134734,130668,83,5.327,97,6.226,16679,2791,13888,2.136,12.764,8527,1618,6909,1.238,6.526,8152,6.239,13.051,5,5,14
2000,Utility Patent Granted,72,370,16658,733783,718918,1157,6.917,1293,7.730,104289,43978,60311,6.117,14.506,75730,27464,48266,3.820,10.534,28559,3.973,21.068,14,14,110
2000,Utility Patent Granted,81,853,14556,236466,242054,2156,15.302,1223,8.680,40628,19964,20664,8.248,16.785,51909,14465,37444,5.976,21.445,-11281,-4.661,33.569,26,94,875
2001,No Utility Patent Granted,11,21773,22205,171002,174682,2635,11.819,2816,12.630,32632,10107,22525,5.786,18.681,39763,15040,24723,8.610,22.763,-7131,-4.082,37.362,2003,2004,10032
2001,No Utility Patent Granted,21,16488,19042,298835,289274,2130,11.293,1768,9.374,59589,16864,42725,5.830,20.600,40165,14394,25771,4.976,13.885,19424,6.715,27.770,1213,1233,8861
2001,No Utility Patent Granted,22,6412,10814,274613,272361,808,7.485,771,7.142,36291,17124,19167,6.287,13.325,32494,8837,23657,3.245,11.930,3797,1.394,23.861,298,340,3228
2001,No Utility Patent Granted,23,596809,602192,6171595,6150976,74880,12.478,70720,11.784,1220289,332881,887408,5.412,19.839,1178249,353892,824357,5.753,19.155,42040,0.683,38.311,50244,50291,254212
2001,No Utility Patent Granted,31-33,275358,295501,7844808,7989895,22629,7.614,26003,8.750,871032,245133,625899,3.068,10.902,1161961,371205,790756,4.646,14.543,-290929,-3.641,21.803,19799,20048,240708
2001,No Utility Patent Granted,42,300567,352598,4469310,4480205,32800,9.268,35398,10.002,646720,210943,435777,4.708,14.435,669828,254629,415199,5.683,14.951,-23108,-0.516,28.870,25028,26505,166706
2001,No Utility Patent Granted,44-45,660720,944447,12912698,12984289,88228,9.309,94783,10.001,1728039,666099,1061940,5.130,13.309,1884769,651721,1233048,5.019,14.516,-156730,-1.207,26.617,60914,66065,341059
2001,No Utility Patent Granted,48-49,138152,166289,3296827,3306088,23230,13.988,22805,13.732,508393,174019,334374,5.264,15.377,530346,191205,339141,5.783,16.041,-21953,-0.664,30.755,16031,16597,103570
2001,No Utility Patent Granted,51,65005,86751,1991393,1950677,15330,17.869,13410,15.631,493041,217816,275225,11.166,25.275,410774,202036,208738,10.357,21.058,82267,4.217,42.116,7986,8614,96297
2001,No Utility Patent Granted,52,205976,331009,4218168,4196618,40163,12.220,35488,10.797,769226,305403,463823,7.277,18.330,725695,314424,411271,7.492,17.292,43531,1.037,34.585,16364,17728,101531
2001,No Utility Patent Granted,53,212636,258045,1772934,1771599,30546,11.861,29532,11.467,324181,131969,192212,7.449,18.299,320506,138830,181676,7.836,18.091,3675,0.207,36.183,19064,19961,80851
2001,No Utility Patent Granted,54,579212,618579,5730933,5618358,83253,13.598,70568,11.526,1173914,398284,775630,7.089,20.894,948203,363989,584214,6.479,16.877,225711,4.017,33.754,49654,50189,229271
2001,No Utility Patent Granted,55,25320,38061,1544863,1549057,4009,10.514,4145,10.871,277427,89977,187450,5.809,17.909,287759,102213,185546,6.598,18.576,-10332,-0.667,35.819,1281,1348,22900
2001,No Utility Patent Granted,56,262389,301420,7929783,8050077,41820,13.965,37902,12.657,1787013,595276,1191737,7.395,22.199,2031927,640848,1391079,7.961,25.241,-244914,-3.042,44.397,26640,27162,285367
2001,No Utility Patent Granted,61,54121,60008,1944009,1915406,6713,11.327,5231,8.826,204074,46430,157644,2.424,10.654,146798,39089,107709,2.041,7.664,57276,2.990,15.328,3658,3717,25741
2001,No Utility Patent Granted,62,493956,612304,13137888,12992422,55664,9.167,45458,7.486,1597949,511343,1086606,3.936,12.299,1307844,491623,816221,3.784,10.066,290105,2.233,20.132,28623,30038,256534
2001,No Utility Patent Granted,71,78530,84113,1593791,1577764,9937,11.869,9154,10.934,258023,85176,172847,5.399,16.354,226619,76614,150005,4.856,14.363,31404,1.990,28.727,6416,6490,49606
2001,No Utility Patent Granted,72,361890,472728,9213470,9175927,54406,11.534,52388,11.106,1545842,729604,816238,7.951,16.847,1471874,580394,891480,6.325,16.041,73968,0.806,32.081,35575,37416,364186
2001,No Utility Patent Granted,81,594043,641529,5006318,4977146,52678,8.205,53641,8.355,692658,203439,489219,4.087,13.917,634260,204711,429549,4.113,12.743,58398,1.173,25.487,37713,38438,141489
2001,Utility Patent Granted,11,71,256,11666,12443,14,5.045,57,20.541,871,388,483,3.118,7.000,2407,1185,1222,9.524,19.345,-1536,-12.345,14.000,D,D,D
2001,Utility Patent Granted,21,226,2767,182191,177508,224,8.072,240,8.649,30399,8584,21815,4.836,17.125,21298,6755,14543,3.805,11.998,9101,5.127,23.997,9,24,1200
2001,Utility Patent Granted,22,112,5927,378328,383115,685,11.608,633,10.727,45809,18675,27134,4.875,11.957,55188,14661,40527,3.827,14.405,-9379,-2.448,23.914,D,D,D
2001,Utility Patent Granted,23,713,3478,336227,329391,336,9.403,527,14.747,79527,11939,67588,3.625,24.144,66479,28440,38039,8.634,20.182,13048,3.961,40.365,31,32,421
2001,Utility Patent Granted,31-33,9839,36929,7992084,8139792,1339,3.585,2187,5.855,599048,142552,456496,1.751,7.360,888982,254079,634903,3.121,10.921,-289934,-3.562,14.719,300,328,14509
2001,Utility Patent Granted,42,5225,42404,1424881,1407329,6018,14.314,5293,12.590,297365,125957,171408,8.950,21.130,257913,111611,146302,7.931,18.326,39452,2.803,36.653,170,265,6443
2001,Utility Patent Granted,44-45,1232,93584,1984701,1950573,5135,5.490,5024,5.372,305146,124677,180469,6.392,15.644,235098,96134,138964,4.929,12.053,70048,3.591,24.106,55,150,1146
2001,Utility Patent Granted,48-49,1019,11463,910030,917034,1634,14.476,1283,11.367,109808,44791,65017,4.884,11.974,120097,36706,83391,4.003,13.096,-10289,-1.122,23.949,9,230,1978
2001,Utility Patent Granted,51,1011,38054,1767422,1731278,8379,23.337,4079,11.361,310273,155882,154391,9.004,17.922,242927,99947,142980,5.773,14.032,67346,3.890,28.063,62,88,4335
2001,Utility Patent Granted,52,594,67671,1966202,1917076,12022,16.985,18238,25.768,505219,240793,264426,12.560,26.354,388707,200872,187835,10.478,20.276,116512,6.078,40.552,13,34,359
2001,Utility Patent Granted,53,562,13693,204685,196448,2783,21.592,1175,9.116,51010,28781,22229,14.651,25.966,35382,13208,22174,6.723,18.011,15628,7.955,36.022,12,16,130
2001,Utility Patent Granted,54,5071,22304,1538399,1505772,3080,13.920,2726,12.320,325678,122570,203108,8.140,21.629,259914,91282,168632,6.062,17.261,65764,4.367,34.522,292,310,6183
2001,Utility Patent Granted,55,2825,14303,1734032,1764638,1610,11.043,2163,14.836,304896,101331,203565,5.742,17.278,363782,140892,222890,7.984,20.615,-58886,-3.337,34.556,27,30,3804
2001,Utility Patent Granted,56,1001,15804,1000169,990107,2166,13.780,1996,12.698,257149,77774,179375,7.855,25.972,242216,106309,135907,10.737,24.464,14933,1.508,48.927,24,25,232
2001,Utility Patent Granted,61,215,1432,522849,515179,222,16.116,113,8.203,37060,5105,31955,0.991,7.194,20736,2065,18671,0.401,4.025,16324,3.169,8.050,5,5,10
2001,Utility Patent Granted,62,417,11307,1133591,1127331,2400,22.479,1139,10.668,111534,36361,75173,3.225,9.894,97675,35520,62155,3.151,8.664,13859,1.229,17.329,18,24,314
2001,Utility Patent Granted,71,169,1398,149693,151653,118,8.511,95,6.852,9192,2129,7063,1.404,6.061,13011,3370,9641,2.222,8.579,-3819,-2.518,12.122,6,6,41
2001,Utility Patent Granted,72,399,18207,761191,770061,2802,16.140,1110,6.394,102104,60536,41568,7.861,13.259,122260,44890,77370,5.829,15.877,-20156,-2.617,26.518,18,19,191
2001,Utility Patent Granted,81,863,13925,240543,238586,1454,10.465,1392,10.019,45891,17490,28401,7.331,19.235,41913,19163,22750,8.032,17.567,3978,1.667,35.135,19,25,211
2002,No Utility Patent Granted,11,21304,21777,169734,172659,2525,11.401,3264,14.738,33724,13146,20578,7.614,19.532,39628,14336,25292,8.303,22.952,-5904,-3.419,39.064,2231,2232,10324
2002,No Utility Patent Granted,21,16404,19381,303318,305855,2296,11.906,2103,10.905,60604,26549,34055,8.680,19.815,66258,22927,43331,7.496,21.663,-5654,-1.849,39.629,1257,1271,10803
2002,No Utility Patent Granted,22,6390,11435,292825,294132,877,7.759,614,5.432,34805,17522,17283,5.957,11.833,37442,9914,27528,3.371,12.730,-2637,-0.897,23.666,336,336,2811
2002,No Utility Patent Granted,23,589559,595717,6043108,6112164,79979,13.434,79274,13.315,1230194,394614,835580,6.456,20.127,1368766,396851,971915,6.493,22.394,-138572,-2.267,40.254,51932,52046,271949
2002,No Utility Patent Granted,31-33,273789,294512,7318752,7664710,23262,7.809,30000,10.071,840541,346919,493622,4.526,10.966,1532421,491613,1040808,6.414,19.993,-691880,-9.027,21.933,22104,22451,334674
2002,No Utility Patent Granted,42,301488,358945,4350319,4447719,36093,9.996,40340,11.172,667704,272327,395377,6.123,15.012,861430,324802,536628,7.303,19.368,-193726,-4.356,30.025,26194,27292,210601
2002,No Utility Patent Granted,44-45,644829,934152,12703586,12732208,103181,11.030,105859,11.316,2000854,893915,1106939,7.021,15.715,2060764,752160,1308604,5.908,16.185,-59910,-0.471,31.430,64102,70133,436559
2002,No Utility Patent Granted,48-49,137692,166855,3057609,3095925,23229,13.874,24376,14.559,518708,209211,309497,6.758,16.755,594144,196286,397858,6.340,19.191,-75436,-2.437,33.509,16595,17046,114275
2002,No Utility Patent Granted,51,62572,86579,1886767,1956317,13163,15.157,13695,15.769,356180,178322,177858,9.115,18.207,497547,187010,310537,9.559,25.433,-141367,-7.226,36.413,8340,8569,108614
2002,No Utility Patent Granted,52,208931,345764,4378934,4329541,46336,13.685,31991,9.448,841582,390177,451405,9.012,19.438,743124,261116,482008,6.031,17.164,98458,2.274,34.328,16152,16940,109656
2002,No Utility Patent Granted,53,219149,266802,1766913,1770553,34279,12.974,29114,11.019,342511,155094,187417,8.760,19.345,350346,134961,215385,7.623,19.787,-7835,-0.443,38.690,18493,19046,82434
2002,No Utility Patent Granted,54,585430,625983,5527602,5608622,83011,13.291,80131,12.830,1043822,417873,625949,7.451,18.611,1204774,449649,755125,8.017,21.481,-160952,-2.870,37.222,54012,54491,289645
2002,No Utility Patent Granted,55,23910,35756,1355817,1397318,4437,12.364,4696,13.086,269618,103893,165725,7.435,19.295,352397,104434,247963,7.474,25.220,-82779,-5.924,38.591,1466,1542,29756
2002,No Utility Patent Granted,56,250460,288755,7285122,7535035,42759,14.718,46298,15.936,1752781,639971,1112810,8.493,23.262,2252700,738458,1514242,9.800,29.896,-499919,-6.635,46.524,29421,29962,404519
2002,No Utility Patent Granted,61,58260,64375,2165490,2134466,7529,11.890,5420,8.560,257623,71170,186453,3.334,12.070,194339,48093,146246,2.253,9.105,63284,2.965,18.210,3562,3639,33781
2002,No Utility Patent Granted,62,511712,640558,13629084,13439761,70589,11.218,47989,7.626,2030284,767688,1262596,5.712,15.107,1654974,583048,1071926,4.338,12.314,375310,2.793,24.628,28872,29803,318168
2002,No Utility Patent Granted,71,80413,86878,1660542,1646408,11667,13.486,10930,12.634,299644,110054,189590,6.684,18.200,271480,91948,179532,5.585,16.489,28164,1.711,32.978,6905,7017,62682
2002,No Utility Patent Granted,72,367389,481914,9343486,9356559,67159,14.079,57383,12.029,1770392,938189,832203,10.027,18.921,1785348,643196,1142152,6.874,19.081,-14956,-0.160,37.843,36628,37944,372830
2002,No Utility Patent Granted,81,606796,655851,5035382,5026497,61741,9.471,53895,8.267,787230,269515,517715,5.362,15.662,769721,230079,539642,4.577,15.313,17509,0.348,30.627,35689,36206,147189
2002,Utility Patent Granted,11,71,279,11326,11879,20,7.194,18,6.475,884,250,634,2.105,7.442,2041,594,1447,5.000,17.182,-1157,-9.740,14.883,D,D,D
2002,Utility Patent Granted,21,225,2670,171304,177335,278,10.365,302,11.260,22573,7007,15566,3.951,12.729,35391,11569,23822,6.524,19.957,-12818,-7.228,25.458,7,7,151
2002,Utility Patent Granted,22,100,5955,374768,373891,414,7.029,284,4.822,40332,19319,21013,5.167,10.787,39230,8634,30596,2.309,10.492,1102,0.295,20.985,D,D,D
2002,Utility Patent Granted,23,672,3524,339362,352155,275,7.720,351,9.854,64466,18020,46446,5.117,18.306,91090,20154,70936,5.723,25.866,-26624,-7.560,36.612,35,40,1935
2002,Utility Patent Granted,31-33,9650,36088,7251221,7658755,1169,3.168,2797,7.580,467361,110073,357288,1.437,6.102,1283936,278031,1005905,3.630,16.764,-816575,-10.662,12.205,422,465,28512
2002,Utility Patent Granted,42,5127,40077,1455575,1501087,2570,6.139,6145,14.678,253205,61401,191804,4.090,16.868,343305,124104,219201,8.268,22.870,-90100,-6.002,33.736,214,251,7846
2002,Utility Patent Granted,44-45,1112,88378,1886078,1908243,5688,6.452,5256,5.962,256621,104710,151911,5.487,13.448,307580,59886,247694,3.138,16.118,-50959,-2.670,26.896,56,77,4376
2002,Utility Patent Granted,48-49,954,10435,979778,1015836,959,8.985,1436,13.454,72921,22588,50333,2.224,7.178,145058,31980,113078,3.148,14.280,-72137,-7.101,14.357,12,13,188
2002,Utility Patent Granted,51,1062,38571,1835070,1874631,8658,22.419,8754,22.668,426370,261854,164516,13.968,22.744,500696,161061,339635,8.592,26.709,-74326,-3.965,45.488,90,94,4477
2002,Utility Patent Granted,52,631,68923,2059811,2028852,8097,11.789,7613,11.085,426768,141598,285170,6.979,21.035,358710,141044,217666,6.952,17.680,68058,3.355,35.361,12,13,559
2002,Utility Patent Granted,53,612,15550,211820,213621,1972,13.118,937,6.233,39162,18232,20930,8.535,18.332,43127,12374,30753,5.793,20.189,-3965,-1.856,36.665,21,47,167
2002,Utility Patent Granted,54,5083,27386,1528297,1573264,8072,31.569,4439,17.361,379783,197698,182085,12.566,24.140,474424,239499,234925,15.223,30.155,-94641,-6.016,48.280,348,395,14734
2002,Utility Patent Granted,55,2709,11476,1475681,1505914,989,8.093,2479,20.285,250548,82841,167707,5.501,16.638,310579,119561,191018,7.939,20.624,-60031,-3.986,33.275,32,47,1723
2002,Utility Patent Granted,56,982,14810,1097286,1122981,1474,9.385,3267,20.800,301961,81844,220117,7.288,26.889,363217,139620,223597,12.433,32.344,-61256,-5.455,53.778,40,44,993
2002,Utility Patent Granted,61,247,1634,552352,539163,326,20.751,200,12.731,59655,10025,49630,1.859,11.064,34342,8869,25473,1.645,6.370,25313,4.695,12.739,7,7,3551
2002,Utility Patent Granted,62,433,10781,1219371,1204052,1005,8.716,2504,21.716,139725,29265,110460,2.431,11.605,111626,51805,59821,4.303,9.271,28099,2.334,18.542,19,19,764
2002,Utility Patent Granted,71,170,954,116972,119073,77,7.967,102,10.554,16723,2784,13939,2.338,14.044,21384,3363,18021,2.824,17.959,-4661,-3.914,28.089,7,7,46
2002,Utility Patent Granted,72,398,19104,731093,709885,1547,8.143,1333,7.017,126972,61031,65941,8.597,17.886,85571,34800,50771,4.902,12.054,41401,5.832,24.108,19,19,170
2002,Utility Patent Granted,81,840,13909,234919,235156,1523,11.037,1303,9.443,45586,19431,26155,8.263,19.385,45848,17219,28629,7.322,19.497,-262,-0.111,38.771,24,25,355
2003,No Utility Patent Granted,11,20655,21158,168361,167473,2545,11.957,2797,13.141,34216,10287,23929,6.143,20.431,32316,11536,20780,6.888,19.296,1900,1.135,38.593,1985,1985,7860
2003,No Utility Patent Granted,21,16023,19096,303918,306908,1717,8.935,1956,10.179,51813,14589,37224,4.754,16.882,57399,19280,38119,6.282,18.702,-5586,-1.820,33.765,1253,1286,10286
2003,No Utility Patent Granted,22,6357,11926,323625,322748,910,7.703,684,5.790,38360,13929,24431,4.316,11.885,36627,12650,23977,3.919,11.348,1733,0.537,22.697,247,258,2048
2003,No Utility Patent Granted,23,598800,605349,6100991,6086596,86432,14.380,77822,12.948,1277430,385963,891467,6.341,20.988,1249149,351057,898092,5.768,20.523,28281,0.465,41.046,53405,53457,249253
2003,No Utility Patent Granted,31-33,267364,287978,7221744,7287120,21165,7.276,26955,9.267,890346,244564,645782,3.356,12.218,1017955,352003,665952,4.830,13.969,-127609,-1.751,24.436,20591,20826,212950
2003,No Utility Patent Granted,42,300003,357556,4361362,4339677,34251,9.570,34943,9.763,648424,193135,455289,4.450,14.942,604525,213324,391201,4.916,13.930,43899,1.012,27.860,24514,25293,135007
2003,No Utility Patent Granted,44-45,651630,938869,13002526,12892611,98234,10.493,92929,9.926,1876821,684969,1191852,5.313,14.557,1660186,600287,1059899,4.656,12.877,216635,1.680,25.754,59612,62959,314512
2003,No Utility Patent Granted,48-49,137977,166736,2997990,2999188,22989,13.792,22879,13.726,493062,165907,327155,5.532,16.440,497716,184412,313304,6.149,16.595,-4654,-0.155,32.880,16125,16391,92614
2003,No Utility Patent Granted,51,62483,84226,1723387,1730806,11440,13.590,11349,13.482,308853,108089,200764,6.245,17.844,325761,128292,197469,7.412,18.821,-16908,-0.977,35.689,7191,7401,62298
2003,No Utility Patent Granted,52,214152,361030,4518144,4466360,45615,12.907,30407,8.603,795088,290046,505042,6.494,17.802,694465,241819,452646,5.414,15.549,100623,2.253,31.098,15728,16488,75571
2003,No Utility Patent Granted,53,226016,274259,1837425,1802297,36163,13.384,28048,10.380,366806,149081,217725,8.272,20.352,295948,118787,177161,6.591,16.421,70858,3.932,32.841,18564,19110,71837
2003,No Utility Patent Granted,54,592592,639671,5767386,5722815,84369,13.278,75870,11.940,1076566,355854,720712,6.218,18.812,993771,357491,636280,6.247,17.365,82795,1.447,34.730,53045,53556,225720
2003,No Utility Patent Granted,55,23821,35810,1392542,1385657,3769,10.506,3899,10.868,284782,87229,197553,6.295,20.552,267843,93553,174290,6.752,19.330,16939,1.222,38.659,1129,1189,15946
2003,No Utility Patent Granted,56,253138,290761,7329701,7318081,41593,14.335,40383,13.918,1728432,477755,1250677,6.528,23.619,1696456,609400,1087056,8.327,23.182,31976,0.437,46.363,26563,27000,311271
2003,No Utility Patent Granted,61,60233,66531,2203930,2174740,7808,11.922,5735,8.756,252019,51658,200361,2.375,11.588,192965,41736,151229,1.919,8.873,59054,2.715,17.746,3991,4095,28489
2003,No Utility Patent Granted,62,524690,652370,14088315,13850958,59486,9.217,45558,7.059,1830790,533257,1297533,3.850,13.218,1355333,454313,901020,3.280,9.785,475457,3.433,19.570,29077,30538,230435
2003,No Utility Patent Granted,71,83070,89561,1708871,1686593,12533,14.198,9960,11.283,305918,96199,209719,5.704,18.138,261163,78807,182356,4.673,15.485,44755,2.654,30.969,6877,6933,54124
2003,No Utility Patent Granted,72,376383,490500,9747756,9565407,63833,13.139,54510,11.220,1848131,843091,1005040,8.814,19.321,1485768,595836,889932,6.229,15.533,362363,3.788,31.065,38362,39356,351081
2003,No Utility Patent Granted,81,613308,667848,5195256,5146246,60503,9.107,53494,8.052,794047,230796,563251,4.485,15.430,695396,209158,486238,4.064,13.513,98651,1.917,27.025,38104,38866,141275
2003,Utility Patent Granted,11,66,277,14040,13365,29,10.376,34,12.165,3969,1110,2859,8.306,29.698,2482,793,1689,5.934,18.572,1487,11.126,37.143,D,D,D
2003,Utility Patent Granted,21,216,2372,151186,156949,194,7.881,373,15.153,20425,5694,14731,3.628,13.014,31355,11962,19393,7.622,19.978,-10930,-6.964,26.028,D,D,D
2003,Utility Patent Granted,22,100,5668,339463,340390,572,10.189,464,8.265,39039,13189,25850,3.875,11.469,40363,10191,30172,2.994,11.858,-1324,-0.389,22.938,3,3,31
2003,Utility Patent Granted,23,652,3531,263443,283645,379,10.917,260,7.490,38317,5883,32434,2.074,13.509,76483,16875,59608,5.949,26.964,-38166,-13.456,27.018,24,24,111
2003,Utility Patent Granted,31-33,9394,34674,6861800,7032429,1228,3.486,2325,6.601,481364,102453,378911,1.457,6.845,829680,234930,594750,3.341,11.798,-348316,-4.953,13.690,305,328,14304
2003,Utility Patent Granted,42,5120,37080,1464436,1462921,2712,7.089,5063,13.235,248951,99337,149614,6.790,17.017,246373,91365,155008,6.245,16.841,2578,0.176,33.682,189,201,3900
2003,Utility Patent Granted,44-45,1146,91302,1908090,1881795,5417,5.961,4564,5.022,240656,107288,133368,5.701,12.789,184173,45743,138430,2.431,9.787,56483,3.002,19.574,36,45,308
2003,Utility Patent Granted,48-49,915,12431,981220,1015789,3006,25.947,1314,11.342,244610,204711,39899,20.153,24.081,310034,48087,261947,4.734,30.522,-65424,-6.441,48.162,12,12,174
2003,Utility Patent Granted,51,1074,41170,1881153,1922105,6138,14.996,5658,13.824,256978,119167,137811,6.200,13.370,340650,176800,163850,9.198,17.723,-83672,-4.353,26.739,68,77,3010
2003,Utility Patent Granted,52,611,65316,1856028,1929600,8914,13.350,11825,17.710,291080,125358,165722,6.497,15.085,444360,180139,264221,9.336,23.029,-153280,-7.944,30.170,9,9,92
2003,Utility Patent Granted,53,602,15613,223883,219879,877,5.574,1118,7.106,36130,6514,29616,2.963,16.432,29443,9376,20067,4.264,13.391,6687,3.041,26.781,24,24,119
2003,Utility Patent Granted,54,5237,21804,1383177,1397033,2537,11.433,3308,14.908,241930,103228,138702,7.389,17.317,268681,98333,170348,7.039,19.232,-26751,-1.915,34.635,380,392,8357
2003,Utility Patent Granted,55,2651,10794,1410926,1443574,1012,9.125,1605,14.472,203055,55550,147505,3.848,14.066,267388,91539,175849,6.341,18.523,-64333,-4.457,28.132,23,32,1394
2003,Utility Patent Granted,56,970,12272,930397,994830,1791,13.675,3441,26.273,147206,45050,102156,4.528,14.797,273065,85933,187132,8.638,27.448,-125859,-12.651,29.594,33,44,5746
2003,Utility Patent Granted,61,250,1294,578238,570941,94,7.054,171,12.833,45197,1861,43336,0.326,7.916,32520,6327,26193,1.108,5.696,12677,2.220,11.392,4,4,34
2003,Utility Patent Granted,62,446,12458,1249675,1242445,955,7.644,1025,8.205,111964,22250,89714,1.791,9.012,96698,24686,72012,1.987,7.783,15266,1.229,15.566,9,9,87
2003,Utility Patent Granted,71,169,1041,126045,121447,137,13.478,88,8.657,25968,6061,19907,4.991,21.382,16660,3219,13441,2.651,13.718,9308,7.664,27.436,7,8,13
2003,Utility Patent Granted,72,410,21259,685099,686663,2431,11.750,1293,6.249,78395,45578,32817,6.638,11.417,81001,21438,59563,3.122,11.796,-2606,-0.380,22.834,26,41,489
2003,Utility Patent Granted,81,797,8108,169106,169934,762,9.246,1028,12.474,23990,7868,16122,4.630,14.117,26330,10726,15604,6.312,15.494,-2340,-1.377,28.234,21,53,416
2004,No Utility Patent Granted,11,20476,20928,171358,170358,2683,12.831,2647,12.659,33056,10837,22219,6.361,19.404,31145,12165,18980,7.141,18.282,1911,1.122,36.564,1892,1893,7784
2004,No Utility Patent Granted,21,16362,19421,305224,299140,1924,9.972,1671,8.660,56931,16495,40436,5.514,19.032,44608,17079,27529,5.709,14.912,12323,4.119,29.824,1085,1110,9185
2004,No Utility Patent Granted,22,6238,11723,339082,345792,655,5.552,803,6.807,19625,6415,13210,1.855,5.675,32679,9502,23177,2.748,9.450,-13054,-3.775,11.351,282,285,1391
2004,No Utility Patent Granted,23,621083,627689,6399742,6253279,98036,15.907,75243,12.209,1421369,386830,1034539,6.186,22.730,1129403,364148,765255,5.823,18.061,291966,4.669,36.122,52642,52716,263032
2004,No Utility Patent Granted,31-33,265061,285946,7242970,7272468,21446,7.456,24858,8.642,868906,240258,628648,3.304,11.948,928434,315334,613100,4.336,12.766,-59528,-0.819,23.896,19101,19290,195977
2004,No Utility Patent Granted,42,298809,357137,4403008,4377548,31437,8.804,31297,8.765,599151,173428,425723,3.962,13.687,549194,201287,347907,4.598,12.546,49957,1.141,25.091,22697,23388,127888
2004,No Utility Patent Granted,44-45,657006,947382,13238538,13131083,95410,10.097,90481,9.576,1797698,642970,1154728,4.897,13.690,1586495,571131,1015364,4.349,12.082,211203,1.608,24.164,61832,65916,324721
2004,No Utility Patent Granted,48-49,139890,170815,3106712,3062701,24220,14.308,21141,12.489,484174,189397,294777,6.184,15.809,395297,139375,255922,4.551,12.907,88877,2.902,25.814,15600,15866,87114
2004,No Utility Patent Granted,51,62441,85867,1767198,1791450,11551,13.473,11291,13.169,276254,107169,169085,5.982,15.421,323143,123462,199681,6.892,18.038,-46889,-2.617,30.841,6604,6909,49987
2004,No Utility Patent Granted,52,221297,364305,4624773,4602617,38842,10.718,35043,9.670,704406,243293,461113,5.286,15.304,661192,268235,392957,5.828,14.366,43214,0.939,28.731,15574,16156,82004
2004,No Utility Patent Granted,53,233835,282517,1872109,1843759,37692,13.592,27294,9.842,338933,142009,196924,7.702,18.383,282155,117659,164496,6.381,15.303,56778,3.079,30.607,18771,19661,80194
2004,No Utility Patent Granted,54,605986,656015,5875389,5819318,86238,13.299,71140,10.971,1027640,347798,679842,5.977,17.659,916283,368797,547486,6.337,15.746,111357,1.914,31.491,50224,50774,231631
2004,No Utility Patent Granted,55,23540,35697,1395639,1394360,3089,8.652,3101,8.686,242890,81750,161140,5.863,17.419,240379,91652,148727,6.573,17.239,2511,0.180,34.479,1120,1169,18987
2004,No Utility Patent Granted,56,261328,299590,7591032,7535070,44002,14.851,37387,12.619,1715982,501949,1214033,6.662,22.773,1622275,577338,1044937,7.662,21.530,93707,1.244,43.059,25419,25935,295914
2004,No Utility Patent Granted,61,62522,69114,2295781,2249982,7881,11.590,5654,8.315,256746,56406,200340,2.507,11.411,165173,45244,119929,2.011,7.341,91573,4.070,14.682,4085,4142,35211
2004,No Utility Patent Granted,62,536681,666957,14327463,14165628,58376,8.852,43374,6.577,1585266,487837,1097429,3.444,11.191,1261755,389182,872573,2.747,8.907,323511,2.284,17.814,30247,31196,228925
2004,No Utility Patent Granted,71,86613,93238,1777380,1755557,13283,14.509,9904,10.818,280067,95280,184787,5.427,15.953,237125,75874,161251,4.322,13.507,42942,2.446,27.014,6987,7025,49957
2004,No Utility Patent Granted,72,386765,502001,10050758,9908959,65461,13.168,55685,11.202,1794390,862710,931680,8.706,18.109,1518553,588697,929856,5.941,15.325,275837,2.784,30.650,40528,41651,381812
2004,No Utility Patent Granted,81,615427,668658,5237448,5199169,57944,8.696,53279,7.996,751096,239899,511197,4.614,14.446,675515,204941,470574,3.942,12.993,75581,1.454,25.985,39612,40145,146076
2004,Utility Patent Granted,11,65,254,10955,11077,D,D,25,9.416,460,D,458,D,4.153,733,116,617,1.047,6.617,-273,-2.465,8.305,D,D,D
2004,Utility Patent Granted,21,208,2291,162179,161910,230,9.890,299,12.857,17561,7131,10430,4.404,10.846,16858,5836,11022,3.604,10.412,703,0.434,20.824,4,10,393
2004,Utility Patent Granted,22,91,5540,291098,300708,584,10.553,572,10.336,35661,14247,21414,4.738,11.859,54827,14474,40353,4.813,18.233,-19166,-6.374,23.718,4,4,40
2004,Utility Patent Granted,23,618,3460,231041,239635,206,5.903,265,7.594,42436,9015,33421,3.762,17.709,59687,12994,46693,5.422,24.907,-17251,-7.199,35.417,27,33,1332
2004,Utility Patent Granted,31-33,8998,33339,6517671,6637124,1259,3.738,1937,5.752,460224,104238,355986,1.571,6.934,697977,196915,501062,2.967,10.516,-237753,-3.582,13.868,282,305,13459
2004,Utility Patent Granted,42,5115,38541,1510229,1498886,5007,13.264,3423,9.068,262698,116589,146109,7.778,17.526,240951,96924,144027,6.466,16.075,21747,1.451,32.151,160,192,3740
2004,Utility Patent Granted,44-45,1114,88051,2162736,2026998,6019,6.856,5499,6.264,441977,108967,333010,5.376,21.805,173023,64570,108453,3.185,8.536,268954,13.269,17.072,54,54,740
2004,Utility Patent Granted,48-49,918,11620,1017633,1006310,1504,12.807,1751,14.910,179133,62772,116361,6.238,17.801,160983,68411,92572,6.798,15.997,18150,1.804,31.995,4,4,26
2004,Utility Patent Granted,51,1054,40494,1705232,1750902,7145,17.855,6190,15.469,289668,89570,200098,5.116,16.544,377366,130202,247164,7.436,21.553,-87698,-5.009,33.088,62,73,2889
2004,Utility Patent Granted,52,581,69343,1788729,1801729,14289,21.061,11296,16.649,403531,196305,207226,10.895,22.397,433561,172960,260601,9.600,24.064,-30030,-1.667,44.794,14,14,210
2004,Utility Patent Granted,53,610,17819,230652,234581,2390,13.794,1406,8.115,38267,21225,17042,9.048,16.313,44398,14262,30136,6.080,18.927,-6131,-2.614,32.626,13,15,128
2004,Utility Patent Granted,54,5348,22732,1370859,1374468,4249,19.283,2854,12.952,233687,108306,125381,7.880,17.002,243733,74575,169158,5.426,17.733,-10046,-0.731,34.004,325,348,7283
2004,Utility Patent Granted,55,2590,10967,1380973,1414954,1106,10.085,1105,10.076,183732,64148,119584,4.534,12.985,248925,70280,178645,4.967,17.592,-65193,-4.607,25.970,26,32,1623
2004,Utility Patent Granted,56,933,12073,842038,846758,2265,18.922,2059,17.201,144345,48795,95550,5.763,17.047,152887,63620,89267,7.513,18.056,-8542,-1.009,34.094,35,78,835
2004,Utility Patent Granted,61,256,1174,582716,574161,146,12.813,77,6.757,34387,5390,28997,0.939,5.989,16816,1464,15352,0.255,2.929,17571,3.060,5.858,D,D,D
2004,Utility Patent Granted,62,461,13357,1354654,1338686,1508,11.492,1039,7.918,104976,21897,83079,1.636,7.842,74395,25200,49195,1.882,5.557,30581,2.284,11.115,23,62,1328
2004,Utility Patent Granted,71,172,1110,108164,106338,228,22.050,76,7.350,15864,4344,11520,4.085,14.918,12692,1989,10703,1.870,11.936,3172,2.983,23.871,10,10,108
2004,Utility Patent Granted,72,403,20007,683745,677960,1001,4.999,1037,5.179,76052,24458,51594,3.608,11.218,65124,22666,42458,3.343,9.606,10928,1.612,19.212,19,19,174
2004,Utility Patent Granted,81,771,10392,180606,192552,676,6.503,684,6.579,23392,8057,15335,4.184,12.148,44932,29294,15638,15.214,23.335,-21540,-11.187,24.297,22,22,486
2005,No Utility Patent Granted,11,19095,19574,155376,156446,2539,12.993,2474,12.660,28806,9733,19073,6.221,18.413,30992,9959,21033,6.366,19.810,-2186,-1.397,36.826,1776,1779,7154
2005,No Utility Patent Granted,21,16666,19932,339612,324606,2130,10.830,1600,8.135,67965,21228,46737,6.540,20.938,38014,13410,24604,4.131,11.711,29951,9.227,23.422,1051,1083,7885
2005,No Utility Patent Granted,22,6054,12268,407266,402496,672,5.424,915,7.385,44528,12217,32311,3.035,11.063,35593,14854,20739,3.690,8.843,8935,2.220,17.686,223,232,945
2005,No Utility Patent Granted,23,645130,652586,6560659,6484591,101232,15.774,79567,12.398,1415744,434015,981729,6.693,21.832,1262221,369946,892275,5.705,19.465,153523,2.368,38.930,55782,55831,263408
2005,No Utility Patent Granted,31-33,260956,282022,7377951,7345505,20717,7.302,24070,8.484,921240,230045,691195,3.132,12.542,856002,284220,571782,3.869,11.653,65238,0.888,23.307,18591,18751,186592
2005,No Utility Patent Granted,42,299605,359242,4447584,4431980,32402,9.025,32007,8.914,593782,181467,412315,4.094,13.398,562514,186499,376015,4.208,12.692,31268,0.706,25.384,23422,24144,123749
2005,No Utility Patent Granted,44-45,653121,955546,13541137,13569386,96137,10.080,92602,9.709,1700040,677230,1022810,4.991,12.528,1757457,547635,1209822,4.036,12.952,-57417,-0.423,25.057,64178,67117,321219
2005,No Utility Patent Granted,48-49,143056,174949,3250470,3209512,24795,14.290,21930,12.639,493283,166575,326708,5.190,15.369,410497,147654,262843,4.601,12.790,82786,2.579,25.580,15344,15633,80933
2005,No Utility Patent Granted,51,62214,85832,1756297,1753206,11297,13.228,10441,12.225,298205,123887,174318,7.066,17.009,291939,105476,186463,6.016,16.652,6266,0.357,33.303,6408,6726,52293
2005,No Utility Patent Granted,52,226411,375625,4643995,4651367,46329,12.522,35033,9.469,688152,276315,411837,5.941,14.795,697331,256229,441102,5.509,14.992,-9179,-0.197,29.589,16927,17658,90055
2005,No Utility Patent Granted,53,242931,297071,1922125,1904225,43411,14.938,30483,10.489,346257,167028,179229,8.771,18.184,311224,113626,197598,5.967,16.344,35033,1.840,32.688,21031,22048,76947
2005,No Utility Patent Granted,54,622276,667503,5904993,5840467,87534,13.274,71409,10.829,1041423,350542,690881,6.002,17.831,908007,311972,596035,5.342,15.547,133416,2.284,31.094,50284,50856,206880
2005,No Utility Patent Granted,55,23388,36833,1480546,1479944,3279,8.972,2703,7.396,245330,92296,153034,6.236,16.577,244867,69618,175249,4.704,16.546,463,0.031,33.091,1044,1084,16175
2005,No Utility Patent Granted,56,266820,306529,8033830,7815213,43765,14.415,37901,12.484,1821200,558753,1262447,7.150,23.303,1386346,479093,907253,6.130,17.739,434854,5.564,35.478,26036,26428,309750
2005,No Utility Patent Granted,61,63411,70922,2312757,2278261,8619,12.379,6023,8.651,258076,80529,177547,3.535,11.328,189119,38640,150479,1.696,8.301,68957,3.027,16.602,4401,4446,26444
2005,No Utility Patent Granted,62,547923,682795,14585910,14492528,60315,8.930,45528,6.741,1562194,522958,1039236,3.608,10.779,1377126,409471,967655,2.825,9.502,185068,1.277,19.005,31673,32548,228022
2005,No Utility Patent Granted,71,89039,95421,1801583,1782778,13337,14.164,10811,11.482,290440,104748,185692,5.876,16.291,254193,73342,180851,4.114,14.258,36247,2.033,28.517,7717,7768,51867
2005,No Utility Patent Granted,72,397467,516633,10259172,10140902,70193,13.755,57580,11.283,1874245,985900,888345,9.722,18.482,1643575,604359,1039216,5.960,16.207,230670,2.275,32.415,44118,45237,424816
2005,No Utility Patent Granted,81,618105,671598,5178035,5202876,59177,8.835,55654,8.309,693986,231338,462648,4.446,13.339,743680,207363,536317,3.986,14.294,-49694,-0.955,26.677,40533,41207,149290
2005,Utility Patent Granted,11,58,224,11787,11981,8,3.441,25,10.753,662,273,389,2.279,5.525,1032,209,823,1.744,8.614,-370,-3.088,11.051,D,D,D
2005,Utility Patent Granted,21,210,2133,153730,155163,130,6.020,183,8.474,19918,4063,15855,2.619,12.837,22338,5842,16496,3.765,14.397,-2420,-1.560,25.674,D,D,D
2005,Utility Patent Granted,22,95,4465,225609,227769,363,8.078,420,9.347,17679,7474,10205,3.281,7.762,21828,7371,14457,3.236,9.583,-4149,-1.822,15.524,D,D,D
2005,Utility Patent Granted,23,612,3469,227472,231153,388,11.261,341,9.897,43422,15445,27977,6.682,18.785,51517,14486,37031,6.267,22.287,-8095,-3.502,37.570,21,21,93
2005,Utility Patent Granted,31-33,8507,32118,6298352,6348254,1089,3.353,1816,5.591,474737,81014,393723,1.276,7.478,572899,165166,407733,2.602,9.025,-98162,-1.546,14.956,243,266,11968
2005,Utility Patent Granted,42,5084,38983,1528518,1534070,3134,8.092,2626,6.780,210462,71061,139401,4.632,13.719,221145,66100,155045,4.309,14.416,-10683,-0.696,27.438,157,177,4421
2005,Utility Patent Granted,44-45,1049,79705,1774332,1766533,5067,6.377,4560,5.739,256636,89773,166863,5.082,14.528,243334,50784,192550,2.875,13.775,13302,0.753,27.549,44,115,362
2005,Utility Patent Granted,48-49,888,11113,915788,947357,1085,9.862,862,7.835,86390,44681,41709,4.716,9.119,148448,22142,126306,2.337,15.670,-62058,-6.551,18.238,11,11,165
2005,Utility Patent Granted,51,1052,41430,1650091,1684539,4630,11.206,4406,10.664,179543,61123,118420,3.628,10.658,248386,81210,167176,4.821,14.745,-68843,-4.087,21.317,76,167,5272
2005,Utility Patent Granted,52,555,65365,1727730,1747140,11507,17.145,15010,22.364,343622,191332,152290,10.951,19.668,383401,229964,153437,13.162,21.944,-39779,-2.277,39.335,12,12,66
2005,Utility Patent Granted,53,594,17103,216321,215113,3430,21.142,1671,10.300,56705,32869,23836,15.280,26.361,53322,14517,38805,6.749,24.788,3383,1.573,49.576,17,18,86
2005,Utility Patent Granted,54,5265,28191,1478269,1475289,3243,11.413,3693,12.996,238245,92622,145623,6.278,16.149,231537,85860,145677,5.820,15.694,6708,0.455,31.389,335,367,6253
2005,Utility Patent Granted,55,2513,10884,1355774,1359197,1383,12.945,982,9.192,175845,48202,127643,3.546,12.937,182758,49654,133104,3.653,13.446,-6913,-0.509,25.875,17,18,427
2005,Utility Patent Granted,56,902,11323,936119,903235,2102,18.461,2228,19.568,246102,80933,165169,8.960,27.247,176570,74508,102062,8.249,19.549,69532,7.698,39.097,22,22,204
2005,Utility Patent Granted,61,240,875,567668,572102,133,14.134,265,28.162,37355,16351,21004,2.858,6.529,46484,6730,39754,1.176,8.125,-9129,-1.596,13.059,10,11,120
2005,Utility Patent Granted,62,450,14102,1325340,1312979,1699,12.359,990,7.201,103036,22535,80501,1.716,7.848,80030,21299,58731,1.622,6.095,23006,1.752,12.191,17,18,264
2005,Utility Patent Granted,71,178,1513,135837,132743,126,8.389,104,6.924,16855,7481,9374,5.636,12.698,10022,2987,7035,2.250,7.550,6833,5.148,15.100,5,5,135
2005,Utility Patent Granted,72,412,20762,772690,754280,1315,6.420,754,3.681,94022,38153,55869,5.058,12.465,58151,23955,34196,3.176,7.709,35871,4.756,15.419,24,54,1391
2005,Utility Patent Granted,81,732,10314,175906,182793,880,8.379,1256,11.960,23203,8401,14802,4.596,12.694,37046,13897,23149,7.603,20.267,-13843,-7.573,25.387,22,22,83
2006,No Utility Patent Granted,11,18930,19433,155636,155575,2624,13.525,2560,13.195,29864,10882,18982,6.995,19.196,29538,10386,19152,6.676,18.986,326,0.210,37.973,1898,1898,7855
2006,No Utility Patent Granted,21,17585,21139,392587,366443,2830,13.763,1678,8.160,90685,34752,55933,9.484,24.747,37878,14424,23454,3.936,10.337,52807,14.411,20.673,1114,1139,8352
2006,No Utility Patent Granted,22,5944,12152,410782,417185,730,5.976,859,7.031,33203,11668,21535,2.797,7.959,45635,11268,34367,2.701,10.939,-12432,-2.980,15.918,257,262,2698
2006,No Utility Patent Granted,23,675295,683762,7120766,6835664,111684,16.720,80073,11.988,1667991,486926,1181065,7.123,24.401,1100289,336991,763298,4.930,16.096,567702,8.305,32.193,59576,59661,250165
2006,No Utility Patent Granted,31-33,260632,282394,7507833,7459426,22517,7.964,23204,8.207,922696,254239,668457,3.408,12.370,825348,278063,547285,3.728,11.064,97348,1.305,22.129,18272,18415,173463
2006,No Utility Patent Granted,42,300286,364109,4498913,4445120,35702,9.858,31781,8.776,634490,209022,425468,4.702,14.274,527830,180509,347321,4.061,11.874,106660,2.399,23.749,23634,24349,127611
2006,No Utility Patent Granted,44-45,647749,962788,13311404,13161408,100611,10.477,95687,9.964,1851252,758674,1092578,5.764,14.066,1553222,527685,1025537,4.009,11.801,298030,2.264,23.603,67791,70846,314475
2006,No Utility Patent Granted,48-49,146993,178784,3237032,3188400,27580,15.642,22649,12.846,532137,209733,322404,6.578,16.690,437028,152399,284629,4.780,13.707,95109,2.983,27.414,16452,16778,86625
2006,No Utility Patent Granted,51,62325,82837,1603539,1584705,11051,13.469,9470,11.542,241289,91126,150163,5.750,15.226,204535,73260,131275,4.623,12.907,36754,2.319,25.814,6369,6537,44193
2006,No Utility Patent Granted,52,231385,393877,4876509,4780211,53078,13.780,35692,9.266,848373,361090,487283,7.554,17.748,657226,266793,390433,5.581,13.749,191147,3.999,27.498,18442,18909,76443
2006,No Utility Patent Granted,53,251165,315380,2047769,2017995,49184,15.937,35635,11.547,385771,178034,207737,8.822,19.117,325363,132618,192745,6.572,16.123,60408,2.993,32.246,25402,25883,86146
2006,No Utility Patent Granted,54,642014,689260,6143004,5979385,97521,14.383,75046,11.068,1168083,405408,762675,6.780,19.535,841145,319975,521170,5.351,14.067,326938,5.468,28.135,53414,53851,209611
2006,No Utility Patent Granted,55,23721,37526,1522911,1517598,3792,10.200,3091,8.315,275248,94455,180793,6.224,18.137,266432,63226,203206,4.166,17.556,8816,0.581,35.112,1070,1103,13092
2006,No Utility Patent Granted,56,275558,318876,8678490,8358193,50260,16.070,38031,12.160,2040753,620226,1420527,7.421,24.416,1405752,456278,949474,5.459,16.819,635001,7.597,33.638,27191,27517,274325
2006,No Utility Patent Granted,61,65487,73679,2390871,2348521,9364,12.946,6664,9.213,277643,79994,197649,3.406,11.822,193700,42188,151512,1.796,8.248,83943,3.574,16.495,4964,5045,31845
2006,No Utility Patent Granted,62,557064,699264,15086561,14865303,66438,9.631,47551,6.893,1730380,598909,1131471,4.029,11.640,1286617,402951,883666,2.711,8.655,443763,2.985,17.310,33615,34468,238482
2006,No Utility Patent Granted,71,91233,97807,1849039,1824197,14377,14.895,11811,12.236,293942,105763,188179,5.798,16.114,244089,77378,166711,4.242,13.381,49853,2.733,26.761,8753,8805,58351
2006,No Utility Patent Granted,72,407146,533280,10717941,10543634,73657,13.994,59763,11.355,1962955,1008613,954342,9.566,18.617,1612685,606666,1006019,5.754,15.295,350270,3.322,30.591,46582,47598,426506
2006,No Utility Patent Granted,81,614174,668982,5223516,5186765,61423,9.172,62786,9.376,746448,247619,498829,4.774,14.391,673467,218390,455077,4.211,12.984,72981,1.407,25.969,45906,46742,156565
2006,Utility Patent Granted,11,49,206,8565,9540,5,2.353,18,8.471,705,15,690,0.157,7.390,2816,2091,725,21.918,29.518,-2111,-22.128,14.780,0,0,0
2006,Utility Patent Granted,21,216,2136,158256,156095,152,7.075,177,8.238,24897,6898,17999,4.419,15.950,20251,9496,10755,6.083,12.974,4646,2.976,25.947,3,3,6
2006,Utility Patent Granted,22,95,4523,207847,208836,395,8.878,247,5.552,18866,7256,11610,3.475,9.034,20972,2987,17985,1.430,10.042,-2106,-1.008,18.068,D,D,D
2006,Utility Patent Granted,23,603,3485,240465,236434,385,11.019,403,11.534,57129,16770,40359,7.093,24.163,49666,14589,35077,6.170,21.006,7463,3.156,42.013,21,73,965
2006,Utility Patent Granted,31-33,8175,31508,6130864,6176379,1252,3.948,1663,5.244,452558,79705,372853,1.290,7.327,543334,143280,400054,2.320,8.797,-90776,-1.470,14.654,209,228,8600
2006,Utility Patent Granted,42,5059,38336,1545552,1567123,3465,9.021,3613,9.406,213841,73374,140467,4.682,13.645,256597,88862,167735,5.670,16.374,-42756,-2.728,27.291,137,149,6896
2006,Utility Patent Granted,44-45,1036,77282,2431312,2375219,5536,7.272,3218,4.227,369478,170306,199172,7.170,15.556,263086,46439,216647,1.955,11.076,106392,4.479,22.153,52,73,940
2006,Utility Patent Granted,48-49,864,12727,1093648,1071927,1462,11.574,1271,10.062,137086,42926,94160,4.005,12.789,94024,33790,60234,3.152,8.771,43062,4.017,17.543,6,6,584
2006,Utility Patent Granted,51,1079,47401,1835442,1845256,7434,15.944,5881,12.614,292125,118639,173486,6.429,15.831,315887,93367,222520,5.060,17.119,-23762,-1.288,31.662,57,206,8348
2006,Utility Patent Granted,52,570,66511,1702004,1691412,10961,16.830,8198,12.587,332675,170012,162663,10.051,19.668,309343,121645,187698,7.192,18.289,23332,1.379,36.578,14,30,794
2006,Utility Patent Granted,53,584,12872,152298,148478,2355,18.975,1433,11.546,34971,13750,21221,9.261,23.553,27649,11155,16494,7.513,18.622,7322,4.931,37.243,20,20,101
2006,Utility Patent Granted,54,5535,33015,1642595,1607853,6695,21.497,2954,9.485,311255,107555,203700,6.689,19.358,242427,74850,167577,4.655,15.078,68828,4.281,30.155,311,352,6629
2006,Utility Patent Granted,55,2528,11702,1394607,1400030,1685,14.687,1227,10.695,208037,55043,152994,3.932,14.859,219679,62025,157654,4.430,15.691,-11642,-0.832,29.719,21,22,814
2006,Utility Patent Granted,56,913,13297,997137,980253,3000,23.764,1654,13.102,221173,87165,134008,8.892,22.563,186141,67336,118805,6.869,18.989,35032,3.574,37.978,28,29,226
2006,Utility Patent Granted,61,240,1267,589297,583151,323,28.234,77,6.731,34514,4009,30505,0.687,5.919,21251,1141,20110,0.196,3.644,13263,2.274,7.288,5,5,65
2006,Utility Patent Granted,62,459,18280,1339412,1315338,3526,20.052,2135,12.141,137939,67714,70225,5.148,10.487,87090,33023,54067,2.511,6.621,50849,3.866,13.242,11,70,604
2006,Utility Patent Granted,71,158,1791,132491,134228,262,15.171,134,7.759,9623,2507,7116,1.868,7.169,12978,3367,9611,2.508,9.669,-3355,-2.499,14.338,7,7,41
2006,Utility Patent Granted,72,391,19818,702315,692001,1576,8.148,626,3.236,87105,41924,45181,6.058,12.587,68865,18627,50238,2.692,9.952,18240,2.636,19.903,26,35,295
2006,Utility Patent Granted,81,723,9746,194724,197761,555,5.331,1883,18.088,22482,6845,15637,3.461,11.368,27896,13640,14256,6.897,14.106,-5414,-2.738,22.737,18,24,433
2007,No Utility Patent Granted,11,18919,19439,156998,157338,2381,12.213,2495,12.797,29062,11169,17893,7.099,18.471,29526,10532,18994,6.694,18.766,-464,-0.295,36.942,1821,1824,7762
2007,No Utility Patent Granted,21,18342,21917,490850,437037,3052,14.333,1805,8.477,163833,44161,119672,10.105,37.487,55930,21157,34773,4.841,12.798,107903,24.690,25.595,1155,1172,10917
2007,No Utility Patent Granted,22,5370,11505,392812,388863,643,5.583,667,5.791,36534,9011,27523,2.317,9.395,28362,8437,19925,2.170,7.294,8172,2.102,14.587,239,251,1610
2007,No Utility Patent Granted,23,685105,694073,7067958,7119140,98132,14.207,91468,13.242,1357825,391116,966709,5.494,19.073,1462171,386614,1075557,5.431,20.539,-104346,-1.466,38.146,68793,68853,286974
2007,No Utility Patent Granted,31-33,261876,283264,7388254,7448094,21115,7.427,23218,8.166,841389,229161,612228,3.077,11.297,961887,316871,645016,4.254,12.915,-120498,-1.618,22.593,17759,17942,190783
2007,No Utility Patent Granted,42,296978,361721,4564741,4565164,33487,9.251,34025,9.399,651688,205587,446101,4.503,14.275,653355,221451,431904,4.851,14.312,-1667,-0.037,28.550,23161,23760,128427
2007,No Utility Patent Granted,44-45,641892,960902,13200111,13219076,103341,10.780,98750,10.301,1881210,742274,1138936,5.615,14.231,1916758,616630,1300128,4.665,14.500,-35548,-0.269,28.462,65415,68153,335123
2007,No Utility Patent Granted,48-49,149151,181700,3295352,3266948,26677,14.807,23599,13.099,535836,182904,352932,5.599,16.402,478373,162946,315427,4.988,14.643,57463,1.759,29.286,16630,16834,82212
2007,No Utility Patent Granted,51,61387,83193,1693616,1675529,10611,12.795,10087,12.163,291139,96462,194677,5.757,17.376,253890,92302,161588,5.509,15.153,37249,2.223,30.306,6311,6546,52415
2007,No Utility Patent Granted,52,233690,400088,4782575,4794670,47915,12.104,39458,9.968,750928,306026,444902,6.383,15.662,771109,277919,493190,5.796,16.083,-20181,-0.421,31.323,19902,20926,105574
2007,No Utility Patent Granted,53,251115,319229,1994323,2002751,44770,14.087,41930,13.193,370077,160838,209239,8.031,18.478,388763,152204,236559,7.600,19.411,-18686,-0.933,36.957,28410,28853,93706
2007,No Utility Patent Granted,54,650601,697094,6056438,6004038,92688,13.445,77237,11.204,1051359,366486,684873,6.104,17.511,947841,349608,598233,5.823,15.787,103518,1.724,31.573,54609,55015,223781
2007,No Utility Patent Granted,55,24052,38641,1499248,1491880,4614,12.045,3943,10.294,308546,98345,210201,6.592,20.682,291829,102914,188915,6.898,19.561,16717,1.121,39.122,857,891,11004
2007,No Utility Patent Granted,56,279902,321892,8617131,8575028,46462,14.566,40641,12.741,1756959,543321,1213638,6.336,20.489,1675751,510766,1164985,5.956,19.542,81208,0.947,39.084,27431,27740,309790
2007,No Utility Patent Granted,61,68038,76581,2442679,2417829,8885,11.771,6688,8.860,249246,68429,180817,2.830,10.309,200170,46908,153262,1.940,8.279,49076,2.030,16.558,4738,4786,28098
2007,No Utility Patent Granted,62,564015,712421,15446631,15269049,65751,9.317,52294,7.410,1896353,596069,1300284,3.904,12.420,1540205,485897,1054308,3.182,10.087,356148,2.332,20.174,33505,34509,257937
2007,No Utility Patent Granted,71,92266,99622,1904946,1889880,13758,13.916,12242,12.383,292666,97001,195665,5.133,15.486,263589,85636,177953,4.531,13.947,29077,1.539,27.895,8990,9042,59097
2007,No Utility Patent Granted,72,414566,544943,10768819,10718205,75196,13.950,63361,11.755,1963263,992519,970744,9.260,18.317,1851962,692259,1159703,6.459,17.279,111301,1.038,34.557,46725,47711,441907
2007,No Utility Patent Granted,81,614332,661063,5106307,5100898,59059,8.945,57383,8.691,725851,235156,490695,4.610,14.230,714060,214737,499323,4.210,13.999,11791,0.231,27.997,40910,41509,146664
2007,Utility Patent Granted,11,51,209,11247,11742,0,0.000,18,8.257,394,0,394,0.000,3.356,1371,354,1017,3.015,11.677,-977,-8.321,6.711,D,D,D
2007,Utility Patent Granted,21,205,2266,216640,188694,330,14.762,269,12.033,72210,15648,56562,8.293,38.268,16085,8271,7814,4.383,8.524,56125,29.744,17.049,5,5,57
2007,Utility Patent Granted,22,87,4696,252454,246896,388,8.255,396,8.426,33394,7879,25515,3.191,13.526,22779,5416,17363,2.194,9.226,10615,4.299,18.452,D,D,D
2007,Utility Patent Granted,23,631,3392,249049,244829,218,6.198,469,13.333,66844,8624,58220,3.522,27.302,59932,20042,39890,8.186,24.479,6912,2.823,48.958,30,30,581
2007,Utility Patent Granted,31-33,7827,31366,5977845,6068556,857,2.689,1866,5.855,412971,65830,347141,1.085,6.805,597327,163741,433586,2.698,9.843,-184356,-3.038,13.610,202,213,9763
2007,Utility Patent Granted,42,5024,39610,1547501,1566138,2860,7.171,3409,8.547,231140,67975,163165,4.340,14.759,268754,102305,166449,6.532,17.160,-37614,-2.402,29.517,150,172,3322
2007,Utility Patent Granted,44-45,1001,83580,2411546,2424474,6923,8.409,4425,5.375,309868,125745,184123,5.186,12.781,335528,63622,271906,2.624,13.839,-25660,-1.058,25.562,36,41,950
2007,Utility Patent Granted,48-49,889,13502,1143205,1135850,1530,11.446,1261,9.433,156408,49221,107187,4.333,13.770,142177,53973,88204,4.752,12.517,14231,1.253,25.034,10,10,74
2007,Utility Patent Granted,51,1162,45254,1785004,1802488,6735,14.612,8410,18.246,294139,123568,170571,6.855,16.318,330564,147739,182825,8.196,18.339,-36425,-2.021,32.637,50,69,1641
2007,Utility Patent Granted,52,600,71114,1815430,1829619,12908,18.261,12052,17.050,361088,141276,219812,7.722,19.736,393356,175275,218081,9.580,21.499,-32268,-1.764,39.471,15,19,203
2007,Utility Patent Granted,53,568,11638,193269,187802,1938,16.597,2016,17.265,51765,15001,36764,7.988,27.564,40782,21547,19235,11.473,21.715,10983,5.848,43.431,20,20,189
2007,Utility Patent Granted,54,5437,34406,1682222,1691446,3341,9.650,3770,10.890,320051,87242,232809,5.158,18.922,342682,112954,229728,6.678,20.260,-22631,-1.338,37.843,304,315,7244
2007,Utility Patent Granted,55,2386,11456,1356429,1342657,1258,10.839,1558,13.424,263886,80748,183138,6.014,19.654,233639,100107,133532,7.456,17.401,30247,2.253,34.802,13,13,320
2007,Utility Patent Granted,56,843,15379,1143589,1159712,2237,14.642,2034,13.314,223108,77985,145123,6.725,19.238,256318,80138,176180,6.910,22.102,-33210,-2.864,38.476,23,24,330
2007,Utility Patent Granted,61,243,1273,597767,591677,112,8.949,69,5.513,36339,3077,33262,0.520,6.142,24792,2711,22081,0.458,4.190,11547,1.952,8.380,5,5,29
2007,Utility Patent Granted,62,442,17970,1306155,1312204,1912,10.563,2173,12.005,94856,22919,71937,1.747,7.229,109424,42391,67033,3.231,8.339,-14568,-1.110,14.458,11,11,247
2007,Utility Patent Granted,71,141,1588,125159,127824,166,10.546,138,8.767,16563,5764,10799,4.509,12.958,21645,3170,18475,2.480,16.934,-5082,-3.976,25.915,8,9,38
2007,Utility Patent Granted,72,391,23514,842690,827697,3148,14.148,620,2.787,124074,65766,58308,7.946,14.990,94919,17265,77654,2.086,11.468,29155,3.522,22.936,24,24,182
2007,Utility Patent Granted,81,694,17333,262893,260540,2745,16.277,1807,10.715,55992,20420,35572,7.838,21.491,50653,20210,30443,7.757,19.442,5339,2.049,38.883,24,26,426
2008,No Utility Patent Granted,11,18186,18717,154126,155582,1972,10.341,2679,14.048,25838,7569,18269,4.865,16.607,28914,10363,18551,6.661,18.584,-3076,-1.977,33.215,1881,1884,7875
2008,No Utility Patent Granted,21,18308,22092,445840,470980,2390,10.911,2015,9.199,76745,21773,54972,4.623,16.295,126605,24884,101721,5.283,26.881,-49860,-10.586,32.590,1403,1410,13682
2008,No Utility Patent Granted,22,5330,12254,398128,396662,990,8.147,784,6.452,44490,18407,26083,4.640,11.216,42084,14039,28045,3.539,10.610,2406,0.607,21.219,221,224,1435
2008,No Utility Patent Granted,23,659806,668965,6741424,6893230,80821,11.851,106788,15.659,1224331,323922,900409,4.699,17.761,1528321,404611,1123710,5.870,22.171,-303990,-4.410,35.523,79757,79799,298829
2008,No Utility Patent Granted,31-33,252883,273921,7188150,7262202,18309,6.623,23329,8.439,754052,206766,547286,2.847,10.383,903648,285757,617891,3.935,12.443,-149596,-2.060,20.766,18319,18481,185631
2008,No Utility Patent Granted,42,294257,358840,4574807,4577439,29914,8.294,33545,9.301,591123,163482,427641,3.571,12.914,596088,210587,385501,4.601,13.022,-4965,-0.108,25.828,23627,24430,131043
2008,No Utility Patent Granted,44-45,628247,942030,13031623,13059159,83883,8.853,94807,10.006,1680804,612789,1068015,4.692,12.871,1747865,538905,1208960,4.127,13.384,-67061,-0.514,25.741,65139,68075,314546
2008,No Utility Patent Granted,48-49,147290,180734,3207288,3209785,23639,13.027,25084,13.824,458706,139945,318761,4.360,14.291,462598,157040,305558,4.893,14.412,-3892,-0.121,28.582,17967,18110,89122
2008,No Utility Patent Granted,51,61394,83012,1675257,1673188,10220,12.288,10534,12.666,252536,85876,166660,5.132,15.093,250103,92361,157742,5.520,14.948,2433,0.145,29.895,6152,6236,49466
2008,No Utility Patent Granted,52,226592,388483,4499869,4540845,37188,9.482,44615,11.376,666364,250025,416339,5.506,14.675,746475,292494,453981,6.441,16.439,-80111,-1.764,29.350,24410,25903,131452
2008,No Utility Patent Granted,53,239017,306442,1927734,1948629,36183,11.582,48131,15.406,339535,130039,209496,6.673,17.424,381441,165379,216062,8.487,19.575,-41906,-2.151,34.849,31855,32251,99702
2008,No Utility Patent Granted,54,653141,699884,6131561,6051516,85100,12.190,81542,11.680,1021236,321694,699542,5.316,16.876,861053,316365,544688,5.228,14.229,160183,2.647,28.457,58430,58842,220993
2008,No Utility Patent Granted,55,24178,38724,1524192,1532394,3546,9.168,3452,8.925,276781,91666,185115,5.982,18.062,294162,72242,221920,4.714,19.196,-17381,-1.134,36.124,1009,1044,14030
2008,No Utility Patent Granted,56,278892,322267,8366751,8350496,44014,13.705,41807,13.017,1678725,540589,1138136,6.474,20.103,1655317,507192,1148125,6.074,19.823,23408,0.280,39.646,28888,29278,304795
2008,No Utility Patent Granted,61,69279,77912,2509180,2475129,8470,10.965,7139,9.242,254318,54221,200097,2.191,10.275,185963,53961,132002,2.180,7.513,68355,2.762,15.027,5167,5255,37303
2008,No Utility Patent Granted,62,570148,719501,15679888,15482780,59850,8.371,50714,7.094,1815275,492047,1323228,3.178,11.724,1424165,476175,947990,3.076,9.198,391110,2.526,18.397,33451,34271,256902
2008,No Utility Patent Granted,71,91905,99670,1935189,1922257,12602,12.619,12993,13.010,283389,91299,192090,4.750,14.743,256354,91266,165088,4.748,13.336,27035,1.406,26.672,9401,9461,60302
2008,No Utility Patent Granted,72,417904,552071,10962464,10844385,70956,12.935,63950,11.658,1975570,942022,1033548,8.687,18.217,1746972,668202,1078770,6.162,16.109,228598,2.108,32.219,48260,49227,459879
2008,No Utility Patent Granted,81,613995,660595,5151296,5130059,55437,8.386,56393,8.531,734404,217527,516877,4.240,14.316,690976,214831,476145,4.188,13.469,43428,0.847,26.938,40357,41146,151643
2008,Utility Patent Granted,11,53,241,9136,9268,17,7.025,19,7.851,944,83,861,0.896,10.186,1262,355,907,3.830,13.617,-318,-3.431,20.371,D,D,D
2008,Utility Patent Granted,21,205,2357,175812,191649,351,15.435,185,8.135,27088,8225,18863,4.292,14.134,59293,6844,52449,3.571,30.938,-32205,-16.804,28.268,4,5,123
2008,Utility Patent Granted,22,86,4125,238108,241678,329,7.966,339,8.208,20981,5197,15784,2.150,8.681,27376,4846,22530,2.005,11.327,-6395,-2.646,17.363,0,0,0
2008,Utility Patent Granted,23,642,3596,263801,266866,229,6.357,242,6.718,50662,9263,41399,3.471,18.984,56822,13390,43432,5.018,21.292,-6160,-2.308,37.968,24,24,160
2008,Utility Patent Granted,31-33,7429,30089,5756763,5838296,962,3.158,1711,5.617,399714,61485,338229,1.053,6.846,560723,152480,408243,2.612,9.604,-161009,-2.758,13.693,199,213,11973
2008,Utility Patent Granted,42,4937,40706,1553619,1561604,4913,12.194,4082,10.131,254808,97360,157448,6.235,16.317,274328,86782,187546,5.557,17.567,-19520,-1.250,32.634,157,173,2853
2008,Utility Patent Granted,44-45,1055,89866,2529836,2522264,3932,4.393,3218,3.595,239881,64896,174985,2.573,9.511,220955,49666,171289,1.969,8.760,18926,0.750,17.520,39,39,608
2008,Utility Patent Granted,48-49,892,13199,1226011,1231346,1626,12.316,1633,12.369,119754,28969,90785,2.353,9.725,128399,44054,84345,3.578,10.428,-8645,-0.702,19.451,5,6,148
2008,Utility Patent Granted,51,1158,45718,1743776,1750106,5942,13.019,5785,12.675,277214,113465,163749,6.483,15.840,292740,89364,203376,5.106,16.727,-15526,-0.887,31.680,63,81,5339
2008,Utility Patent Granted,52,603,78960,1930823,1960227,11662,15.123,7971,10.337,297201,132598,164603,6.764,15.162,353569,133660,219909,6.819,18.037,-56368,-2.876,30.323,15,20,904
2008,Utility Patent Granted,53,540,13797,221374,216415,2796,21.403,1329,10.173,44407,23222,21185,10.730,20.519,34176,13427,20749,6.204,15.792,10231,4.727,31.584,18,18,168
2008,Utility Patent Granted,54,5643,34645,1748669,1766701,3595,10.116,5379,15.136,312221,126145,186076,7.140,17.673,342343,137629,204714,7.790,19.378,-30122,-1.705,35.345,351,398,7327
2008,Utility Patent Granted,55,2461,11574,1336210,1378767,966,8.185,1421,12.041,196690,49690,147000,3.604,14.266,281836,77438,204398,5.616,20.441,-85146,-6.176,28.531,16,25,2173
2008,Utility Patent Granted,56,932,16200,1315433,1333581,2472,15.298,2389,14.785,236781,91749,145032,6.880,17.755,277780,97799,179981,7.334,20.830,-40999,-3.074,35.511,22,22,80
2008,Utility Patent Granted,61,240,1426,610586,603898,177,13.000,48,3.526,30916,4107,26809,0.680,5.119,17892,1122,16770,0.186,2.963,13024,2.157,5.926,4,4,4
2008,Utility Patent Granted,62,458,20162,1476460,1476443,3082,15.419,2734,13.678,134579,49010,85569,3.319,9.115,137347,44207,93140,2.994,9.303,-2768,-0.187,18.230,12,13,392
2008,Utility Patent Granted,71,148,1217,128213,122978,96,7.846,109,8.909,16171,1910,14261,1.553,13.150,5741,1542,4199,1.254,4.668,10430,8.481,9.337,6,6,32
2008,Utility Patent Granted,72,394,23926,920387,912064,1071,4.486,968,4.055,96760,32080,64680,3.517,10.609,82300,21412,60888,2.348,9.023,14460,1.585,18.047,16,16,184
2008,Utility Patent Granted,81,731,17934,288057,279866,1667,9.350,1458,8.177,53152,15794,37358,5.643,18.992,35968,16659,19309,5.952,12.852,17184,6.140,25.704,17,34,391
2009,No Utility Patent Granted,11,17417,17945,139920,146956,1794,9.774,2615,14.246,18765,6404,12361,4.358,12.769,32552,10633,21919,7.235,22.151,-13787,-9.382,25.538,1794,1794,7666
2009,No Utility Patent Granted,21,18482,22229,410826,422865,2328,10.484,2279,10.264,66986,22731,44255,5.375,15.841,91532,25246,66286,5.970,21.646,-24546,-5.805,31.682,1439,1471,13827
2009,No Utility Patent Granted,22,5271,12101,363285,362037,717,5.956,593,4.926,30656,9922,20734,2.741,8.468,28191,8878,19313,2.452,7.787,2465,0.681,15.574,233,320,5234
2009,No Utility Patent Granted,23,597837,606635,5662474,6181520,63538,9.948,127650,19.986,818199,250819,567380,4.058,13.236,1856608,468211,1388397,7.574,30.035,-1038409,-16.799,26.472,88247,88309,336818
2009,No Utility Patent Granted,31-33,243244,263782,6301016,6712363,15748,5.851,26489,9.842,523560,186034,337526,2.772,7.800,1346761,302393,1044368,4.505,20.064,-823201,-12.264,15.600,19851,20031,187444
2009,No Utility Patent Granted,42,285849,351402,4287379,4440990,25941,7.281,35711,10.023,431814,139287,292527,3.136,9.723,739695,210550,529145,4.741,16.656,-307881,-6.933,19.447,25329,26025,137195
2009,No Utility Patent Granted,44-45,607970,917021,12582663,12986130,71973,7.739,97839,10.521,1207506,486116,721390,3.743,9.298,2019509,609506,1410003,4.694,15.551,-812003,-6.253,18.597,66865,70863,377520
2009,No Utility Patent Granted,48-49,142158,175403,3012904,3124043,21091,11.840,26559,14.909,356313,144312,212001,4.619,11.406,581269,177526,403743,5.683,18.606,-224956,-7.201,22.811,18410,18792,110830
2009,No Utility Patent Granted,51,60045,80369,1543551,1581531,8448,10.420,9858,12.159,190477,72480,117997,4.583,12.044,267285,82739,184546,5.232,16.900,-76808,-4.857,24.088,6556,6782,52173
2009,No Utility Patent Granted,52,216974,377270,4252400,4303387,34389,9.006,43522,11.398,547544,229904,317640,5.342,12.724,648726,236379,412347,5.493,15.075,-101182,-2.351,25.447,24105,25688,107145
2009,No Utility Patent Granted,53,226031,292345,1808491,1878134,30151,10.068,44414,14.831,273355,115499,157856,6.150,14.555,413295,159086,254209,8.470,22.006,-139940,-7.451,29.109,28990,29419,94220
2009,No Utility Patent Granted,54,642358,691434,5920247,6008960,77563,11.131,88353,12.679,882328,312555,569773,5.201,14.684,1058081,341899,716182,5.690,17.608,-175753,-2.925,29.367,62059,62558,248498
2009,No Utility Patent Granted,55,24234,38668,1504865,1533487,2777,7.111,3549,9.087,214976,77435,137541,5.050,14.019,273447,72053,201394,4.699,17.832,-58471,-3.813,28.038,983,1111,18278
2009,No Utility Patent Granted,56,273019,316806,7439101,7922610,38264,11.931,46058,14.362,1165181,405876,759305,5.123,14.707,2135681,563183,1572498,7.109,26.957,-970500,-12.250,29.414,29512,29884,320488
2009,No Utility Patent Granted,61,70109,78861,2554168,2527923,8085,10.303,7313,9.319,247173,53351,193822,2.110,9.778,194827,51106,143721,2.022,7.707,52346,2.071,15.414,5264,5324,37054
2009,No Utility Patent Granted,62,577586,735386,16007521,15885436,58239,7.971,48693,6.665,1657470,482613,1174857,3.038,10.434,1409531,454156,955375,2.859,8.873,247939,1.561,17.746,33315,34232,295346
2009,No Utility Patent Granted,71,90830,98777,1881001,1909142,11275,11.329,12763,12.824,235854,78791,157063,4.127,12.354,293128,81425,211703,4.265,15.354,-57274,-3.000,24.708,9346,9404,62405
2009,No Utility Patent Granted,72,418770,558475,10676305,10892937,64891,11.634,63519,11.388,1556991,825531,731460,7.579,14.294,1989128,660827,1328301,6.067,18.261,-432137,-3.967,28.587,48655,49880,463857
2009,No Utility Patent Granted,81,611048,657052,5011169,5085895,50617,7.669,56604,8.576,596220,185458,410762,3.647,11.723,744657,213280,531377,4.194,14.642,-148437,-2.919,23.446,40442,41386,152060
2009,Utility Patent Granted,11,52,224,9450,9134,D,D,13,5.652,1203,D,1202,D,13.171,585,96,489,1.051,6.405,618,6.766,12.809,0,0,0
2009,Utility Patent Granted,21,207,2511,190674,191021,271,11.005,174,7.066,21535,5554,15981,2.908,11.274,21975,4369,17606,2.287,11.504,-440,-0.230,22.547,3,3,48
2009,Utility Patent Granted,22,83,4738,281285,277514,573,12.508,259,5.654,35437,13130,22307,4.731,12.769,28350,6635,21715,2.391,10.216,7087,2.554,20.431,0,0,0
2009,Utility Patent Granted,23,620,4027,282309,299920,261,6.376,394,9.625,38368,11665,26703,3.889,12.793,73156,12277,60879,4.093,24.392,-34788,-11.599,25.585,35,44,332
2009,Utility Patent Granted,31-33,7180,29200,5285963,5552803,922,3.106,1883,6.344,289302,54788,234514,0.987,5.210,825740,157541,668199,2.837,14.871,-536438,-9.661,10.420,221,237,12085
2009,Utility Patent Granted,42,4755,40670,1534901,1552746,4071,10.058,3685,9.104,203405,61290,142115,3.947,13.100,237420,72275,165145,4.655,15.290,-34015,-2.191,26.199,171,190,4485
2009,Utility Patent Granted,44-45,1008,92714,2152807,2175322,5873,6.378,4595,4.990,225030,111500,113530,5.126,10.345,271789,63878,207911,2.936,12.494,-46759,-2.150,20.689,56,88,734
2009,Utility Patent Granted,48-49,902,13580,1147048,1180955,1093,7.981,1324,9.667,94142,34546,59596,2.925,7.972,163281,34992,128289,2.963,13.826,-69139,-5.855,15.943,7,7,19
2009,Utility Patent Granted,51,1192,44849,1745987,1781623,8174,17.688,10900,23.587,237109,115050,122059,6.458,13.309,307661,108715,198946,6.102,17.269,-70552,-3.960,26.617,66,83,5318
2009,Utility Patent Granted,52,606,77417,1906367,1978856,6847,8.590,11429,14.339,232157,88538,143619,4.474,11.732,376886,94562,282324,4.779,19.046,-144729,-7.314,23.464,19,19,336
2009,Utility Patent Granted,53,514,14633,208205,212506,2133,14.488,2312,15.704,23417,13981,9436,6.579,11.019,31702,14786,16916,6.958,14.918,-8285,-3.899,22.039,21,21,81
2009,Utility Patent Granted,54,5628,37658,1870944,1870416,6688,18.388,4116,11.316,323286,162500,160786,8.688,17.284,322590,119041,203549,6.364,17.247,696,0.037,34.494,361,372,6066
2009,Utility Patent Granted,55,2469,11683,1312921,1319687,1580,13.840,1047,9.171,193781,62669,131112,4.749,14.684,205987,51816,154171,3.926,15.609,-12206,-0.925,29.368,10,13,295
2009,Utility Patent Granted,56,909,15951,1163399,1225829,2650,16.826,2246,14.261,191894,69519,122375,5.671,15.654,320332,62565,257767,5.104,26.132,-128438,-10.478,31.308,23,33,1126
2009,Utility Patent Granted,61,257,1517,633769,622792,136,9.233,48,3.259,33281,2179,31102,0.350,5.344,12002,1726,10276,0.277,1.927,21279,3.417,3.854,D,D,D
2009,Utility Patent Granted,62,460,17007,1469845,1445164,2530,15.226,1748,10.520,133147,41250,91897,2.854,9.213,83095,28706,54389,1.986,5.750,50052,3.463,11.500,14,15,472
2009,Utility Patent Granted,71,135,1339,126629,129771,198,15.017,157,11.907,9983,3642,6341,2.806,7.693,16213,3479,12734,2.681,12.494,-6230,-4.801,15.386,7,7,31
2009,Utility Patent Granted,72,390,21315,765674,788443,1128,5.310,986,4.641,59386,28595,30791,3.627,7.532,106432,18614,87818,2.361,13.499,-47046,-5.967,15.064,12,12,146
2009,Utility Patent Granted,81,731,17564,244220,262608,606,3.413,992,5.587,20157,7069,13088,2.692,7.676,58153,9021,49132,3.435,22.144,-37996,-14.469,15.351,16,16,58
2010,No Utility Patent Granted,11,17190,17720,144385,142374,1960,11.006,2137,12.000,26439,7782,18657,5.466,18.570,22517,7598,14919,5.337,15.815,3922,2.755,31.631,1405,1409,5640
2010,No Utility Patent Granted,21,18190,22063,399667,401826,2100,9.456,2388,10.753,69220,27020,42200,6.724,17.226,73644,21027,52617,5.233,18.327,-4424,-1.101,34.453,1571,1583,11971
2010,No Utility Patent Granted,22,5340,11662,355749,354858,813,7.081,452,3.937,27442,11940,15502,3.365,7.733,25456,7827,17629,2.206,7.174,1986,0.560,14.347,177,179,1256
2010,No Utility Patent Granted,23,558776,567921,5098284,5383322,69611,11.863,107350,18.294,865200,276310,588890,5.133,16.072,1437731,377139,1060592,7.006,26.707,-572531,-10.635,32.144,69406,69523,256667
2010,No Utility Patent Granted,31-33,234289,254554,5942746,6123630,15723,6.066,25038,9.659,552955,155399,397556,2.538,9.030,915329,252452,662877,4.123,14.947,-362374,-5.918,18.060,18197,18302,145314
2010,No Utility Patent Granted,42,279186,345034,4134153,4201393,27550,7.921,33091,9.514,469235,161734,307501,3.850,11.169,601031,180926,420105,4.306,14.306,-131796,-3.137,22.337,23134,23868,118280
2010,No Utility Patent Granted,44-45,597520,894221,12193102,12301001,71778,7.975,83499,9.277,1253776,451539,802237,3.671,10.192,1463460,480657,982803,3.907,11.897,-209684,-1.705,20.385,56656,61427,314986
2010,No Utility Patent Granted,48-49,138663,171474,2886564,2927941,20156,11.636,23640,13.648,365049,128794,236255,4.399,12.468,447216,145084,302132,4.955,15.274,-82167,-2.806,24.936,15796,16077,77777
2010,No Utility Patent Granted,51,58843,77805,1417204,1447122,8080,10.314,9148,11.677,165581,70504,95077,4.872,11.442,225272,63727,161545,4.404,15.567,-59691,-4.125,22.884,5944,6056,36386
2010,No Utility Patent Granted,52,212858,360308,3908019,3971603,30901,8.517,35882,9.890,470128,190112,280016,4.787,11.837,598090,203846,394244,5.133,15.059,-127962,-3.222,23.674,18589,19715,80280
2010,No Utility Patent Granted,53,223251,286288,1723650,1752542,31946,11.078,36110,12.522,262402,122629,139773,6.997,14.973,321149,131948,189201,7.529,18.325,-58747,-3.352,29.945,21762,22201,67649
2010,No Utility Patent Granted,54,638246,688227,5793103,5842719,81110,11.766,83423,12.101,862187,338271,523916,5.790,14.757,965357,318018,647339,5.443,16.522,-103170,-1.766,29.513,56744,57207,207358
2010,No Utility Patent Granted,55,24263,38732,1511582,1526668,3102,7.971,3474,8.926,217721,79224,138497,5.189,14.261,246824,65040,181784,4.260,16.167,-29103,-1.906,28.522,893,959,15130
2010,No Utility Patent Granted,56,269806,313631,7498051,7505649,38130,12.072,42593,13.485,1441958,401531,1040427,5.350,19.212,1460522,474975,985547,6.328,19.459,-18564,-0.247,38.423,26881,27439,251879
2010,No Utility Patent Granted,61,70714,80104,2622497,2589788,8622,10.856,7263,9.145,265418,71456,193962,2.759,10.249,199626,48421,151205,1.870,7.708,65792,2.540,15.416,5159,5215,32628
2010,No Utility Patent Granted,62,583452,750650,16301577,16186687,61573,8.283,46966,6.318,1622969,568685,1054284,3.513,10.027,1391249,368631,1022618,2.277,8.595,231720,1.432,17.190,31713,32603,215932
2010,No Utility Patent Granted,71,89841,98032,1828375,1840486,11067,11.252,11709,11.905,225846,90084,135762,4.895,12.271,251258,71123,180135,3.864,13.652,-25412,-1.381,24.542,8357,8437,54584
2010,No Utility Patent Granted,72,424533,569445,10559012,10610997,63214,11.174,55734,9.852,1450118,751193,698925,7.079,13.666,1547920,524167,1023753,4.940,14.588,-97802,-0.922,27.332,42100,43094,364710
2010,No Utility Patent Granted,81,611568,656600,4921383,4949747,51288,7.813,51032,7.774,592038,198222,393816,4.005,11.961,647762,183057,464705,3.698,13.087,-55724,-1.126,23.922,35931,36338,122756
2010,Utility Patent Granted,11,55,219,7002,7213,5,2.232,15,6.696,408,33,375,0.458,5.657,827,278,549,3.854,11.466,-419,-5.809,11.314,D,D,D
2010,Utility Patent Granted,21,221,2568,186881,194234,234,9.209,180,7.084,18434,5356,13078,2.758,9.491,33158,4911,28247,2.528,17.071,-14724,-7.581,18.981,5,5,191
2010,Utility Patent Granted,22,80,5534,283902,285828,298,5.427,212,3.861,13917,2978,10939,1.042,4.869,17836,2849,14987,0.997,6.240,-3919,-1.371,9.738,D,D,D
2010,Utility Patent Granted,23,638,3979,252253,261615,287,7.060,459,11.292,37358,12652,24706,4.836,14.280,56442,9976,46466,3.813,21.574,-19084,-7.295,28.560,43,47,445
2010,Utility Patent Granted,31-33,7348,28387,4908108,5082279,802,2.783,1658,5.754,280783,48676,232107,0.958,5.525,627804,144631,483173,2.846,12.353,-347021,-6.828,11.049,195,228,11244
2010,Utility Patent Granted,42,4905,41436,1466549,1508650,3459,8.369,3251,7.866,153607,52832,100775,3.502,10.182,239334,65925,173409,4.370,15.864,-85727,-5.682,20.364,177,221,5015
2010,Utility Patent Granted,44-45,1077,102057,2259420,2288699,4035,3.925,5525,5.374,181036,50758,130278,2.218,7.910,238341,43174,195167,1.886,10.414,-57305,-2.504,15.820,53,55,551
2010,Utility Patent Granted,48-49,932,13819,1129158,1163310,868,6.169,1372,9.751,99545,25030,74515,2.152,8.557,166390,54872,111518,4.717,14.303,-66845,-5.746,17.114,9,9,95
2010,Utility Patent Granted,51,1287,45784,1716789,1759548,5121,11.115,5701,12.374,201809,81040,120769,4.606,11.469,284552,101146,183406,5.748,16.172,-82743,-4.703,22.939,67,85,2987
2010,Utility Patent Granted,52,671,83469,2009288,2069308,8255,9.560,14017,16.233,295516,98054,197462,4.738,14.281,411444,128316,283128,6.201,19.883,-115928,-5.602,28.562,18,99,1049
2010,Utility Patent Granted,53,553,16743,207868,216892,2405,14.490,2114,12.737,28296,13419,14877,6.187,13.046,45890,27827,18063,12.830,21.158,-17594,-8.112,26.092,22,23,712
2010,Utility Patent Granted,54,5944,40175,1930522,1922507,5829,14.673,4932,12.415,309459,110267,199192,5.736,16.097,292344,87973,204371,4.576,15.206,17115,0.890,30.413,382,509,6278
2010,Utility Patent Granted,55,2587,11336,1325487,1316322,1013,8.839,1262,11.012,177842,46649,131193,3.544,13.511,159630,50398,109232,3.829,12.127,18212,1.384,24.254,20,24,544
2010,Utility Patent Granted,56,970,15151,1129856,1122167,2173,14.372,2110,13.955,188060,57981,130079,5.167,16.759,171228,40023,131205,3.567,15.259,16832,1.500,30.517,26,26,176
2010,Utility Patent Granted,61,249,1523,642896,637210,195,12.737,211,13.782,28455,1821,26634,0.286,4.466,17431,1603,15828,0.252,2.736,11024,1.730,5.471,3,3,7
2010,Utility Patent Granted,62,482,16965,1430636,1422030,1489,8.879,1098,6.548,83605,18728,64877,1.317,5.879,66665,14491,52174,1.019,4.688,16940,1.191,9.376,10,10,86
2010,Utility Patent Granted,71,138,1428,166728,162436,148,10.663,68,4.899,17813,1842,15971,1.134,10.966,9120,1377,7743,0.848,5.615,8693,5.352,11.229,5,5,16
2010,Utility Patent Granted,72,411,18104,746117,767631,569,3.121,826,4.530,56860,23578,33282,3.072,7.407,97987,16305,81682,2.124,12.765,-41127,-5.358,14.814,23,90,1114
2010,Utility Patent Granted,81,727,18909,271392,271416,1010,5.306,1263,6.635,31963,7506,24457,2.765,11.776,32903,10089,22814,3.717,12.123,-940,-0.346,23.553,22,31,126
2011,No Utility Patent Granted,11,17076,17641,146455,145706,2021,11.413,2155,12.170,23801,7360,16441,5.051,16.335,22248,7352,14896,5.046,15.269,1553,1.066,30.538,1476,1476,5157
2011,No Utility Patent Granted,21,18582,22711,446792,420837,2637,11.772,2016,9.000,102001,28208,73793,6.703,24.238,48932,16592,32340,3.943,11.627,53069,12.610,23.255,1399,1422,10301
2011,No Utility Patent Granted,22,5353,12976,419759,421442,870,6.710,850,6.556,35711,16867,18844,4.002,8.474,39353,13730,25623,3.258,9.338,-3642,-0.864,16.947,198,206,1033
2011,No Utility Patent Granted,23,541269,550202,4894954,4993309,74083,13.250,91899,16.437,918254,246919,671335,4.945,18.390,1113496,322172,791324,6.452,22.300,-195242,-3.910,36.779,59072,59225,219368
2011,No Utility Patent Granted,31-33,231070,250688,6019261,5948323,17454,6.917,20734,8.217,705814,154743,551071,2.601,11.866,563720,182460,381260,3.067,9.477,142094,2.389,18.954,15475,15633,124499
2011,No Utility Patent Granted,42,276494,341724,4018905,3993002,28257,8.251,29705,8.674,488154,141618,346536,3.547,12.225,436012,153268,282744,3.838,10.919,52142,1.306,21.839,21286,21922,103425
2011,No Utility Patent Granted,44-45,590581,883836,11784844,11726704,76034,8.597,77232,8.732,1295810,449428,846382,3.833,11.050,1176594,373972,802622,3.189,10.033,119216,1.017,20.067,54307,56862,233260
2011,No Utility Patent Granted,48-49,141458,172830,2937542,2889561,24348,14.215,21254,12.409,419867,127056,292811,4.397,14.530,321615,112140,209475,3.881,11.130,98252,3.400,22.260,14600,14790,65328
2011,No Utility Patent Granted,51,58464,77207,1359139,1355434,9042,11.755,8470,11.011,175676,67353,108323,4.969,12.961,168098,57220,110878,4.222,12.402,7578,0.559,24.804,5565,5689,35646
2011,No Utility Patent Granted,52,209578,355286,3819797,3827625,28279,7.914,32339,9.051,457097,156488,300609,4.088,11.942,475904,171958,303946,4.493,12.433,-18807,-0.491,23.884,17387,18291,69431
2011,No Utility Patent Granted,53,220063,281847,1689829,1704011,32895,11.591,36790,12.964,262405,115809,146596,6.796,15.399,292515,135570,156945,7.956,17.166,-30110,-1.767,30.799,21053,24363,82205
2011,No Utility Patent Granted,54,639231,688945,5850163,5777211,83597,12.165,80047,11.649,948406,302732,645674,5.240,16.416,806688,288689,517999,4.997,13.963,141718,2.453,27.927,56023,56589,200948
2011,No Utility Patent Granted,55,23908,38633,1547455,1526299,2800,7.251,2761,7.150,237984,73453,164531,4.812,15.592,196753,43361,153392,2.841,12.891,41231,2.701,25.782,815,846,11976
2011,No Utility Patent Granted,56,269397,313796,7794616,7660088,38492,12.266,38538,12.280,1538509,356585,1181924,4.655,20.085,1262480,418870,843610,5.468,16.481,276029,3.603,32.963,25421,25910,222977
2011,No Utility Patent Granted,61,72115,81910,2701679,2656294,8648,10.672,6894,8.508,284498,74212,210286,2.794,10.710,192522,40370,152152,1.520,7.248,91976,3.463,14.496,5012,5069,28257
2011,No Utility Patent Granted,62,586717,756646,16422092,16297737,57617,7.659,48823,6.490,1581222,457605,1123617,2.808,9.702,1331877,389490,942387,2.390,8.172,249345,1.530,16.344,33627,34696,241871
2011,No Utility Patent Granted,71,89690,97853,1840199,1836197,11451,11.709,11337,11.592,235766,81035,154731,4.413,12.840,228217,69986,158231,3.811,12.429,7549,0.411,24.858,8091,8164,49889
2011,No Utility Patent Granted,72,429546,577191,10848758,10741875,62331,10.863,55502,9.673,1551527,748579,802948,6.969,14.444,1333970,495078,838892,4.609,12.418,217557,2.025,24.837,42836,43966,364321
2011,No Utility Patent Granted,81,611231,656578,4903760,4906568,51629,7.865,51434,7.835,601318,183374,417944,3.737,12.255,608151,171522,436629,3.496,12.395,-6833,-0.139,24.511,36987,37530,123893
2011,Utility Patent Granted,11,55,190,7124,7067,4,2.089,7,3.655,451,60,391,0.849,6.382,350,36,314,0.509,4.953,101,1.429,9.905,0,0,0
2011,Utility Patent Granted,21,230,2534,201949,197347,172,6.780,178,7.016,32010,5117,26893,2.593,16.220,23035,3886,19149,1.969,11.672,8975,4.548,23.345,4,4,7
2011,Utility Patent Granted,22,83,4168,222521,221024,120,2.844,223,5.285,12426,757,11669,0.342,5.622,9275,2541,6734,1.150,4.196,3151,1.426,8.393,0,0,0
2011,Utility Patent Granted,23,654,4313,274118,270384,446,10.440,364,8.521,51762,11756,40006,4.348,19.144,44031,9082,34949,3.359,16.285,7731,2.859,32.569,31,31,140
2011,Utility Patent Granted,31-33,7611,28764,4919567,4926250,722,2.485,1299,4.471,358302,40748,317554,0.827,7.273,372530,97016,275514,1.969,7.562,-14228,-0.289,14.547,162,172,4675
2011,Utility Patent Granted,42,5098,44946,1619752,1627234,4025,9.060,2990,6.730,201747,67518,134229,4.149,12.398,216978,71320,145658,4.383,13.334,-15231,-0.936,24.796,161,167,3542
2011,Utility Patent Granted,44-45,1121,112285,2862095,2821316,6585,5.910,4865,4.366,332895,84985,247910,3.012,11.799,252631,58621,194010,2.078,8.954,80264,2.845,17.909,44,73,333
2011,Utility Patent Granted,48-49,955,14964,1177608,1173565,1103,7.320,1312,8.707,110054,35833,74221,3.053,9.378,100278,31490,68788,2.683,8.545,9776,0.833,17.089,5,6,106
2011,Utility Patent Granted,51,1360,47924,1788272,1789426,7695,16.223,6715,14.157,290192,128850,161342,7.201,16.217,294589,109252,185337,6.105,16.463,-4397,-0.246,32.434,60,66,2557
2011,Utility Patent Granted,52,686,82705,2060529,2070096,9288,11.098,11263,13.458,284097,89069,195028,4.303,13.724,302191,93606,208585,4.522,14.598,-18094,-0.874,27.448,24,25,202
2011,Utility Patent Granted,53,566,17117,215389,214232,1832,10.826,1441,8.516,27746,10774,16972,5.029,12.951,25222,15707,9515,7.332,11.773,2524,1.178,23.546,14,73,94
2011,Utility Patent Granted,54,6410,43547,1994395,2014696,5981,13.831,5375,12.429,320237,104800,215437,5.202,15.895,361428,129723,231705,6.439,17.940,-41191,-2.045,31.790,358,368,5618
2011,Utility Patent Granted,55,2654,11935,1408514,1379134,1491,12.756,999,8.546,234865,72665,162200,5.269,17.030,173770,46143,127627,3.346,12.600,61095,4.430,25.200,16,18,922
2011,Utility Patent Granted,56,1004,15270,1270532,1187942,3365,22.366,2915,19.375,328058,48172,279886,4.055,27.616,159456,58373,101083,4.914,13.423,168602,14.193,26.846,24,26,414
2011,Utility Patent Granted,61,259,1534,685510,670458,404,26.157,425,27.517,57509,7309,50200,1.090,8.578,27759,6838,20921,1.020,4.140,29750,4.437,8.281,8,8,13
2011,Utility Patent Granted,62,504,19885,1582207,1561936,1967,10.035,1400,7.142,112534,33858,78676,2.168,7.205,71904,20696,51208,1.325,4.604,40630,2.601,9.207,18,20,176
2011,Utility Patent Granted,71,139,1624,156160,159876,138,8.593,102,6.351,15419,2022,13397,1.265,9.644,22923,1836,21087,1.148,14.338,-7504,-4.694,19.289,8,8,219
2011,Utility Patent Granted,72,438,17553,709643,701367,588,3.369,393,2.251,63387,15912,47475,2.269,9.038,47455,8936,38519,1.274,6.766,15932,2.272,13.532,22,22,185
2011,Utility Patent Granted,81,759,18751,277482,282244,1514,7.993,1894,9.999,35293,12474,22819,4.420,12.504,45264,13154,32110,4.661,16.037,-9971,-3.533,25.009,19,19,194
2012,No Utility Patent Granted,11,17324,17847,149000,148285,2022,11.394,1819,10.250,24529,7293,17236,4.918,16.542,23181,7034,16147,4.744,15.633,1348,0.909,31.266,1248,1251,4681
2012,No Utility Patent Granted,21,19358,23549,508129,478569,2830,12.231,2007,8.674,121496,36761,84735,7.681,25.387,62565,25152,37413,5.256,13.073,58931,12.314,26.147,1305,1333,11892
2012,No Utility Patent Granted,22,5398,12943,435700,433215,752,5.854,557,4.336,33568,11314,22254,2.612,7.749,28536,5942,22594,1.372,6.587,5032,1.162,13.174,195,202,1726
2012,No Utility Patent Granted,23,545093,553862,5058933,4987826,76706,13.893,73182,13.255,1021532,255597,765935,5.124,20.481,878448,276973,601475,5.553,17.612,143084,2.869,35.224,47103,47280,191472
2012,No Utility Patent Granted,31-33,231639,250708,6059109,5972601,17653,7.032,18320,7.298,715755,160872,554883,2.693,11.984,542871,185836,357035,3.111,9.089,172884,2.895,18.179,13602,13733,124847
2012,No Utility Patent Granted,42,278269,342633,4107445,4060174,28424,8.288,29100,8.485,549489,146450,403039,3.607,13.534,454139,158352,295787,3.900,11.185,95350,2.348,22.370,19173,19830,99406
2012,No Utility Patent Granted,44-45,588568,873589,11635873,11581114,77024,8.820,76436,8.753,1359241,461766,897475,3.987,11.737,1247646,416209,831437,3.594,10.773,111595,0.964,21.546,49619,52513,234046
2012,No Utility Patent Granted,48-49,144726,176585,3078540,3037261,23748,13.576,20430,11.679,438803,136793,302010,4.504,14.447,356141,125183,230958,4.122,11.726,82662,2.722,23.451,13835,14039,69010
2012,No Utility Patent Granted,51,59581,77310,1394628,1377830,8907,11.577,8156,10.601,214507,69555,144952,5.048,15.568,182974,69110,113864,5.016,13.280,31533,2.289,26.560,5221,5372,34040
2012,No Utility Patent Granted,52,209241,349507,3777128,3735047,32626,9.391,28456,8.191,518036,186426,331610,4.991,13.870,435147,153016,282131,4.097,11.650,82889,2.219,23.301,14796,15513,57897
2012,No Utility Patent Granted,53,223265,276127,1671061,1654347,31123,11.288,30293,10.987,283522,111853,171669,6.761,17.138,249731,105069,144662,6.351,15.095,33791,2.043,30.191,18148,18940,59634
2012,No Utility Patent Granted,54,646074,694323,5938493,5861713,84809,12.294,75807,10.989,971011,331871,639140,5.662,16.565,815541,312356,503185,5.329,13.913,155470,2.652,27.826,51931,52513,206115
2012,No Utility Patent Granted,55,23310,38142,1540165,1515976,3518,9.245,3340,8.777,248310,62871,185439,4.147,16.380,200098,62767,137331,4.140,13.199,48212,3.180,26.399,812,852,10464
2012,No Utility Patent Granted,56,274897,320504,8299358,8082254,40756,12.827,35206,11.081,1637573,374955,1262618,4.639,20.261,1201296,395187,806109,4.890,14.863,436277,5.398,29.727,22912,23240,237575
2012,No Utility Patent Granted,61,74403,83946,2748876,2712200,9094,10.973,6951,8.387,276696,63551,213145,2.343,10.202,202305,49132,153173,1.812,7.459,74391,2.743,14.918,4688,4739,28183
2012,No Utility Patent Granted,62,590261,756873,16265834,16120519,57209,7.585,51858,6.876,1781388,513626,1267762,3.186,11.050,1491789,437541,1054248,2.714,9.254,289599,1.796,18.508,33797,34899,265253
2012,No Utility Patent Granted,71,90863,98653,1882031,1843831,12164,12.433,10529,10.762,275564,92664,182900,5.026,14.945,200035,64459,135576,3.496,10.849,75529,4.096,21.698,7290,7360,45392
2012,No Utility Patent Granted,72,437914,580714,11006604,10827344,65149,11.283,58547,10.140,1771480,792239,979241,7.317,16.361,1409412,564836,844576,5.217,13.017,362068,3.344,26.034,41275,42497,373244
2012,No Utility Patent Granted,81,616583,659348,4960703,4919710,53333,8.126,47213,7.194,643316,195147,448169,3.967,13.076,561207,167940,393267,3.414,11.407,82109,1.669,22.815,33057,33713,117261
2012,Utility Patent Granted,11,56,219,7531,7375,3,1.357,7,3.167,577,86,491,1.166,7.824,255,43,212,0.583,3.458,322,4.366,6.915,0,0,0
2012,Utility Patent Granted,21,238,2726,217929,209835,189,6.946,179,6.578,34722,4217,30505,2.010,16.547,19047,3865,15182,1.842,9.077,15675,7.470,18.154,D,D,D
2012,Utility Patent Granted,22,91,4381,206877,209591,194,4.412,227,5.162,12296,3768,8528,1.798,5.867,18238,3726,14512,1.778,8.702,-5942,-2.835,11.733,D,D,D
2012,Utility Patent Granted,23,700,3914,241421,242811,151,3.686,517,12.619,39422,5479,33943,2.256,16.236,42441,17223,25218,7.093,17.479,-3019,-1.243,32.471,25,25,303
2012,Utility Patent Granted,31-33,8003,29561,5118433,5106655,690,2.306,1402,4.686,381973,38710,343263,0.758,7.480,357515,80173,277342,1.570,7.001,24458,0.479,14.002,191,199,7886
2012,Utility Patent Granted,42,5324,45141,1658424,1655411,2792,6.088,4225,9.213,242229,55171,187058,3.333,14.633,234569,62323,172246,3.765,14.170,7660,0.463,28.340,152,158,3479
2012,Utility Patent Granted,44-45,1179,116653,3124835,3074656,4894,4.194,4973,4.262,363988,77466,286522,2.520,11.838,264701,57222,207479,1.861,8.609,99287,3.229,17.218,56,66,633
2012,Utility Patent Granted,48-49,961,14567,1147958,1140624,849,5.856,712,4.911,90225,21032,69193,1.844,7.910,74494,14611,59883,1.281,6.531,15731,1.379,13.062,3,3,46
2012,Utility Patent Granted,51,1594,48603,1852008,1850724,5791,11.704,7543,15.245,289732,96344,193388,5.206,15.655,289922,110458,179464,5.968,15.665,-190,-0.010,31.310,52,133,2045
2012,Utility Patent Granted,52,738,93865,2217923,2215329,10014,10.744,8697,9.331,325389,95855,229534,4.327,14.688,319984,117231,202753,5.292,14.444,5405,0.244,28.888,18,22,194
2012,Utility Patent Granted,53,624,26221,229770,242613,5220,20.481,3752,14.721,63814,42358,21456,17.459,26.303,87597,25076,62521,10.336,36.106,-23783,-9.803,52.606,20,29,199
2012,Utility Patent Granted,54,6798,43180,1980829,2014476,3846,8.686,6042,13.646,325813,87220,238593,4.330,16.174,390720,143846,246874,7.141,19.396,-64907,-3.222,32.347,389,408,6956
2012,Utility Patent Granted,55,2701,13232,1513974,1516989,1248,9.465,1154,8.752,232175,52906,179269,3.488,15.305,235688,67124,168564,4.425,15.537,-3513,-0.232,30.610,11,16,899
2012,Utility Patent Granted,56,1033,13292,1159449,1158035,832,6.128,1401,10.319,129125,31981,97144,2.762,11.150,126341,44235,82106,3.820,10.910,2784,0.240,21.820,41,77,1603
2012,Utility Patent Granted,61,293,1921,711220,707583,195,10.425,94,5.025,37455,1970,35485,0.278,5.293,30077,5103,24974,0.721,4.251,7378,1.043,8.501,5,5,37
2012,Utility Patent Granted,62,563,25005,2021968,1999835,3200,12.876,2894,11.645,153814,45439,108375,2.272,7.691,111042,26276,84766,1.314,5.553,42772,2.139,11.105,13,1449,8821
2012,Utility Patent Granted,71,152,2163,183287,179819,110,5.033,155,7.092,22529,1738,20791,0.967,12.529,14664,3502,11162,1.948,8.155,7865,4.374,16.310,7,7,25
2012,Utility Patent Granted,72,460,21368,978376,971893,597,2.806,410,1.927,76257,19204,57053,1.976,7.846,64086,11755,52331,1.209,6.594,12171,1.252,13.188,20,20,189
2012,Utility Patent Granted,81,811,20392,263671,269839,1691,8.263,1838,8.981,38893,13420,25473,4.973,14.413,50296,17911,32385,6.638,18.639,-11403,-4.226,28.827,11,15,126
2013,No Utility Patent Granted,11,17310,17735,144411,145209,1935,10.896,1984,11.171,21590,6567,15023,4.522,14.868,23226,9798,13428,6.748,15.995,-1636,-1.127,29.736,1378,1378,7513
2013,No Utility Patent Granted,21,19376,23499,500095,497723,2442,10.418,2326,9.923,84075,26226,57849,5.269,16.892,79509,23363,56146,4.694,15.975,4566,0.917,31.949,1546,1578,12734
2013,No Utility Patent Granted,22,5411,11922,355443,356750,590,4.956,555,4.662,25538,9282,16256,2.602,7.159,28148,6497,21651,1.821,7.890,-2610,-0.732,14.317,201,210,1846
2013,No Utility Patent Granted,23,544860,553566,5195439,5120567,70931,12.813,70999,12.825,997003,240556,756447,4.698,19.471,846603,259538,587065,5.069,16.533,150400,2.937,33.067,45080,45172,177724
2013,No Utility Patent Granted,31-33,228631,247506,6079567,6034495,16311,6.564,18280,7.356,642156,146536,495620,2.428,10.641,550992,191768,359224,3.178,9.131,91164,1.511,18.261,13684,13803,121075
2013,No Utility Patent Granted,42,276602,339911,4137267,4103480,27335,8.035,27882,8.196,503328,139599,363729,3.402,12.266,434759,154751,280008,3.771,10.595,68569,1.671,21.190,19883,20378,104059
2013,No Utility Patent Granted,44-45,587230,873080,11885655,11772780,73941,8.477,72331,8.292,1392875,449136,943739,3.815,11.831,1159610,366311,793299,3.112,9.850,233265,1.981,19.700,49824,51909,219897
2013,No Utility Patent Granted,48-49,146271,177985,3159471,3139714,21907,12.340,21004,11.831,409785,122281,287504,3.895,13.052,371202,137309,233893,4.373,11.823,38583,1.229,23.646,14013,14183,70477
2013,No Utility Patent Granted,51,59628,76462,1354413,1345350,9235,12.154,8276,10.892,187147,61665,125482,4.584,13.911,168491,64252,104239,4.776,12.524,18656,1.387,25.048,5652,5839,38857
2013,No Utility Patent Granted,52,209463,356262,3679340,3661065,28220,7.897,30434,8.516,454505,132172,322333,3.610,12.415,417520,155245,262275,4.240,11.404,36985,1.010,22.809,14325,14817,70559
2013,No Utility Patent Granted,53,228397,280548,1698169,1674898,34040,12.280,27323,9.857,285135,124348,160787,7.424,17.024,238533,98696,139837,5.893,14.242,46602,2.782,28.483,17491,17881,58913
2013,No Utility Patent Granted,54,653081,702642,6093943,5991640,84884,12.155,76269,10.922,1003225,336990,666235,5.624,16.744,797442,308284,489158,5.145,13.309,205783,3.435,26.618,52511,52817,207894
2013,No Utility Patent Granted,55,23283,38277,1589715,1557019,2880,7.565,2469,6.485,279149,98417,180732,6.321,17.928,216541,59089,157452,3.795,13.907,62608,4.021,27.815,625,644,7287
2013,No Utility Patent Granted,56,273768,318307,8557144,8425717,36885,11.593,36576,11.496,1553002,370534,1182468,4.398,18.432,1287909,401655,886254,4.767,15.285,265093,3.146,30.571,23673,23904,221908
2013,No Utility Patent Granted,61,76450,85852,2746594,2729071,9068,10.683,7122,8.391,248723,59811,188912,2.192,9.114,213370,51743,161627,1.896,7.818,35353,1.295,15.637,4976,5104,36604
2013,No Utility Patent Granted,62,593445,760875,16218108,16125178,59449,7.849,52607,6.945,1669737,471066,1198671,2.921,10.355,1483361,449203,1034158,2.786,9.199,186376,1.156,18.398,35712,36503,283498
2013,No Utility Patent Granted,71,92145,100151,1910153,1895238,11932,11.990,10658,10.710,249109,87161,161948,4.599,13.144,218955,65510,153445,3.457,11.553,30154,1.591,23.106,7395,7421,46331
2013,No Utility Patent Granted,72,444731,592466,11472766,11277900,67082,11.421,56848,9.679,1842344,838230,1004114,7.433,16.336,1448928,588034,860894,5.214,12.847,393416,3.488,25.695,42110,43147,375884
2013,No Utility Patent Granted,81,620236,662925,4976773,4961568,51865,7.843,48513,7.337,604480,187195,417285,3.773,12.183,573568,180820,392748,3.644,11.560,30912,0.623,23.120,34351,34741,119589
2013,Utility Patent Granted,11,56,328,9464,9180,D,D,13,4.107,1335,D,643,D,14.542,781,113,668,1.231,8.508,554,6.035,17.015,0,0,0
2013,Utility Patent Granted,21,249,2833,230667,228444,246,8.680,248,8.751,32181,7777,24404,3.404,14.087,27903,12785,15118,5.597,12.214,4278,1.873,24.429,8,10,265
2013,Utility Patent Granted,22,104,5531,280463,281772,414,7.546,325,5.924,20447,7778,12669,2.760,7.257,23027,5505,17522,1.954,8.172,-2580,-0.916,14.513,5,5,216
2013,Utility Patent Granted,23,736,4072,262273,257893,350,8.649,299,7.389,57190,16726,40464,6.486,22.176,49260,13996,35264,5.427,19.101,7930,3.075,38.202,33,58,7596
2013,Utility Patent Granted,31-33,8099,29605,5178045,5177376,680,2.277,1194,3.998,354239,42583,311656,0.822,6.842,355885,78537,277348,1.517,6.874,-1646,-0.032,13.684,192,195,6461
2013,Utility Patent Granted,42,5435,47285,1734973,1714188,3810,8.044,3964,8.370,289204,101598,187606,5.927,16.871,246668,79575,167093,4.642,14.390,42536,2.481,28.780,172,177,3130
2013,Utility Patent Granted,44-45,1206,119757,3114480,3111242,5142,4.312,4119,3.454,253037,75089,177948,2.413,8.133,248169,66271,181898,2.130,7.977,4868,0.156,15.953,60,73,423
2013,Utility Patent Granted,48-49,994,14723,1121916,1112753,1728,11.904,1315,9.059,153119,35808,117311,3.218,13.760,135868,67922,67946,6.104,12.210,17251,1.550,24.420,8,9,71
2013,Utility Patent Granted,51,1698,47805,1919179,1900146,5448,11.223,6927,14.269,331746,134545,197201,7.081,17.459,296497,128824,167673,6.780,15.604,35249,1.855,31.208,76,92,5251
2013,Utility Patent Granted,52,749,81836,2373758,2358442,7128,8.572,9757,11.734,310226,83874,226352,3.556,13.154,279659,82475,197184,3.497,11.858,30567,1.296,23.716,17,37,859
2013,Utility Patent Granted,53,656,27929,252479,252217,3674,13.219,3401,12.237,52456,19013,33443,7.538,20.798,51649,20786,30863,8.241,20.478,807,0.320,40.956,17,17,216
2013,Utility Patent Granted,54,7273,45453,2116594,2063248,7152,15.865,6406,14.210,435981,223425,212556,10.829,21.131,332269,117671,214598,5.703,16.104,103712,5.027,32.208,412,441,7454
2013,Utility Patent Granted,55,2707,13506,1574495,1572657,1144,8.426,1287,9.479,213209,56103,157106,3.567,13.557,213251,64076,149175,4.074,13.560,-42,-0.003,27.114,19,20,1160
2013,Utility Patent Granted,56,1121,19238,1307870,1286133,6995,40.911,2715,15.879,203974,65204,138770,5.070,15.859,161797,67533,94264,5.251,12.580,42177,3.279,25.160,30,47,757
2013,Utility Patent Granted,61,319,2362,761213,758033,150,6.414,103,4.405,38856,4587,34269,0.605,5.126,31729,1544,30185,0.204,4.186,7127,0.940,8.371,5,5,21
2013,Utility Patent Granted,62,642,28703,2212734,2212342,3036,10.725,2245,7.931,173808,52774,121034,2.385,7.856,174788,44146,130642,1.995,7.901,-980,-0.044,15.713,20,21,487
2013,Utility Patent Granted,71,167,2089,203972,196748,158,7.642,115,5.562,29393,10780,18613,5.479,14.939,14596,4096,10500,2.082,7.419,14797,7.521,14.837,4,4,45
2013,Utility Patent Granted,72,467,20365,907882,906820,1067,5.281,743,3.678,87930,37076,50854,4.089,9.697,84782,23670,61112,2.610,9.349,3148,0.347,18.699,31,31,231
2013,Utility Patent Granted,81,857,20070,285356,286564,1838,9.077,2197,10.850,46973,18327,28646,6.395,16.392,47826,17414,30412,6.077,16.689,-853,-0.298,32.784,24,24,144
2014,No Utility Patent Granted,11,17411,17835,144556,143520,1987,11.179,1865,10.493,21899,6884,15015,4.797,15.259,19721,7373,12348,5.137,13.741,2178,1.518,27.482,1306,1307,5809
2014,No Utility Patent Granted,21,19661,23794,500522,493088,2564,10.878,2115,8.973,91854,31269,60585,6.341,18.628,76815,28372,48443,5.754,15.578,15039,3.050,31.157,1478,1509,14966
2014,No Utility Patent Granted,22,5452,11910,364713,362971,554,4.652,552,4.635,27142,6064,21078,1.671,7.478,23646,6345,17301,1.748,6.515,3496,0.963,13.029,187,198,1236
2014,No Utility Patent Granted,23,552840,562116,5413970,5289357,73170,13.118,64502,11.564,1042908,271292,771616,5.129,19.717,792829,231000,561829,4.367,14.989,250079,4.728,29.978,41556,41597,156245
2014,No Utility Patent Granted,31-33,226885,245855,6103764,6047714,16686,6.780,17203,6.990,650700,160054,490646,2.647,10.759,538083,171149,366934,2.830,8.897,112617,1.862,17.795,13104,13187,110810
2014,No Utility Patent Granted,42,275179,341612,4259342,4216239,26082,7.628,26684,7.804,486946,128735,358211,3.053,11.549,401632,144596,257036,3.430,9.526,85314,2.023,19.052,19131,19630,96381
2014,No Utility Patent Granted,44-45,586594,875893,12313027,12142379,74059,8.475,70023,8.013,1404000,493983,910017,4.068,11.563,1065228,339192,726036,2.793,8.773,338772,2.790,17.546,49436,51524,210317
2014,No Utility Patent Granted,48-49,148335,181122,3183161,3137223,22518,12.520,19984,11.111,428877,131643,297234,4.196,13.671,336164,117350,218814,3.741,10.715,92713,2.955,21.431,14011,14192,66291
2014,No Utility Patent Granted,51,60627,78007,1410415,1393089,9600,12.433,8008,10.372,201334,72152,129182,5.179,14.452,165841,58196,107645,4.177,11.905,35493,2.548,23.809,5270,5389,31602
2014,No Utility Patent Granted,52,210284,344805,3705389,3672963,28350,8.249,26072,7.586,475776,165142,310634,4.496,12.953,409023,154099,254924,4.195,11.136,66753,1.817,22.272,14069,14535,54074
2014,No Utility Patent Granted,53,233175,289955,1752684,1727301,34769,12.150,27192,9.502,278655,116634,162021,6.752,16.132,228003,94564,133439,5.475,13.200,50652,2.932,26.400,17618,18021,58907
2014,No Utility Patent Granted,54,659480,708798,6162211,6051106,84092,11.915,77986,11.050,999857,340891,658966,5.634,16.524,778342,298980,479362,4.941,12.863,221515,3.661,25.726,53074,53674,193433
2014,No Utility Patent Granted,55,23433,38186,1599917,1615618,2550,6.639,2995,7.798,227549,63705,163844,3.943,14.084,254606,92377,162229,5.718,15.759,-27057,-1.675,28.169,674,700,10248
2014,No Utility Patent Granted,56,275515,320456,8949465,8737295,37442,11.726,35164,11.012,1741854,432546,1309308,4.951,19.936,1319254,447119,872135,5.117,15.099,422600,4.837,30.198,22770,23071,213363
2014,No Utility Patent Granted,61,77762,87225,2749261,2718503,8813,10.194,7267,8.406,257707,60841,196866,2.238,9.480,195508,50908,144600,1.873,7.192,62199,2.288,14.384,5137,5209,35272
2014,No Utility Patent Granted,62,596845,764527,16332250,16208940,61119,8.040,52372,6.890,1591266,502551,1088715,3.100,9.817,1341977,420632,921345,2.595,8.279,249289,1.538,16.558,36887,38104,268093
2014,No Utility Patent Granted,71,93503,101822,1933052,1906311,12416,12.305,10584,10.489,261061,94588,166473,4.962,13.695,206226,69867,136359,3.665,10.818,54835,2.876,21.636,7534,7618,52586
2014,No Utility Patent Granted,72,449749,597562,11832260,11662990,63985,10.765,57655,9.700,1795141,829724,965417,7.114,15.392,1453903,564750,889153,4.842,12.466,341238,2.926,24.932,43758,44882,398277
2014,No Utility Patent Granted,81,623352,677272,5111646,5083662,53104,7.871,47845,7.092,616878,208467,408411,4.101,12.135,559902,169917,389985,3.342,11.014,56976,1.121,22.028,34833,35214,121555
2014,Utility Patent Granted,11,59,314,10644,10081,6,1.860,23,7.132,2075,571,1504,5.664,20.584,965,160,805,1.587,9.573,1110,11.011,19.146,D,D,D
2014,Utility Patent Granted,21,275,3023,252871,249317,285,9.491,245,8.159,35924,9036,26888,3.624,14.409,28431,9061,19370,3.634,11.404,7493,3.005,22.807,D,D,D
2014,Utility Patent Granted,22,101,5572,269893,272277,313,5.643,262,4.724,17623,4273,13350,1.569,6.472,22059,4614,17445,1.695,8.102,-4436,-1.629,12.945,3,3,5
2014,Utility Patent Granted,23,801,4110,283389,284170,422,10.250,436,10.590,59185,19904,39281,7.004,20.827,60556,19564,40992,6.885,21.310,-1371,-0.482,41.655,32,62,1184
2014,Utility Patent Granted,31-33,8364,30067,5263230,5257696,918,3.039,1195,3.956,388665,60328,328337,1.147,7.392,376097,84603,291494,1.609,7.153,12568,0.239,14.307,204,210,7612
2014,Utility Patent Granted,42,5553,45048,1684925,1687898,3594,7.952,3889,8.605,222881,53018,169863,3.141,13.205,226582,86601,139981,5.131,13.424,-3701,-0.219,26.409,161,182,4341
2014,Utility Patent Granted,44-45,1273,119412,3081232,3054640,4267,3.551,5757,4.791,230940,65904,165036,2.158,7.560,182591,48637,133954,1.592,5.977,48349,1.583,11.955,66,68,622
2014,Utility Patent Granted,48-49,1012,15070,1222615,1207540,1726,11.742,984,6.694,125116,36320,88796,3.008,10.361,95503,27776,67727,2.300,7.909,29613,2.452,15.818,9,21,1339
2014,Utility Patent Granted,51,1794,50256,1931668,1917186,8483,17.271,6204,12.631,329921,116063,213858,6.054,17.209,300278,93660,206618,4.885,15.662,29643,1.546,31.325,79,83,3190
2014,Utility Patent Granted,52,783,96198,2356153,2401688,9764,10.179,9218,9.610,274115,107664,166451,4.483,11.413,368082,87117,280965,3.627,15.326,-93967,-3.913,22.827,23,27,346
2014,Utility Patent Granted,53,697,26608,254527,250248,3210,12.142,2869,10.852,63368,24769,38599,9.898,25.322,53137,28638,24499,11.444,21.234,10231,4.088,42.467,19,20,111
2014,Utility Patent Granted,54,7738,50387,2274997,2266932,9622,20.032,4913,10.228,361629,129872,231757,5.729,15.952,344293,79694,264599,3.516,15.188,17336,0.765,30.375,472,482,5294
2014,Utility Patent Granted,55,2780,14106,1640149,1619825,1676,12.140,1076,7.794,216710,70344,146366,4.343,13.379,175225,48340,126885,2.984,10.818,41485,2.561,21.635,15,17,323
2014,Utility Patent Granted,56,1197,21676,1221015,1243934,5264,25.772,2763,13.527,222154,77833,144321,6.257,17.859,276495,130093,146402,10.458,22.227,-54341,-4.368,35.718,29,29,563
2014,Utility Patent Granted,61,345,2451,811008,813946,230,9.162,349,13.902,58174,25624,32550,3.148,7.147,62980,9836,53144,1.208,7.738,-4806,-0.590,14.294,6,6,1736
2014,Utility Patent Granted,62,682,37657,2351844,2329871,6401,17.869,2730,7.621,234594,96091,138503,4.124,10.069,189596,42623,146973,1.829,8.138,44998,1.931,16.275,24,25,348
2014,Utility Patent Granted,71,188,2373,234548,227195,206,8.904,87,3.761,30486,8243,22243,3.628,13.418,15606,3611,11995,1.589,6.869,14880,6.549,13.738,6,6,13
2014,Utility Patent Granted,72,492,22409,945505,927244,1135,5.138,497,2.250,94487,36934,57553,3.983,10.190,58380,13279,45101,1.432,6.296,36107,3.894,12.592,26,31,381
2014,Utility Patent Granted,81,895,10733,212965,212451,1295,11.886,1619,14.860,31652,15089,16563,7.102,14.898,30509,11662,18847,5.489,14.360,1143,0.538,28.721,24,25,356
2015,No Utility Patent Granted,11,17703,18120,148885,146932,2183,12.207,1709,9.557,24349,8224,16125,5.597,16.572,20448,6817,13631,4.640,13.917,3901,2.655,27.833,1165,1167,5424
2015,No Utility Patent Granted,21,19504,23768,494754,501921,2559,10.766,2562,10.779,81779,32385,49394,6.452,16.293,96963,29043,67920,5.786,19.318,-15184,-3.025,32.586,1793,1811,14962
2015,No Utility Patent Granted,22,5441,12210,383634,382293,575,4.708,581,4.757,29111,8019,21092,2.098,7.615,26281,6263,20018,1.638,6.875,2830,0.740,13.749,223,225,973
2015,No Utility Patent Granted,23,566556,576512,5726270,5570068,75423,13.246,61176,10.744,1098083,285055,813028,5.118,19.714,786086,229294,556792,4.117,14.113,311997,5.601,28.225,40095,40153,155161
2015,No Utility Patent Granted,31-33,226311,246044,6208978,6133739,17446,7.096,17079,6.947,670473,165173,505300,2.693,10.931,518895,166365,352530,2.712,8.460,151578,2.471,16.919,13173,13257,112945
2015,No Utility Patent Granted,42,272771,339540,4253712,4219909,26043,7.646,28173,8.271,488397,136027,352370,3.223,11.574,419602,152343,267259,3.610,9.943,68795,1.630,19.887,19546,20002,97992
2015,No Utility Patent Granted,44-45,585664,873058,12715873,12550240,74765,8.582,71027,8.153,1501920,574234,927686,4.575,11.967,1175083,400053,775030,3.188,9.363,326837,2.604,18.726,49533,52397,230786
2015,No Utility Patent Granted,48-49,152847,186492,3304686,3244034,25305,13.764,20026,10.892,477661,148756,328905,4.586,14.724,355574,121372,234202,3.741,10.961,122087,3.763,21.922,13797,13981,66123
2015,No Utility Patent Granted,51,61405,79101,1389697,1366959,10458,13.405,8293,10.630,211662,76595,135067,5.603,15.484,166275,61380,104895,4.490,12.164,45387,3.320,24.328,5565,5827,42679
2015,No Utility Patent Granted,52,211578,355707,3828424,3816342,29660,8.379,26246,7.414,487295,161759,325536,4.239,12.769,458967,131539,327428,3.447,12.026,28328,0.742,24.053,14058,14695,58432
2015,No Utility Patent Granted,53,238799,296946,1787849,1768718,35765,12.197,28306,9.654,283124,116112,167012,6.565,16.007,244930,107554,137376,6.081,13.848,38194,2.159,27.696,18195,18678,63564
2015,No Utility Patent Granted,54,665572,716973,6349965,6232802,85634,12.018,76819,10.781,1010823,318357,692466,5.108,16.218,775937,296926,479011,4.764,12.449,234886,3.769,24.898,54250,54735,204039
2015,No Utility Patent Granted,55,23795,37711,1707785,1668720,2973,7.921,2617,6.973,286387,96197,190190,5.765,17.162,206780,43760,163020,2.622,12.392,79607,4.771,24.783,671,705,10252
2015,No Utility Patent Granted,56,278346,327032,9421579,9210351,41590,12.859,34367,10.626,1649468,414895,1234573,4.505,17.909,1222340,367842,854498,3.994,13.271,427128,4.637,26.543,22581,22831,226719
2015,No Utility Patent Granted,61,79677,89519,2818194,2783051,9563,10.810,7448,8.419,253769,59684,194085,2.145,9.118,184629,46655,137974,1.676,6.634,69140,2.484,13.268,5210,5422,32815
2015,No Utility Patent Granted,62,598533,773949,16627297,16460401,64193,8.348,54299,7.061,1803680,595001,1208679,3.615,10.958,1470005,453654,1016351,2.756,8.931,333675,2.027,17.861,38246,39231,274550
2015,No Utility Patent Granted,71,95648,104216,1992955,1966116,13032,12.645,10720,10.402,262174,92899,169275,4.725,13.335,207251,73090,134161,3.717,10.541,54923,2.793,21.082,7483,7538,53289
2015,No Utility Patent Granted,72,455284,605272,12448913,12260969,64874,10.770,59014,9.797,1968360,931555,1036805,7.598,16.054,1593746,651174,942572,5.311,12.999,374614,3.055,25.997,42633,43899,436000
2015,No Utility Patent Granted,81,627099,674261,5143012,5108747,53157,7.913,48242,7.181,612188,200489,411699,3.924,11.983,543809,175548,368261,3.436,10.645,68379,1.338,21.289,34855,35376,121388
2015,Utility Patent Granted,11,60,314,9705,9507,D,D,13,4.063,1491,D,1489,D,15.683,1097,156,941,1.641,11.539,394,4.144,23.078,D,D,D
2015,Utility Patent Granted,21,289,3068,246581,247447,252,8.215,251,8.183,27047,7897,19150,3.191,10.930,28705,7511,21194,3.035,11.600,-1658,-0.670,21.861,9,9,55
2015,Utility Patent Granted,22,100,5316,257158,256137,382,7.212,343,6.476,19488,3827,15661,1.494,7.608,17661,3253,14408,1.270,6.895,1827,0.713,13.790,D,D,D
2015,Utility Patent Granted,23,800,4137,283637,284608,398,9.731,304,7.433,54569,18825,35744,6.614,19.173,57181,10502,46679,3.690,20.091,-2612,-0.918,38.347,37,37,1044
2015,Utility Patent Granted,31-33,8494,30126,5339553,5318127,792,2.613,1158,3.821,406680,61779,344901,1.162,7.647,363835,82890,280945,1.559,6.841,42845,0.806,13.683,209,215,6444
2015,Utility Patent Granted,42,5689,45692,1797516,1775430,3191,7.029,2608,5.744,224057,64667,159390,3.642,12.620,179202,52785,126417,2.973,10.093,44855,2.526,20.187,168,202,4269
2015,Utility Patent Granted,44-45,1385,126577,2995268,2982328,4598,3.647,3629,2.878,218369,77175,141194,2.588,7.322,190206,43186,147020,1.448,6.378,28163,0.944,12.756,73,124,438
2015,Utility Patent Granted,48-49,1015,16491,1295871,1261067,2490,15.731,1166,7.366,175045,60470,114575,4.795,13.881,106219,48937,57282,3.881,8.423,68826,5.458,16.846,8,8,75
2015,Utility Patent Granted,51,1842,50125,1996815,1998829,3497,6.877,4947,9.729,258269,58945,199324,2.949,12.921,260045,75691,184354,3.787,13.010,-1776,-0.089,25.842,125,154,4156
2015,Utility Patent Granted,52,752,85826,2270679,2254304,9269,10.620,12180,13.955,316336,83923,232413,3.723,14.033,285254,92900,192354,4.121,12.654,31082,1.379,25.308,23,24,83
2015,Utility Patent Granted,53,727,27882,267912,264531,2596,9.442,1822,6.627,41984,16812,25172,6.355,15.871,35193,14433,20760,5.456,13.304,6791,2.567,26.608,18,18,336
2015,Utility Patent Granted,54,7849,53493,2300365,2295750,8399,16.070,5946,11.376,424734,200537,224197,8.735,18.501,411871,118107,293764,5.145,17.941,12863,0.560,35.881,532,549,8699
2015,Utility Patent Granted,55,2858,15158,1640326,1637902,1554,10.331,1321,8.782,218532,63342,155190,3.867,13.342,214338,51102,163236,3.120,13.086,4194,0.256,26.172,10,12,307
2015,Utility Patent Granted,56,1198,19422,1232472,1230408,1882,9.047,4643,22.319,153502,46828,106674,3.806,12.476,150054,66755,83299,5.425,12.195,3448,0.280,24.391,45,45,678
2015,Utility Patent Granted,61,362,2475,818763,813701,346,14.048,322,13.073,50159,3800,46359,0.467,6.164,39582,8373,31209,1.029,4.864,10577,1.300,9.729,8,8,45
2015,Utility Patent Granted,62,735,46201,2477683,2445922,11229,26.575,3335,7.893,337988,159127,178861,6.506,13.818,272947,65056,207891,2.660,11.159,65041,2.659,22.319,21,22,183
2015,Utility Patent Granted,71,188,2542,239254,230056,268,10.872,114,4.625,29534,6938,22596,3.016,12.838,11604,2776,8828,1.207,5.044,17930,7.794,10.088,10,21,119
2015,Utility Patent Granted,72,525,21440,747216,723921,1222,5.787,573,2.714,92408,27673,64735,3.823,12.765,46888,13756,33132,1.900,6.477,45520,6.288,12.954,27,35,518
2015,Utility Patent Granted,81,940,18582,261610,260945,2215,11.997,1978,10.713,41400,14975,26425,5.739,15.865,40592,19833,20759,7.600,15.556,808,0.310,31.112,24,24,121
2016,No Utility Patent Granted,11,18106,18591,148975,148711,2254,12.247,1880,10.215,22932,9011,13921,6.059,15.421,22589,7566,15023,5.088,15.190,343,0.231,30.380,1321,1321,5448
2016,No Utility Patent Granted,21,17777,22024,387311,439543,1744,7.605,3562,15.532,40136,17613,22523,4.007,9.131,144379,32524,111855,7.400,32.848,-104243,-23.716,18.263,2387,2418,18627
2016,No Utility Patent Granted,22,5443,12465,363992,363457,772,6.256,521,4.222,24420,8465,15955,2.329,6.719,23517,5492,18025,1.511,6.470,903,0.248,12.941,243,244,1405
2016,No Utility Patent Granted,23,583918,594280,6004958,5856203,78486,13.419,59690,10.205,1111194,292400,818794,4.993,18.975,813902,235017,578885,4.013,13.898,297292,5.077,27.796,39939,39998,159807
2016,No Utility Patent Granted,31-33,225415,245969,6273015,6261201,17184,6.985,17251,7.013,624835,157174,467661,2.510,9.979,600515,162777,437738,2.600,9.591,24320,0.388,19.182,13338,13428,111363
2016,No Utility Patent Granted,42,269720,337373,4288529,4273079,25659,7.590,26995,7.986,480143,135801,344342,3.178,11.236,450296,151726,298570,3.551,10.538,29847,0.698,21.076,19602,20161,102387
2016,No Utility Patent Granted,44-45,586593,866123,12580728,12467771,72493,8.388,68760,7.956,1355399,471139,884260,3.779,10.871,1132064,380184,751880,3.049,9.080,223335,1.791,18.160,48175,51463,230711
2016,No Utility Patent Granted,48-49,155679,189601,3356135,3307999,25030,13.331,21330,11.361,459709,154874,304835,4.682,13.897,364521,128760,235761,3.892,11.019,95188,2.878,22.039,15145,15315,70952
2016,No Utility Patent Granted,51,63011,81914,1388268,1373593,11434,14.186,8807,10.927,207813,77633,130180,5.652,15.129,178993,69328,109665,5.047,13.031,28820,2.098,26.062,5596,5814,36820
2016,No Utility Patent Granted,52,212353,360660,3993504,3914786,29730,8.285,26082,7.269,546765,166682,380083,4.258,13.967,392613,125718,266895,3.211,10.029,154152,3.938,20.058,14308,14945,62380
2016,No Utility Patent Granted,53,245036,304713,1818139,1797756,37633,12.524,29159,9.704,287134,121909,165225,6.781,15.972,247609,101001,146608,5.618,13.773,39525,2.199,27.546,18731,19054,64779
2016,No Utility Patent Granted,54,671761,725423,6469674,6376426,88419,12.271,78668,10.918,1018931,349434,669497,5.480,15.980,832516,314587,517929,4.934,13.056,186415,2.924,26.112,55766,56323,214408
2016,No Utility Patent Granted,55,23976,37629,1733855,1716247,2908,7.803,2190,5.876,258191,75365,182826,4.391,15.044,224689,55076,169613,3.209,13.092,33502,1.952,26.184,665,699,13229
2016,No Utility Patent Granted,56,285849,337249,9600723,9530280,42396,12.753,32801,9.866,1691427,470793,1220634,4.940,17.748,1547885,471079,1076806,4.943,16.242,143542,1.506,32.484,22493,22699,231145
2016,No Utility Patent Granted,61,81318,91230,2848600,2824238,9555,10.588,7584,8.404,255134,58466,196668,2.070,9.034,204978,59017,145961,2.090,7.258,50156,1.776,14.516,5285,5477,44381
2016,No Utility Patent Granted,62,602914,782187,16897937,16690621,65524,8.438,54153,6.974,1803154,534739,1268415,3.204,10.803,1389696,440799,948897,2.641,8.326,413458,2.477,16.652,38651,39705,287360
2016,No Utility Patent Granted,71,98684,107627,2055389,2016253,14201,13.408,10780,10.178,284361,95007,189354,4.712,14.103,204739,71820,132919,3.562,10.154,79622,3.949,20.309,7722,7779,52578
2016,No Utility Patent Granted,72,466127,622670,12901461,12656028,70167,11.432,52424,8.541,2015683,997553,1018130,7.882,15.927,1530145,579296,950849,4.577,12.090,485538,3.836,24.180,40546,41601,415151
2016,No Utility Patent Granted,81,634855,684334,5252952,5203001,56995,8.384,48010,7.062,652584,215851,436733,4.149,12.542,553639,177931,375708,3.420,10.641,98945,1.902,21.282,35274,35715,127551
2016,Utility Patent Granted,11,59,300,10760,10535,27,9.294,8,2.754,1653,440,1213,4.177,15.691,1237,81,1156,0.769,11.742,416,3.949,23.485,D,D,D
2016,Utility Patent Granted,21,282,2945,196659,223149,216,7.280,260,8.763,13572,8453,5119,3.788,6.082,66371,9076,57295,4.067,29.743,-52799,-23.661,12.164,5,5,244
2016,Utility Patent Granted,22,94,5285,276559,276628,302,5.729,274,5.198,19664,4803,14861,1.736,7.108,19473,5953,13520,2.152,7.039,191,0.069,14.079,4,9,60
2016,Utility Patent Granted,23,814,4208,310871,304675,201,4.736,274,6.455,56110,7031,49079,2.308,18.416,43141,11118,32023,3.649,14.160,12969,4.257,28.319,36,40,1286
2016,Utility Patent Granted,31-33,8518,30054,5276535,5287027,863,2.860,1108,3.672,348966,40597,308369,0.768,6.600,368885,81731,287154,1.546,6.977,-19919,-0.377,13.201,232,248,8287
2016,Utility Patent Granted,42,5684,46959,1828541,1825523,3100,6.608,3014,6.424,202881,62799,140082,3.440,11.114,195591,65854,129737,3.607,10.714,7290,0.399,21.428,195,220,4816
2016,Utility Patent Granted,44-45,1456,139366,3379831,3367048,8381,6.087,5020,3.646,356410,100670,255740,2.990,10.585,333554,76578,256976,2.274,9.906,22856,0.679,19.813,66,68,593
2016,Utility Patent Granted,48-49,1052,17682,1372395,1357490,1876,10.756,1395,7.998,156896,38669,118227,2.849,11.558,127591,62785,64806,4.625,9.399,29305,2.159,18.798,11,88,34392
2016,Utility Patent Granted,51,1848,53405,2012595,2001915,5998,11.569,2883,5.561,255630,101890,153740,5.090,12.769,233077,74702,158375,3.732,11.643,22553,1.127,23.285,92,101,2908
2016,Utility Patent Granted,52,720,91089,2316020,2285068,13064,14.881,6463,7.362,336896,128151,208745,5.608,14.743,272983,71682,201301,3.137,11.946,63913,2.797,23.893,20,20,66
2016,Utility Patent Granted,53,712,30710,278777,272662,4080,13.786,1852,6.258,54358,32003,22355,11.737,19.936,42384,14149,28235,5.189,15.545,11974,4.392,31.089,23,23,106
2016,Utility Patent Granted,54,7851,56183,2323628,2306014,5462,9.830,4224,7.602,295424,102444,192980,4.442,12.811,261618,71623,189995,3.106,11.345,33806,1.466,22.690,528,552,8003
2016,Utility Patent Granted,55,2873,16527,1644810,1650383,2151,13.275,1503,9.276,200883,55062,145821,3.336,12.172,212594,49620,162974,3.007,12.881,-11711,-0.710,24.344,19,23,531
2016,Utility Patent Granted,56,1204,20612,1330077,1326914,3337,16.613,2287,11.385,174350,44770,129580,3.374,13.140,165251,62188,103063,4.687,12.454,9099,0.686,24.908,32,33,2865
2016,Utility Patent Granted,61,361,2281,811007,814548,128,5.340,360,15.019,43402,7193,36209,0.883,5.328,50533,10000,40533,1.228,6.204,-7131,-0.875,10.657,6,6,62
2016,Utility Patent Granted,62,726,54248,2711877,2669564,6817,13.121,2229,4.290,262406,81240,181166,3.043,9.830,175272,35348,139924,1.324,6.566,87134,3.264,13.131,33,71,1516
2016,Utility Patent Granted,71,199,2692,257006,253277,229,8.598,172,6.458,24666,6939,17727,2.740,9.739,16545,2994,13551,1.182,6.532,8121,3.206,13.065,7,7,14
2016,Utility Patent Granted,72,525,22574,799983,800978,1053,4.724,486,2.180,62992,24928,38064,3.112,7.864,65548,10179,55369,1.271,8.183,-2556,-0.319,15.729,26,26,200
2016,Utility Patent Granted,81,958,17291,244824,243465,824,4.706,1259,7.191,29411,5585,23826,2.294,12.080,26085,10666,15419,4.381,10.714,3326,1.366,21.428,27,35,164
2017,No Utility Patent Granted,11,18234,18720,151758,150349,2133,11.436,1997,10.707,26170,9036,17134,6.010,17.406,23291,7925,15366,5.271,15.491,2879,1.915,30.983,1364,1364,5502
2017,No Utility Patent Granted,21,16461,20470,383654,382803,1785,8.485,2918,13.871,71654,20254,51400,5.291,18.718,70262,28952,41310,7.563,18.355,1392,0.364,36.709,1933,2007,15864
2017,No Utility Patent Granted,22,5409,11680,327100,327530,583,4.981,630,5.383,29630,9464,20166,2.890,9.047,30637,7019,23618,2.143,9.354,-1007,-0.307,18.093,223,227,1344
2017,No Utility Patent Granted,23,596828,607323,6214729,6106806,76563,12.742,63637,10.591,1077831,274639,803192,4.497,17.650,861921,250271,611650,4.098,14.114,215910,3.536,28.228,42344,42406,166102
2017,No Utility Patent Granted,31-33,223152,243676,6222738,6180405,16833,6.889,18203,7.449,702784,175171,527613,2.834,11.371,617894,206274,411620,3.338,9.998,84890,1.374,19.995,13495,13620,131970
2017,No Utility Patent Granted,42,263425,332065,4310564,4278841,24413,7.311,28149,8.430,561175,147616,413559,3.450,13.115,497672,176210,321462,4.118,11.631,63503,1.484,23.262,19280,19840,106547
2017,No Utility Patent Granted,44-45,584225,861151,12268690,12288406,71238,8.263,73177,8.488,1331101,452954,878147,3.686,10.832,1365899,479341,886558,3.901,11.115,-34798,-0.283,21.664,48812,51625,238944
2017,No Utility Patent Granted,48-49,156719,190273,3415132,3379057,23772,12.525,22833,12.030,466618,131316,335302,3.886,13.809,393241,137555,255686,4.071,11.638,73377,2.172,23.275,15723,15964,72946
2017,No Utility Patent Granted,51,64837,85912,1400372,1411764,11061,13.017,9186,10.810,222367,76458,145909,5.416,15.751,241469,75795,165674,5.369,17.104,-19102,-1.353,31.502,6067,6269,45168
2017,No Utility Patent Granted,52,211817,368806,4290870,4264852,30592,8.307,29532,8.019,575438,183882,391556,4.312,13.493,524049,171759,352290,4.027,12.288,51389,1.205,24.575,14546,15177,64770
2017,No Utility Patent Granted,53,251270,314630,1853997,1833365,39782,12.813,31504,10.147,309482,120710,188772,6.584,16.881,267592,112448,155144,6.133,14.596,41890,2.285,29.191,19502,19984,66790
2017,No Utility Patent Granted,54,674783,737906,6518204,6429554,84996,11.561,79531,10.818,1031322,314867,716455,4.897,16.040,853136,360148,492988,5.601,13.269,178186,2.771,26.538,55727,56325,236045
2017,No Utility Patent Granted,55,23720,38618,1840494,1772931,3887,10.184,2985,7.821,359410,101928,257482,5.749,20.272,223773,76294,147479,4.303,12.622,135637,7.650,25.243,759,790,15356
2017,No Utility Patent Granted,56,288975,341179,9680058,9585071,39613,11.667,36336,10.702,1746332,438673,1307659,4.577,18.219,1563937,486788,1077149,5.079,16.316,182395,1.903,32.633,23924,24274,247927
2017,No Utility Patent Granted,61,82464,92091,2928511,2919070,9479,10.360,8298,9.069,264269,60458,203811,2.071,9.053,245325,74501,170824,2.552,8.404,18944,0.649,16.808,5566,6016,52104
2017,No Utility Patent Granted,62,605652,798406,17437476,17214187,66742,8.393,60374,7.592,2117460,547643,1569817,3.181,12.301,1675035,566030,1109005,3.288,9.731,442425,2.570,19.461,39520,40886,321884
2017,No Utility Patent Granted,71,100995,111519,2156218,2130257,14489,13.177,11370,10.340,302421,106225,196196,4.986,14.196,250162,84162,166000,3.951,11.743,52259,2.453,23.487,7952,7994,56071
2017,No Utility Patent Granted,72,475277,635285,13146057,12993841,70664,11.227,58863,9.352,2143770,1005592,1138178,7.739,16.498,1852231,719003,1133228,5.533,14.255,291539,2.244,28.509,41336,42867,446844
2017,No Utility Patent Granted,81,639246,690123,5254614,5229151,56254,8.182,51091,7.431,660232,208229,452003,3.982,12.626,608466,194235,414231,3.714,11.636,51766,0.990,23.272,36864,37475,138663
2017,Utility Patent Granted,11,61,292,9933,9851,D,D,23,7.591,1403,D,1398,D,14.242,1240,463,777,4.700,12.588,163,1.655,25.175,D,D,D
2017,Utility Patent Granted,21,271,3028,191919,193805,628,21.024,546,18.279,32056,15452,16604,7.973,16.540,36822,16450,20372,8.488,19.000,-4766,-2.459,33.081,8,8,70
2017,Utility Patent Granted,22,109,6315,318042,316987,513,8.266,295,4.753,21313,9022,12291,2.846,6.724,19141,2721,16420,0.858,6.038,2172,0.685,12.077,D,D,D
2017,Utility Patent Granted,23,857,4372,318640,322976,285,6.487,328,7.466,44915,8043,36872,2.490,13.907,53266,14187,39079,4.393,16.492,-8351,-2.586,27.813,30,30,258
2017,Utility Patent Granted,31-33,8431,30507,5466620,5455275,826,2.681,1436,4.661,409576,49693,359883,0.911,7.508,388151,96748,291403,1.773,7.115,21425,0.393,14.230,261,275,10112
2017,Utility Patent Granted,42,5781,46597,1788320,1802822,2991,6.396,3321,7.102,200916,56322,144594,3.124,11.145,228417,84441,143976,4.684,12.670,-27501,-1.525,22.289,208,223,4847
2017,Utility Patent Granted,44-45,1462,133471,3415560,3416347,4352,3.204,9062,6.672,374982,73848,301134,2.162,10.976,376478,94200,282278,2.757,11.020,-1496,-0.044,21.952,76,76,680
2017,Utility Patent Granted,48-49,1060,18615,1443169,1410854,1409,7.604,1238,6.681,186980,73675,113305,5.222,13.253,118083,38921,79162,2.759,8.370,68897,4.883,16.739,14,15,111
2017,Utility Patent Granted,51,1991,53149,2056910,2079174,5321,9.760,8065,14.792,282111,85862,196249,4.130,13.568,331788,91115,240673,4.382,15.958,-49677,-2.389,27.137,115,129,5924
2017,Utility Patent Granted,52,675,77136,2073222,2086234,4236,5.271,10700,13.314,317120,134458,182662,6.445,15.201,344467,142224,202243,6.817,16.511,-27347,-1.311,30.401,20,22,182
2017,Utility Patent Granted,53,696,32358,291764,288083,4712,15.373,1299,4.238,49424,23233,26191,8.065,17.156,39576,9452,30124,3.281,13.738,9848,3.418,27.475,20,20,60
2017,Utility Patent Granted,54,7892,46669,2346770,2332482,2944,6.225,4199,8.878,266135,72488,193647,3.108,11.410,237803,85637,152166,3.671,10.195,28332,1.215,20.391,538,563,8181
2017,Utility Patent Granted,55,2765,16680,1653369,1649280,1629,9.796,1527,9.183,210711,64584,146127,3.916,12.776,204737,60860,143877,3.690,12.414,5974,0.362,24.827,21,21,533
2017,Utility Patent Granted,56,1142,20757,1525874,1493888,1115,5.280,1839,8.708,277459,152670,124789,10.220,18.573,207721,88662,119059,5.935,13.905,69738,4.668,27.809,35,42,460
2017,Utility Patent Granted,61,354,2122,760809,759555,186,8.743,197,9.260,37643,3530,34113,0.465,4.956,35457,10559,24898,1.390,4.668,2186,0.288,9.336,7,7,32
2017,Utility Patent Granted,62,709,45147,2671871,2645880,4911,10.908,4663,10.357,261368,70345,191023,2.659,9.878,208315,76440,131875,2.889,7.873,53053,2.005,15.746,41,85,1383
2017,Utility Patent Granted,71,202,2197,220177,217290,484,23.472,214,10.378,24924,5580,19344,2.568,11.470,19182,4995,14187,2.299,8.828,5742,2.643,17.656,D,D,D
2017,Utility Patent Granted,72,561,22780,874773,872740,647,2.846,551,2.424,75032,16486,58546,1.889,8.597,69763,18700,51063,2.143,7.994,5269,0.604,15.987,22,25,196
2017,Utility Patent Granted,81,932,16251,251874,249256,1231,7.678,796,4.965,36246,16125,20121,6.469,14.542,30233,8563,21670,3.435,12.129,6013,2.412,24.259,26,26,135
2018,No Utility Patent Granted,11,18287,18762,152987,152092,2086,11.150,1980,10.583,23394,8665,14729,5.697,15.381,21593,7404,14189,4.868,14.197,1801,1.184,28.395,1430,1430,5361
2018,No Utility Patent Granted,21,16471,20116,401475,389731,2004,9.955,2033,10.099,78705,18139,60566,4.654,20.195,54816,21736,33080,5.577,14.065,23889,6.130,28.130,1423,1477,10600
2018,No Utility Patent Granted,22,5461,12630,359558,359276,708,5.633,586,4.662,26672,7888,18784,2.196,7.424,26081,6119,19962,1.703,7.259,591,0.164,14.519,209,219,997
2018,No Utility Patent Granted,23,610855,621733,6434433,6298949,78804,12.827,64059,10.427,1128316,306345,821971,4.863,17.913,857584,242423,615161,3.849,13.615,270732,4.298,27.229,43583,43644,167594
2018,No Utility Patent Granted,31-33,221349,241929,6289207,6238131,16437,6.779,17513,7.223,690437,168324,522113,2.698,11.068,590830,175681,415149,2.816,9.471,99608,1.597,18.943,13402,13481,114663
2018,No Utility Patent Granted,42,259644,326050,4376420,4361337,22760,6.934,27145,8.270,503545,131377,372168,3.012,11.546,472616,162579,310037,3.728,10.836,30929,0.709,21.673,18692,19190,97428
2018,No Utility Patent Granted,44-45,578942,855088,12002348,12026874,65871,7.677,71788,8.366,1219127,408356,810771,3.395,10.137,1271026,407330,863696,3.387,10.568,-51899,-0.432,20.273,48544,51729,247565
2018,No Utility Patent Granted,48-49,161091,194863,3511350,3452094,26070,13.543,21352,11.092,491654,151018,340636,4.375,14.242,372752,128928,243824,3.735,10.798,118902,3.444,21.596,14926,15088,75720
2018,No Utility Patent Granted,51,65889,90233,1476712,1475914,10635,11.869,9382,10.470,207210,73436,133774,4.976,14.039,205625,67683,137942,4.586,13.932,1585,0.107,27.864,6133,6448,40928
2018,No Utility Patent Granted,52,211809,367522,4300309,4273458,29773,8.093,30536,8.300,561215,203539,357676,4.763,13.133,508352,167443,340909,3.918,11.896,52863,1.237,23.791,14972,15893,70886
2018,No Utility Patent Granted,53,258583,328674,1961270,1939607,39745,12.220,32868,10.106,325915,133799,192116,6.898,16.803,283167,119296,163871,6.151,14.599,42748,2.204,29.198,19686,20089,63909
2018,No Utility Patent Granted,54,678585,738072,6589918,6525049,83336,11.319,79707,10.826,981488,301650,679838,4.623,15.042,850794,327197,523597,5.014,13.039,130694,2.003,26.078,56250,56931,221579
2018,No Utility Patent Granted,55,22909,38954,1831438,1844929,1718,4.342,2937,7.424,256989,44743,212246,2.425,13.929,283471,93475,189996,5.067,15.365,-26482,-1.435,27.859,722,744,11322
2018,No Utility Patent Granted,56,292242,341747,9995108,9850665,39073,11.487,35849,10.540,1710684,424616,1286068,4.311,17.366,1414063,411396,1002667,4.176,14.355,296621,3.011,28.710,23980,24190,212997
2018,No Utility Patent Granted,61,84186,93801,2928484,2920155,9358,10.062,7768,8.352,244426,57696,186730,1.976,8.370,226948,54979,171969,1.883,7.772,17478,0.599,15.544,5527,5594,37388
2018,No Utility Patent Granted,62,600405,794018,17594095,17453168,64411,8.140,58939,7.449,2001902,622275,1379627,3.565,11.470,1716892,506963,1209929,2.905,9.837,285010,1.633,19.674,39605,40549,282750
2018,No Utility Patent Granted,71,103935,114802,2241180,2217076,14529,12.826,11475,10.130,301565,104976,196589,4.735,13.602,253135,76443,176692,3.448,11.418,48430,2.184,22.835,8167,8272,55515
2018,No Utility Patent Granted,72,483059,642901,13262139,13135693,66527,10.420,57586,9.020,1997555,889996,1107559,6.775,15.207,1741114,666317,1074797,5.073,13.255,256441,1.952,26.510,43074,44527,469877
2018,No Utility Patent Granted,81,643155,694182,5314636,5281289,56038,8.101,51196,7.401,670066,221049,449017,4.186,12.688,603659,193819,409840,3.670,11.430,66407,1.257,22.860,37173,37790,136216
2018,Utility Patent Granted,11,66,254,9323,9709,D,D,50,17.986,763,D,755,D,7.859,1518,597,921,6.149,15.636,-755,-7.777,15.718,D,D,D
2018,Utility Patent Granted,21,272,3132,204392,202627,183,5.601,454,13.894,29377,3827,25550,1.889,14.498,24980,9886,15094,4.879,12.328,4397,2.170,24.656,10,11,463
2018,Utility Patent Granted,22,100,5749,287609,287038,1248,22.200,993,17.664,51491,33032,18459,11.508,17.939,50049,31860,18189,11.100,17.436,1442,0.502,34.873,9,9,88
2018,Utility Patent Granted,23,878,4432,371454,365333,241,5.435,245,5.525,59594,15384,44210,4.211,16.312,46955,8072,38883,2.209,12.853,12639,3.460,25.705,37,37,673
2018,Utility Patent Granted,31-33,8397,31856,5577912,5540378,1862,5.919,1071,3.404,422415,72656,349759,1.311,7.624,347663,62924,284739,1.136,6.275,74752,1.349,12.550,281,288,9884
2018,Utility Patent Granted,42,5805,47845,1749778,1748696,2620,5.460,2899,6.042,178897,30505,148392,1.744,10.230,176724,54170,122554,3.098,10.106,2173,0.124,20.212,197,201,4145
2018,Utility Patent Granted,44-45,1471,129168,3667092,3652031,4362,3.337,7487,5.727,402197,75795,326402,2.075,11.013,376122,147960,228162,4.051,10.299,26075,0.714,20.598,71,89,1129
2018,Utility Patent Granted,48-49,1056,18406,1509622,1485901,968,5.216,1270,6.844,156408,38647,117761,2.601,10.526,109131,25194,83937,1.696,7.344,47277,3.182,14.689,8,8,19
2018,Utility Patent Granted,51,1979,51655,2064908,2041142,4719,9.192,4083,7.953,296541,97762,198779,4.790,14.528,248067,77300,170767,3.787,12.153,48474,2.375,24.307,125,218,8807
2018,Utility Patent Granted,52,685,79290,2142604,2131702,7725,9.862,5799,7.404,316841,123636,193205,5.800,14.863,294729,70295,224434,3.298,13.826,22112,1.037,27.652,16,16,118
2018,Utility Patent Granted,53,733,26077,238321,233150,2131,8.315,1236,4.823,35274,9369,25905,4.018,15.129,25553,9308,16245,3.992,10.960,9721,4.169,21.920,23,23,71
2018,Utility Patent Granted,54,8088,48015,2469484,2433863,3922,8.031,5562,11.389,310845,81431,229414,3.346,12.772,241129,96823,144306,3.978,9.907,69716,2.864,19.815,519,553,8663
2018,Utility Patent Granted,55,2732,14615,1662888,1641462,748,5.086,934,6.350,200686,42635,158051,2.597,12.226,156941,45781,111160,2.789,9.561,43745,2.665,19.122,17,19,764
2018,Utility Patent Granted,56,1136,17412,1498443,1504698,707,3.470,6630,32.542,138715,46038,92677,3.060,9.219,148236,64144,84092,4.263,9.852,-9521,-0.633,18.438,35,36,644
2018,Utility Patent Granted,61,334,2051,796694,783039,107,5.121,184,8.806,50675,3806,46869,0.486,6.472,22462,2553,19909,0.326,2.869,28213,3.603,5.737,9,9,68
2018,Utility Patent Granted,62,701,49133,2882356,2871665,5126,10.551,4028,8.291,214994,67015,147979,2.334,7.487,193313,56790,136523,1.978,6.732,21681,0.755,13.463,30,30,597
2018,Utility Patent Granted,71,203,2000,192997,189495,212,10.187,374,17.972,19875,11710,8165,6.180,10.488,12320,3164,9156,1.670,6.502,7555,3.987,13.003,10,10,118
2018,Utility Patent Granted,72,582,23856,1058965,1040546,816,3.406,1021,4.262,112616,31278,81338,3.006,10.823,79061,28326,50735,2.722,7.598,33555,3.225,15.196,31,135,1824
2018,Utility Patent Granted,81,961,14999,277364,269873,422,2.654,2227,14.005,41207,6725,34482,2.492,15.269,24443,11385,13058,4.219,9.057,16764,6.212,18.114,27,27,218
2019,No Utility Patent Granted,11,18416,18930,154433,153837,2143,11.355,2030,10.756,23718,8070,15648,5.246,15.418,22543,6835,15708,4.443,14.654,1175,0.764,29.308,1508,1508,5343
2019,No Utility Patent Granted,21,16381,20274,420560,409210,2090,10.342,1959,9.694,75615,22056,53559,5.390,18.478,52798,18466,34332,4.513,12.902,22817,5.576,25.805,1362,1396,10580
2019,No Utility Patent Granted,22,5560,11850,329856,329118,650,5.523,490,4.163,20951,6335,14616,1.925,6.366,19525,3955,15570,1.202,5.933,1426,0.433,11.865,222,222,1391
2019,No Utility Patent Granted,23,625678,637076,6638234,6528079,81723,12.983,66448,10.557,1113490,314106,799384,4.812,17.057,894252,251311,642941,3.850,13.699,219238,3.358,27.397,46926,47008,181487
2019,No Utility Patent Granted,31-33,219262,240705,6347028,6288060,16326,6.769,17326,7.183,661794,165321,496473,2.629,10.525,544043,163981,380062,2.608,8.652,117751,1.873,17.304,13556,13670,114879
2019,No Utility Patent Granted,42,255384,323422,4415431,4399467,22239,6.840,25614,7.879,471168,134672,336496,3.061,10.710,438519,147658,290861,3.356,9.968,32649,0.742,19.935,19025,19395,96468
2019,No Utility Patent Granted,44-45,575209,851035,11908785,11919148,65156,7.648,66995,7.864,1128386,396382,732004,3.326,9.467,1158990,419456,739534,3.519,9.724,-30604,-0.257,18.934,48412,50597,251824
2019,No Utility Patent Granted,48-49,167008,201929,3667745,3580177,28041,14.107,21724,10.929,526213,176677,349536,4.935,14.698,350617,122904,227713,3.433,9.793,175596,4.905,19.587,15823,16042,78596
2019,No Utility Patent Granted,51,66967,90723,1464531,1456193,11970,13.359,9723,10.852,211604,76640,134964,5.263,14.531,194780,66891,127889,4.594,13.376,16824,1.155,26.752,6475,6696,39998
2019,No Utility Patent Granted,52,211134,362451,4161286,4151600,29097,8.046,27432,7.586,486297,154282,332015,3.716,11.713,467077,152689,314388,3.678,11.251,19220,0.463,22.501,15464,15986,64992
2019,No Utility Patent Granted,53,264662,329558,1938210,1918229,39624,12.152,32671,10.019,300092,128778,171314,6.713,15.644,262049,107028,155021,5.580,13.661,38043,1.983,27.322,20833,21147,66435
2019,No Utility Patent Granted,54,685270,738979,6636921,6541670,88043,11.988,78978,10.753,972862,316025,656837,4.831,14.872,785080,297465,487615,4.547,12.001,187782,2.871,24.002,57848,58299,220050
2019,No Utility Patent Granted,55,22511,37282,1800097,1805086,1514,4.027,2144,5.703,212143,41536,170607,2.301,11.753,223857,54128,169729,2.999,12.401,-11714,-0.649,23.505,686,712,9346
2019,No Utility Patent Granted,56,296327,349646,10256258,10098523,42804,12.364,35924,10.376,1709570,477773,1231797,4.731,16.929,1394972,425326,969646,4.212,13.814,314598,3.115,27.627,24621,24851,198447
2019,No Utility Patent Granted,61,85882,95623,2985679,2959914,9726,10.258,8114,8.558,261483,68804,192679,2.325,8.834,210576,60414,150162,2.041,7.114,50907,1.720,14.229,5829,5960,41981
2019,No Utility Patent Granted,62,604409,804430,17798307,17630629,69010,8.646,56410,7.068,1890713,611152,1279561,3.466,10.724,1559212,505609,1053603,2.868,8.844,331501,1.880,17.688,39448,40561,293312
2019,No Utility Patent Granted,71,106938,118217,2310025,2282069,15292,13.120,11961,10.262,300773,109216,191557,4.786,13.180,245006,76407,168599,3.348,10.736,55767,2.444,21.472,8692,8773,60049
2019,No Utility Patent Granted,72,489995,655458,13539953,13455236,68441,10.531,57323,8.820,1919555,907853,1011702,6.747,14.266,1744245,639903,1104342,4.756,12.963,175310,1.303,25.927,44603,45704,465803
2019,No Utility Patent Granted,81,647294,700388,5335421,5319827,56873,8.152,51390,7.366,625649,213937,411712,4.022,11.761,595599,188523,407076,3.544,11.196,30050,0.565,22.392,38393,38854,139983
2019,Utility Patent Granted,11,65,236,9942,9798,12,5.053,15,6.316,1119,378,741,3.858,11.421,809,130,679,1.327,8.257,310,3.164,16.514,0,0,0
2019,Utility Patent Granted,21,282,2833,206758,205873,95,3.289,205,7.098,18626,3495,15131,1.698,9.047,16807,3425,13382,1.664,8.164,1819,0.884,16.328,4,4,28
2019,Utility Patent Granted,22,100,6642,311757,315020,294,4.405,357,5.350,18140,7518,10622,2.387,5.758,24908,9723,15185,3.086,7.907,-6768,-2.148,11.517,D,D,D
2019,Utility Patent Granted,23,910,4624,406133,398607,257,5.593,199,4.331,60825,6487,54338,1.627,15.259,46729,6932,39797,1.739,11.723,14096,3.536,23.446,37,37,192
2019,Utility Patent Granted,31-33,8587,31424,5717237,5672877,835,2.630,1489,4.690,423031,57627,365404,1.016,7.457,332486,73772,258714,1.300,5.861,90545,1.596,11.722,232,233,4666
2019,Utility Patent Granted,42,5900,47918,1752450,1749057,2724,5.714,2237,4.692,167726,38314,129412,2.191,9.590,161205,40717,120488,2.328,9.217,6521,0.373,18.433,184,198,3888
2019,Utility Patent Granted,44-45,1533,131618,3831394,3784156,4730,3.605,3928,2.994,346571,86744,259827,2.292,9.158,254302,57145,197157,1.510,6.720,92269,2.438,13.440,71,72,501
2019,Utility Patent Granted,48-49,1057,18419,1817177,1676617,1195,6.585,652,3.593,356010,32480,323530,1.937,21.234,79651,10981,68670,0.655,4.751,276359,16.483,9.501,21,24,185
2019,Utility Patent Granted,51,2119,53246,2061598,2077903,4705,8.816,4946,9.268,271843,84298,187545,4.057,13.083,304729,70210,234519,3.379,14.665,-32886,-1.583,26.165,112,150,6527
2019,Utility Patent Granted,52,735,84011,2368884,2344940,6974,8.219,8658,10.204,312202,128249,183953,5.469,13.314,263446,88397,175049,3.770,11.235,48756,2.079,22.469,16,18,84
2019,Utility Patent Granted,53,732,32320,300958,299642,1919,5.951,1777,5.510,33446,11494,21952,3.836,11.162,30958,11750,19208,3.921,10.332,2488,0.830,20.663,35,136,521
2019,Utility Patent Granted,54,8471,56312,2601162,2610917,3212,5.695,3389,6.009,273415,70278,203137,2.692,10.472,295706,90152,205554,3.453,11.326,-22291,-0.854,20.944,570,577,9596
2019,Utility Patent Granted,55,2724,14317,1699737,1700702,591,3.949,1885,12.597,166573,24920,141653,1.465,9.794,170438,42025,128413,2.471,10.022,-3865,-0.227,19.589,12,19,4829
2019,Utility Patent Granted,56,1210,16626,1455952,1456393,1198,7.261,942,5.710,99833,27074,72759,1.859,6.855,104226,25676,78550,1.763,7.156,-4393,-0.302,13.710,36,37,345
2019,Utility Patent Granted,61,361,1847,818726,813359,180,9.417,309,16.165,35239,3610,31629,0.444,4.333,24324,3689,20635,0.454,2.991,10915,1.342,5.981,6,8,15
2019,Utility Patent Granted,62,765,53698,3005152,2987538,5878,11.243,3048,5.830,215244,81190,134054,2.718,7.205,182461,63112,119349,2.113,6.107,32783,1.097,12.215,32,32,3136
2019,Utility Patent Granted,71,235,2334,162809,160572,364,16.542,97,4.408,16565,4582,11983,2.854,10.316,11988,2487,9501,1.549,7.466,4577,2.850,14.932,8,8,47
2019,Utility Patent Granted,72,609,22137,952818,949748,673,3.038,705,3.182,55185,22918,32267,2.413,5.810,49124,22961,26163,2.418,5.172,6061,0.638,10.345,36,36,389
2019,Utility Patent Granted,81,988,13947,290882,288933,444,3.176,513,3.669,22027,4573,17454,1.583,7.624,17766,7444,10322,2.576,6.149,4261,1.475,12.298,35,35,456
2020,No Utility Patent Granted,11,18028,18569,156894,155305,2017,10.831,2124,11.406,25237,8218,17019,5.292,16.250,21922,7364,14558,4.742,14.115,3315,2.135,28.231,1467,1467,5297
2020,No Utility Patent Granted,21,15794,19516,381938,396255,1688,8.504,2356,11.869,49845,17023,32822,4.296,12.579,78832,22940,55892,5.789,19.894,-28987,-7.315,25.158,1567,1636,12984
2020,No Utility Patent Granted,22,5603,12012,336420,334634,690,5.767,596,4.981,26307,6927,19380,2.070,7.861,22615,7218,15397,2.157,6.758,3692,1.103,13.516,240,243,2357
2020,No Utility Patent Granted,23,631821,644545,6804078,6733038,80139,12.498,73466,11.457,1080681,304352,776329,4.520,16.050,939074,281072,658002,4.175,13.947,141607,2.103,27.895,49998,50096,192044
2020,No Utility Patent Granted,31-33,215304,237464,6281201,6314169,15709,6.570,18983,7.939,581798,159354,422444,2.524,9.214,648043,182505,465538,2.890,10.263,-66245,-1.049,18.428,14074,14183,120178
2020,No Utility Patent Granted,42,248846,315937,4330644,4342651,21726,6.817,27227,8.543,444343,131548,312795,3.029,10.232,468033,150803,317230,3.473,10.778,-23690,-0.546,20.464,19061,19537,93666
2020,No Utility Patent Granted,44-45,565732,843015,11880928,11909849,64862,7.652,74087,8.741,1180564,388794,791770,3.264,9.913,1231144,438553,792591,3.682,10.337,-50580,-0.425,19.825,49300,52749,252117
2020,No Utility Patent Granted,48-49,168220,202488,3741225,3691496,27951,13.828,27250,13.481,572935,241925,331010,6.554,15.520,471603,174324,297279,4.722,12.775,101332,2.745,25.551,18007,18234,90925
2020,No Utility Patent Granted,51,67814,92092,1422637,1428831,11057,12.067,10140,11.066,197197,72954,124243,5.106,13.801,208270,70684,137586,4.947,14.576,-11073,-0.775,27.603,6689,7007,49842
2020,No Utility Patent Granted,52,211655,362866,4229663,4186118,29858,8.243,28551,7.882,525243,163010,362233,3.894,12.547,436728,148013,288715,3.536,10.433,88515,2.114,20.866,14920,15770,65804
2020,No Utility Patent Granted,53,270103,335537,1959244,1943922,41748,12.561,35382,10.646,298462,125965,172497,6.480,15.354,269174,111769,157405,5.750,13.847,29288,1.507,27.694,22080,22381,66076
2020,No Utility Patent Granted,54,692541,746225,6710285,6625964,92195,12.437,82284,11.100,987765,333984,653781,5.041,14.907,816681,319879,496802,4.828,12.325,171084,2.582,24.651,58287,58768,224261
2020,No Utility Patent Granted,55,22322,36887,1837990,1826054,1920,5.191,2118,5.726,254105,63100,191005,3.456,13.916,229954,62550,167404,3.425,12.593,24151,1.323,25.186,668,712,13500
2020,No Utility Patent Granted,56,297668,353896,10110905,10152416,44715,12.733,39269,11.182,1679761,586040,1093721,5.772,16.545,1774821,490894,1283927,4.835,17.482,-95060,-0.936,33.091,25959,26123,219214
2020,No Utility Patent Granted,61,87202,97116,2938773,2937180,10134,10.519,8574,8.900,240187,68874,171313,2.345,8.177,236996,57327,179669,1.952,8.069,3191,0.109,16.138,6017,6082,39782
2020,No Utility Patent Granted,62,606257,813855,18071984,17925343,72342,8.945,62077,7.676,1935756,632617,1303139,3.529,10.799,1643424,542116,1101308,3.024,9.168,292332,1.631,18.336,40815,41990,314555
2020,No Utility Patent Granted,71,109086,121018,2297066,2299669,16253,13.579,13593,11.357,299590,113571,186019,4.939,13.028,304507,87978,216529,3.826,13.241,-4917,-0.214,26.055,9530,9632,64197
2020,No Utility Patent Granted,72,489972,658690,13262363,13363574,66724,10.152,63901,9.722,1778352,863766,914586,6.464,13.307,1974824,671307,1303517,5.023,14.778,-196472,-1.470,26.615,46366,47945,469367
2020,No Utility Patent Granted,81,644812,698128,5310918,5329517,58113,8.310,60467,8.647,629717,221746,407971,4.161,11.816,665792,231137,434655,4.337,12.493,-36075,-0.677,23.631,40610,41015,154146
2020,Utility Patent Granted,11,64,221,9607,9619,14,6.250,20,8.929,1110,296,814,3.077,11.540,1117,409,708,4.252,11.613,-7,-0.073,23.081,3,3,19
2020,Utility Patent Granted,21,290,2806,197501,205508,191,6.666,310,10.818,22795,6196,16599,3.015,11.092,38883,14556,24327,7.083,18.920,-16088,-7.828,22.184,9,10,281
2020,Utility Patent Granted,22,104,6671,300525,304825,237,3.573,161,2.427,12697,3087,9610,1.013,4.165,21118,2457,18661,0.806,6.928,-8421,-2.763,8.331,D,D,D
2020,Utility Patent Granted,23,954,4206,381337,382251,279,6.711,182,4.378,43807,9224,34583,2.413,11.460,45694,4393,41301,1.149,11.954,-1887,-0.494,22.921,44,46,359
2020,Utility Patent Granted,31-33,8521,30905,5679201,5696432,921,2.954,1475,4.730,395208,57304,337904,1.006,6.938,430854,74040,356814,1.300,7.564,-35646,-0.626,13.876,280,287,7510
2020,Utility Patent Granted,42,5837,49193,1801281,1810957,1930,3.895,2634,5.316,168711,36076,132635,1.992,9.316,191135,79373,111762,4.383,10.554,-22424,-1.238,18.632,223,232,4350
2020,Utility Patent Granted,44-45,1554,128970,3932946,3861289,7172,5.547,7838,6.062,383942,175799,208143,4.553,9.943,239302,76867,162435,1.991,6.197,144640,3.746,12.395,83,85,975
2020,Utility Patent Granted,48-49,1059,19294,1965086,1913563,1803,9.495,1194,6.288,216665,84945,131720,4.439,11.323,113739,49313,64426,2.577,5.944,102926,5.379,11.888,14,14,131
2020,Utility Patent Granted,51,2172,53190,2080359,2080574,3451,6.496,3313,6.237,247504,70518,176986,3.389,11.896,246426,73987,172439,3.556,11.844,1078,0.052,23.688,146,167,5439
2020,Utility Patent Granted,52,740,82095,2409680,2401620,3481,4.172,6182,7.408,264345,60542,203803,2.521,11.007,246177,59258,186919,2.467,10.250,18168,0.756,20.501,14,18,423
2020,Utility Patent Granted,53,738,32783,319283,317159,1751,5.351,1630,4.981,40280,12943,27337,4.081,12.700,35548,12212,23336,3.850,11.208,4732,1.492,22.417,30,62,227
2020,Utility Patent Granted,54,8745,59270,2791334,2754385,3596,6.076,3420,5.779,378954,121242,257712,4.402,13.758,306917,104008,202909,3.776,11.143,72037,2.615,22.286,614,656,12675
2020,Utility Patent Granted,55,2740,14081,1699067,1687050,867,6.083,1213,8.510,212374,61650,150724,3.654,12.588,187042,51029,136013,3.025,11.087,25332,1.502,22.174,13,16,244
2020,Utility Patent Granted,56,1255,18118,1544219,1546679,1496,8.335,1156,6.441,120435,29182,91253,1.887,7.787,125953,35153,90800,2.273,8.143,-5518,-0.357,15.573,36,36,513
2020,Utility Patent Granted,61,372,2245,817870,813792,371,17.484,125,5.891,38802,7646,31156,0.940,4.768,30759,2559,28200,0.314,3.780,8043,0.988,7.559,9,14,162
2020,Utility Patent Granted,62,839,53587,3133074,3102622,3174,5.922,3195,5.961,246984,62845,184139,2.026,7.960,184497,41378,143119,1.334,5.946,62487,2.014,11.893,48,56,755
2020,Utility Patent Granted,71,230,2361,177760,174376,279,11.875,256,10.896,25747,12498,13249,7.167,14.765,18939,3414,15525,1.958,10.861,6808,3.904,21.722,16,16,71
2020,Utility Patent Granted,72,587,21951,1124724,1071814,616,2.818,428,1.958,152891,20036,132855,1.869,14.265,48636,16116,32520,1.504,4.538,104255,9.727,9.075,36,43,642
2020,Utility Patent Granted,81,1008,14945,307236,295822,2297,15.835,1418,9.776,55882,23286,32596,7.872,18.890,32457,14629,17828,4.945,10.972,23425,7.919,21.944,27,28,133
2021,No Utility Patent Granted,11,18520,19070,155156,155978,2381,12.651,1883,10.005,24300,10172,14128,6.521,15.579,25826,7434,18392,4.766,16.558,-1526,-0.978,31.158,1405,1405,5605
2021,No Utility Patent Granted,21,14792,18779,319806,351714,1435,7.433,2489,12.892,32757,13370,19387,3.801,9.314,96262,22529,73733,6.405,27.369,-63505,-18.056,18.627,1634,1697,12472
2021,No Utility Patent Granted,22,5791,12168,329032,329070,760,6.291,587,4.859,24972,7766,17206,2.360,7.589,25234,7689,17545,2.337,7.668,-262,-0.080,15.177,269,273,1723
2021,No Utility Patent Granted,23,649393,662850,6719545,6757921,89090,13.636,70047,10.722,986118,321557,664561,4.758,14.592,1060546,249424,811122,3.691,15.693,-74428,-1.101,29.184,49098,49179,171624
2021,No Utility Patent Granted,31-33,211925,234296,5971370,6071568,17267,7.339,19207,8.164,572044,165138,406906,2.720,9.422,771775,167641,604134,2.761,12.711,-199731,-3.290,18.843,13603,13759,103811
2021,No Utility Patent Granted,42,245692,314231,4129359,4217020,24493,7.765,26886,8.524,392006,127849,264157,3.032,9.296,567467,144908,422559,3.436,13.457,-175461,-4.161,18.592,18103,18728,92150
2021,No Utility Patent Granted,44-45,568125,833445,11588778,11637585,76603,9.176,79386,9.509,1313961,437534,876427,3.760,11.291,1411431,438995,972436,3.772,12.128,-97470,-0.838,22.581,46420,53150,261884
2021,No Utility Patent Granted,48-49,180384,213984,3734123,3705288,38241,18.423,25416,12.244,664876,284560,380316,7.680,17.944,598921,159896,439025,4.315,16.164,65955,1.780,32.328,16984,17271,87175
2021,No Utility Patent Granted,51,69640,93078,1316179,1362413,12255,13.209,11661,12.568,177757,66672,111085,4.894,13.047,270578,76187,194391,5.592,19.860,-92821,-6.813,26.094,6758,7097,43086
2021,No Utility Patent Granted,52,214876,364082,4258790,4225284,34385,9.456,33461,9.202,621070,211743,409327,5.011,14.699,551138,208292,342846,4.930,13.044,69932,1.655,26.088,15295,15934,63999
2021,No Utility Patent Granted,53,281889,343131,1860259,1887885,49783,14.812,35712,10.626,275794,138290,137504,7.325,14.609,333066,110856,222210,5.872,17.642,-57272,-3.034,29.217,23628,23979,69457
2021,No Utility Patent Granted,54,707402,763569,6686823,6662320,103210,13.678,85217,11.293,1032412,379283,653129,5.693,15.496,982373,328883,653490,4.936,14.745,50039,0.751,29.490,61846,62400,229939
2021,No Utility Patent Granted,55,22059,36510,1755438,1778764,2726,7.466,2731,7.480,233654,59741,173913,3.359,13.136,279142,57076,222066,3.209,15.693,-45488,-2.557,26.272,795,925,17458
2021,No Utility Patent Granted,56,302758,359928,9979111,10033208,50811,14.274,42898,12.051,1658451,452660,1205791,4.512,16.530,1762056,377738,1384318,3.765,17.562,-103605,-1.033,33.059,27472,27698,190392
2021,No Utility Patent Granted,61,86554,96387,2702118,2838033,10788,11.146,11594,11.979,197646,61663,135983,2.173,6.964,468691,70167,398524,2.472,16.515,-271045,-9.550,13.928,7703,7850,44842
2021,No Utility Patent Granted,62,612634,827659,17691118,17960312,79472,9.685,65323,7.961,1727810,629765,1098045,3.506,9.620,2268370,516005,1752365,2.873,12.630,-540560,-3.010,19.240,43298,44816,292325
2021,No Utility Patent Granted,71,106720,118402,1692692,1989910,16379,13.662,19356,16.145,191331,84890,106441,4.266,9.615,784510,131833,652677,6.625,39.424,-593179,-29.809,19.230,12003,12161,75750
2021,No Utility Patent Granted,72,482855,652810,11318013,12305297,69079,10.524,76204,11.610,1496699,758670,738029,6.165,12.163,3480718,841628,2639090,6.840,28.286,-1984019,-16.123,24.326,47491,49163,474963
2021,No Utility Patent Granted,81,642445,695733,4855226,5084086,67205,9.644,69441,9.965,549464,235281,314183,4.628,10.808,1007747,247392,760355,4.866,19.822,-458283,-9.014,21.615,45213,46829,160846
2021,Utility Patent Granted,11,60,233,9379,9585,5,2.096,16,6.709,1106,92,1014,0.960,11.539,1513,61,1452,0.636,15.786,-407,-4.246,23.079,4,4,16
2021,Utility Patent Granted,21,277,2309,154391,173158,95,3.992,236,9.918,9204,3181,6023,1.837,5.315,46621,7750,38871,4.476,26.924,-37417,-21.609,10.631,10,31,1844
2021,Utility Patent Granted,22,111,6958,302787,304667,498,7.250,320,4.659,16454,2833,13621,0.930,5.401,19734,3527,16207,1.158,6.477,-3280,-1.077,10.801,5,5,43
2021,Utility Patent Granted,23,983,4397,366229,374295,468,10.601,503,11.394,51511,13593,37918,3.632,13.762,67198,13275,53923,3.547,17.953,-15687,-4.191,27.524,47,47,583
2021,Utility Patent Granted,31-33,8478,31102,5687217,5738452,984,3.141,1439,4.593,415552,69668,345884,1.214,7.242,517436,91488,425948,1.594,9.017,-101884,-1.775,14.483,272,287,10789
2021,Utility Patent Granted,42,5831,48260,1785625,1811820,1914,3.922,3000,6.147,189691,51406,138285,2.837,10.470,240989,69612,171377,3.842,13.301,-51298,-2.831,20.939,213,231,4543
2021,Utility Patent Granted,44-45,1622,129369,3962508,4040482,3747,2.839,9007,6.824,272627,64735,207892,1.602,6.747,436700,95664,341036,2.368,10.808,-164073,-4.061,13.495,84,153,906
2021,Utility Patent Granted,48-49,1085,21349,1972133,2000743,2001,9.503,1414,6.716,134490,55557,78933,2.777,6.722,195871,30163,165708,1.508,9.790,-61381,-3.068,13.444,19,50,561
2021,Utility Patent Granted,51,2259,50417,2010697,2048326,4686,9.045,7468,14.415,271121,78963,192158,3.855,13.236,343875,100618,243257,4.912,16.788,-72754,-3.552,26.472,145,153,6139
2021,Utility Patent Granted,52,751,81989,2423863,2433388,6320,7.736,5731,7.015,272344,74284,198060,3.053,11.192,291335,82054,209281,3.372,11.972,-18991,-0.780,22.384,19,19,813
2021,Utility Patent Granted,53,757,35824,325242,344890,3201,8.572,6237,16.702,48144,18528,29616,5.372,13.959,89275,22964,66311,6.658,25.885,-41131,-11.926,27.919,22,24,236
2021,Utility Patent Granted,54,9145,57093,2808123,2830148,2747,4.686,5806,9.904,319917,86422,233495,3.054,11.304,364524,133995,230529,4.735,12.880,-44607,-1.576,22.608,592,622,11078
2021,Utility Patent Granted,55,2706,13670,1707447,1729703,1095,7.856,1632,11.709,221484,42260,179224,2.443,12.805,264521,74155,190366,4.287,15.293,-43037,-2.488,25.609,23,26,981
2021,Utility Patent Granted,56,1315,20982,1553331,1586479,2509,11.998,2368,11.324,172702,100977,71725,6.365,10.886,238042,55394,182648,3.492,15.004,-65340,-4.119,21.772,39,39,565
2021,Utility Patent Granted,61,379,2176,730121,757645,108,4.829,229,10.239,21704,5901,15803,0.779,2.865,77191,5731,71460,0.756,10.188,-55487,-7.324,5.729,16,44,738
2021,Utility Patent Granted,62,860,55469,3009552,3011333,6218,11.447,3917,7.211,269507,101788,167719,3.380,8.950,272749,64937,207812,2.156,9.057,-3242,-0.108,17.900,43,71,1228
2021,Utility Patent Granted,71,226,2320,140481,165801,130,5.381,322,13.328,7724,2862,4862,1.726,4.659,57898,4089,53809,2.466,34.920,-50174,-30.262,9.317,15,15,41
2021,Utility Patent Granted,72,601,21173,847852,975129,618,2.914,692,3.263,27796,14188,13608,1.455,2.850,280181,18010,262171,1.847,28.733,-252385,-25.882,5.701,41,66,979
2021,Utility Patent Granted,81,1027,14113,272435,287930,896,6.210,1525,10.570,22508,11435,11073,3.971,7.817,53925,11672,42253,4.054,18.729,-31417,-10.911,15.634,39,47,171
2022,No Utility Patent Granted,11,18479,19013,155260,153708,2292,12.081,2210,11.649,29047,9493,19554,6.176,18.898,26047,8874,17173,5.773,16.946,3000,1.952,33.892,1795,1827,6007
2022,No Utility Patent Granted,21,14971,18730,351774,340078,1922,10.207,2124,11.279,68055,17615,50440,5.180,20.012,44280,19307,24973,5.677,13.021,23775,6.991,26.041,1446,1513,11641
2022,No Utility Patent Granted,22,5967,11844,303456,299106,905,7.721,661,5.639,32594,12223,20371,4.087,10.897,23780,5173,18607,1.729,7.950,8814,2.947,15.901,306,330,1886
2022,No Utility Patent Granted,23,668842,683004,7006999,6864280,94229,14.012,73242,10.891,1211372,338962,872410,4.938,17.647,923435,299556,623879,4.364,13.453,287937,4.195,26.906,60303,60432,229081
2022,No Utility Patent Granted,31-33,214182,237674,6312318,6178135,19680,8.317,17567,7.424,811863,170134,641729,2.754,13.141,544103,172093,372010,2.786,8.807,267760,4.334,17.614,14058,14206,112672
2022,No Utility Patent Granted,42,245929,317255,4291641,4212829,26007,8.190,26559,8.364,616736,158634,458102,3.765,14.639,458176,186289,271887,4.422,10.876,158560,3.764,21.751,18853,19825,109106
2022,No Utility Patent Granted,44-45,577012,843006,11878488,11747560,83898,10.020,72567,8.666,1552682,486447,1066235,4.141,13.217,1280821,475551,805270,4.048,10.903,271861,2.314,21.806,49048,52222,253123
2022,No Utility Patent Granted,48-49,196642,232036,4167064,3983290,43917,19.643,26998,12.076,821473,242014,579459,6.076,20.623,450679,166237,284442,4.173,11.314,370794,9.309,22.628,21417,21903,110480
2022,No Utility Patent Granted,51,71554,94800,1414904,1362504,14006,14.953,11737,12.531,313607,86956,226651,6.382,23.017,213124,89373,123751,6.559,15.642,100483,7.375,31.284,8180,8777,56326
2022,No Utility Patent Granted,52,215669,362831,4304640,4256697,33320,9.172,34200,9.414,675733,231688,444045,5.443,15.875,578350,256919,321431,6.036,13.587,97383,2.288,27.174,18496,19450,86443
2022,No Utility Patent Granted,53,292556,352921,1972623,1911693,50889,14.654,39604,11.404,379963,145991,233972,7.637,19.876,257248,122499,134749,6.408,13.457,122715,6.419,26.913,29698,30889,88166
2022,No Utility Patent Granted,54,717379,775650,7124945,6864495,104195,13.541,91849,11.937,1402705,414700,988005,6.041,20.434,882965,396399,486566,5.775,12.863,519740,7.571,25.726,74973,75809,283925
2022,No Utility Patent Granted,55,21628,35571,1835246,1782032,2311,6.438,2959,8.243,338803,51911,286892,2.913,19.012,232506,69769,162737,3.915,13.047,106297,5.965,26.094,930,963,12058
2022,No Utility Patent Granted,56,312302,365945,10656511,10304031,50168,13.835,43521,12.002,2219695,484353,1735342,4.701,21.542,1508365,497314,1011051,4.826,14.639,711330,6.903,29.277,31430,31860,235024
2022,No Utility Patent Granted,61,90602,100227,2897074,2792880,12423,12.627,8739,8.882,382453,64721,317732,2.317,13.694,174862,53996,120866,1.933,6.261,207591,7.433,12.522,6620,6791,36777
2022,No Utility Patent Granted,62,620619,834601,17971445,17772233,80953,9.774,68188,8.233,2347944,678708,1669236,3.819,13.211,1942673,616657,1326016,3.470,10.931,405271,2.280,21.862,47920,50035,365383
2022,No Utility Patent Granted,71,114355,126094,2115417,1899907,20960,17.152,13180,10.785,595046,120757,474289,6.356,31.320,165823,68001,97822,3.579,8.728,429223,22.592,17.456,10603,10705,51494
2022,No Utility Patent Granted,72,505237,677029,12792039,12019066,81456,12.251,57150,8.596,2918687,962824,1955863,8.011,24.284,1368322,540975,827347,4.501,11.385,1550365,12.899,22.769,42403,44386,374609
2022,No Utility Patent Granted,81,658725,713486,5203387,5037249,75807,10.754,58621,8.316,909496,267426,642070,5.309,18.055,577477,230186,347291,4.570,11.464,332019,6.591,22.928,46190,47049,171041
2022,Utility Patent Granted,11,62,252,11550,11039,20,8.081,11,4.444,1734,543,1191,4.919,15.708,714,56,658,0.507,6.468,1020,9.240,12.936,D,D,D
2022,Utility Patent Granted,21,257,2280,154186,152387,124,5.316,229,9.818,19917,2633,17284,1.728,13.070,16441,6188,10253,4.061,10.789,3476,2.281,21.578,14,15,282
2022,Utility Patent Granted,22,117,7697,341935,340475,613,8.010,525,6.860,37711,7071,30640,2.077,11.076,35075,11421,23654,3.354,10.302,2636,0.774,20.604,D,D,D
2022,Utility Patent Granted,23,994,4685,351284,353015,421,8.973,435,9.271,53388,19103,34285,5.411,15.123,58260,14387,43873,4.075,16.504,-4872,-1.380,30.247,56,64,777
2022,Utility Patent Granted,31-33,8244,30508,5837941,5753380,1188,3.856,1787,5.801,577861,100563,477298,1.748,10.044,410016,107764,302252,1.873,7.127,167845,2.917,14.253,282,289,7727
2022,Utility Patent Granted,42,5613,43836,1836680,1804345,1989,4.468,3348,7.521,235359,58820,176539,3.260,13.044,171934,66374,105560,3.679,9.529,63425,3.515,19.058,222,237,4692
2022,Utility Patent Granted,44-45,1699,130277,4033258,3974196,7581,5.887,4567,3.547,435176,113583,321593,2.858,10.950,326944,63926,263018,1.609,8.227,108232,2.723,16.453,107,121,1167
2022,Utility Patent Granted,48-49,1102,21390,1927668,1917180,2919,14.006,1821,8.738,183932,50443,133489,2.631,9.594,160229,43942,116287,2.292,8.358,23703,1.236,16.715,17,17,138
2022,Utility Patent Granted,51,2192,48484,2100666,2084523,3982,8.021,6309,12.708,347190,76623,270567,3.676,16.656,313909,100557,213352,4.824,15.059,33281,1.597,30.118,203,251,12483
2022,Utility Patent Granted,52,739,81975,2470274,2469626,8486,10.336,8741,10.646,412071,125792,286279,5.094,16.686,406833,149914,256919,6.070,16.473,5238,0.212,32.947,30,35,651
2022,Utility Patent Granted,53,758,38304,356486,344713,4134,10.975,2864,7.603,68839,24158,44681,7.008,19.970,44352,19147,25205,5.554,12.866,24487,7.104,25.733,31,31,146
2022,Utility Patent Granted,54,9070,50263,2950096,2892942,5647,10.463,13059,24.197,504914,143916,360998,4.975,17.453,385946,214641,171305,7.419,13.341,118968,4.112,26.682,777,801,12543
2022,Utility Patent Granted,55,2617,13881,1790452,1765692,1198,8.553,1448,10.338,225282,29972,195310,1.697,12.759,177424,50495,126929,2.860,10.048,47858,2.710,20.097,24,25,1161
2022,Utility Patent Granted,56,1303,20535,1407018,1423843,1894,8.979,3011,14.275,179604,49786,129818,3.497,12.614,217902,51177,166725,3.594,15.304,-38298,-2.690,25.228,52,149,4206
2022,Utility Patent Granted,61,383,2061,810659,791670,95,4.460,233,10.939,63197,2949,60248,0.373,7.983,25454,5528,19926,0.698,3.215,37743,4.768,6.430,18,21,735
2022,Utility Patent Granted,62,876,63936,3168374,3151923,5588,8.949,2596,4.158,243993,75420,168573,2.393,7.741,212346,53889,158457,1.710,6.737,31647,1.004,13.474,38,38,388
2022,Utility Patent Granted,71,227,2696,170939,158901,287,10.719,250,9.337,28919,2044,26875,1.286,18.199,5877,1258,4619,0.792,3.699,23042,14.501,7.397,16,16,37
2022,Utility Patent Granted,72,589,22478,954491,935098,1958,8.815,1424,6.411,161017,40903,120114,4.374,17.219,120185,36574,83611,3.911,12.853,40832,4.367,25.705,40,44,398
2022,Utility Patent Granted,81,994,13273,259843,253196,1375,10.292,1548,11.587,36241,11556,24685,4.564,14.313,22806,11184,11622,4.417,9.007,13435,5.306,18.015,50,50,344
